＠う	《うろつくカラカル》	名詞
＠うろ	《うろつくカラカル》	名詞
＠うろつ	《うろつくカラカル》	名詞
＠うろつく	《うろつくカラカル》	名詞
＠うろつくか	《うろつくカラカル》	名詞
＠うろつくから	《うろつくカラカル》	名詞
＠うろつくからか	《うろつくカラカル》	名詞
＠うろつくからかる	《うろつくカラカル》	名詞
＠ご	《ごみ引きずり》	名詞
＠ごみ	《ごみ引きずり》	名詞
＠ごみひ	《ごみ引きずり》	名詞
＠ごみひき	《ごみ引きずり》	名詞
＠ごみひきず	《ごみ引きずり》	名詞
＠ごみひきずり	《ごみ引きずり》	名詞
＠し	《しつこい請願者》	名詞
＠しつ	《しつこい請願者》	名詞
＠しつこ	《しつこい請願者》	名詞
＠しつこい	《しつこい請願者》	名詞
＠しつこいせ	《しつこい請願者》	名詞
＠しつこいせい	《しつこい請願者》	名詞
＠しつこいせいが	《しつこい請願者》	名詞
＠しつこいせいがん	《しつこい請願者》	名詞
＠しつこいせいがんし	《しつこい請願者》	名詞
＠しつこいせいがんしゃ	《しつこい請願者》	名詞
＠ど	《どぶ骨》	名詞
＠どぶ	《どぶ骨》	名詞
＠どぶほ	《どぶ骨》	名詞
＠どぶほね	《どぶ骨》	名詞
＠の	《のし歩く城塁》	名詞
＠のし	《のし歩く城塁》	名詞
＠のしあ	《のし歩く城塁》	名詞
＠のしある	《のし歩く城塁》	名詞
＠のしあるく	《のし歩く城塁》	名詞
＠のしあるくじ	《のし歩く城塁》	名詞
＠のしあるくじょ	《のし歩く城塁》	名詞
＠のしあるくじょう	《のし歩く城塁》	名詞
＠のしあるくじょうる	《のし歩く城塁》	名詞
＠のしあるくじょうるい	《のし歩く城塁》	名詞
＠ひ	《ひっかき爪》	名詞
＠ひっ	《ひっかき爪》	名詞
＠ひっか	《ひっかき爪》	名詞
＠ひっかき	《ひっかき爪》	名詞
＠ひっかきづ	《ひっかき爪》	名詞
＠ひっかきづめ	《ひっかき爪》	名詞
＠あ	《アゾリウスのギルド門》	名詞
＠あぞ	《アゾリウスのギルド門》	名詞
＠あぞり	《アゾリウスのギルド門》	名詞
＠あぞりう	《アゾリウスのギルド門》	名詞
＠あぞりうす	《アゾリウスのギルド門》	名詞
＠あぞりうすの	《アゾリウスのギルド門》	名詞
＠あぞりうすのぎ	《アゾリウスのギルド門》	名詞
＠あぞりうすのぎる	《アゾリウスのギルド門》	名詞
＠あぞりうすのぎるど	《アゾリウスのギルド門》	名詞
＠あぞりうすのぎるども	《アゾリウスのギルド門》	名詞
＠あぞりうすのぎるどもん	《アゾリウスのギルド門》	名詞
＠あ	《アゾリウスのロケット》	名詞
＠あぞ	《アゾリウスのロケット》	名詞
＠あぞり	《アゾリウスのロケット》	名詞
＠あぞりう	《アゾリウスのロケット》	名詞
＠あぞりうす	《アゾリウスのロケット》	名詞
＠あぞりうすの	《アゾリウスのロケット》	名詞
＠あぞりうすのろ	《アゾリウスのロケット》	名詞
＠あぞりうすのろけ	《アゾリウスのロケット》	名詞
＠あぞりうすのろけっ	《アゾリウスのロケット》	名詞
＠あぞりうすのろけっと	《アゾリウスのロケット》	名詞
＠あ	《アゾリウスの空護衛》	名詞
＠あぞ	《アゾリウスの空護衛》	名詞
＠あぞり	《アゾリウスの空護衛》	名詞
＠あぞりう	《アゾリウスの空護衛》	名詞
＠あぞりうす	《アゾリウスの空護衛》	名詞
＠あぞりうすの	《アゾリウスの空護衛》	名詞
＠あぞりうすのか	《アゾリウスの空護衛》	名詞
＠あぞりうすのから	《アゾリウスの空護衛》	名詞
＠あぞりうすのからご	《アゾリウスの空護衛》	名詞
＠あぞりうすのからごえ	《アゾリウスの空護衛》	名詞
＠あぞりうすのからごえい	《アゾリウスの空護衛》	名詞
＠あ	《アゾリウスの造反者、ラヴィニア》	名詞
＠あぞ	《アゾリウスの造反者、ラヴィニア》	名詞
＠あぞり	《アゾリウスの造反者、ラヴィニア》	名詞
＠あぞりう	《アゾリウスの造反者、ラヴィニア》	名詞
＠あぞりうす	《アゾリウスの造反者、ラヴィニア》	名詞
＠あぞりうすの	《アゾリウスの造反者、ラヴィニア》	名詞
＠あぞりうすのぞ	《アゾリウスの造反者、ラヴィニア》	名詞
＠あぞりうすのぞう	《アゾリウスの造反者、ラヴィニア》	名詞
＠あぞりうすのぞうは	《アゾリウスの造反者、ラヴィニア》	名詞
＠あぞりうすのぞうはん	《アゾリウスの造反者、ラヴィニア》	名詞
＠あぞりうすのぞうはんし	《アゾリウスの造反者、ラヴィニア》	名詞
＠あぞりうすのぞうはんしゃ	《アゾリウスの造反者、ラヴィニア》	名詞
＠あぞりうすのぞうはんしゃ、	《アゾリウスの造反者、ラヴィニア》	名詞
＠あぞりうすのぞうはんしゃ、ら	《アゾリウスの造反者、ラヴィニア》	名詞
＠あぞりうすのぞうはんしゃ、らヴ	《アゾリウスの造反者、ラヴィニア》	名詞
＠あぞりうすのぞうはんしゃ、らヴぃ	《アゾリウスの造反者、ラヴィニア》	名詞
＠あぞりうすのぞうはんしゃ、らヴぃに	《アゾリウスの造反者、ラヴィニア》	名詞
＠あぞりうすのぞうはんしゃ、らヴぃにあ	《アゾリウスの造反者、ラヴィニア》	名詞
＠あ	《アゾリウスの騎士判事》	名詞
＠あぞ	《アゾリウスの騎士判事》	名詞
＠あぞり	《アゾリウスの騎士判事》	名詞
＠あぞりう	《アゾリウスの騎士判事》	名詞
＠あぞりうす	《アゾリウスの騎士判事》	名詞
＠あぞりうすの	《アゾリウスの騎士判事》	名詞
＠あぞりうすのき	《アゾリウスの騎士判事》	名詞
＠あぞりうすのきし	《アゾリウスの騎士判事》	名詞
＠あぞりうすのきしは	《アゾリウスの騎士判事》	名詞
＠あぞりうすのきしはん	《アゾリウスの騎士判事》	名詞
＠あぞりうすのきしはんじ	《アゾリウスの騎士判事》	名詞
＠あ	《アーチ道の天使》	名詞
＠あー	《アーチ道の天使》	名詞
＠あーち	《アーチ道の天使》	名詞
＠あーちみ	《アーチ道の天使》	名詞
＠あーちみち	《アーチ道の天使》	名詞
＠あーちみちの	《アーチ道の天使》	名詞
＠あーちみちのて	《アーチ道の天使》	名詞
＠あーちみちのてん	《アーチ道の天使》	名詞
＠あーちみちのてんし	《アーチ道の天使》	名詞
＠え	《エアロムンクルス》	名詞
＠えあ	《エアロムンクルス》	名詞
＠えあろ	《エアロムンクルス》	名詞
＠えあろむ	《エアロムンクルス》	名詞
＠えあろむん	《エアロムンクルス》	名詞
＠えあろむんく	《エアロムンクルス》	名詞
＠えあろむんくる	《エアロムンクルス》	名詞
＠えあろむんくるす	《エアロムンクルス》	名詞
＠え	《エイ翼のスパイ》	名詞
＠えい	《エイ翼のスパイ》	名詞
＠えいつ	《エイ翼のスパイ》	名詞
＠えいつば	《エイ翼のスパイ》	名詞
＠えいつばさ	《エイ翼のスパイ》	名詞
＠えいつばさの	《エイ翼のスパイ》	名詞
＠えいつばさのす	《エイ翼のスパイ》	名詞
＠えいつばさのすぱ	《エイ翼のスパイ》	名詞
＠えいつばさのすぱい	《エイ翼のスパイ》	名詞
＠え	《エリマキ神秘家》	名詞
＠えり	《エリマキ神秘家》	名詞
＠えりま	《エリマキ神秘家》	名詞
＠えりまき	《エリマキ神秘家》	名詞
＠えりまきし	《エリマキ神秘家》	名詞
＠えりまきしん	《エリマキ神秘家》	名詞
＠えりまきしんぴ	《エリマキ神秘家》	名詞
＠えりまきしんぴか	《エリマキ神秘家》	名詞
＠お	《オルゾフのギルド門》	名詞
＠おる	《オルゾフのギルド門》	名詞
＠おるぞ	《オルゾフのギルド門》	名詞
＠おるぞふ	《オルゾフのギルド門》	名詞
＠おるぞふの	《オルゾフのギルド門》	名詞
＠おるぞふのぎ	《オルゾフのギルド門》	名詞
＠おるぞふのぎる	《オルゾフのギルド門》	名詞
＠おるぞふのぎるど	《オルゾフのギルド門》	名詞
＠おるぞふのぎるども	《オルゾフのギルド門》	名詞
＠おるぞふのぎるどもん	《オルゾフのギルド門》	名詞
＠お	《オルゾフのロケット》	名詞
＠おる	《オルゾフのロケット》	名詞
＠おるぞ	《オルゾフのロケット》	名詞
＠おるぞふ	《オルゾフのロケット》	名詞
＠おるぞふの	《オルゾフのロケット》	名詞
＠おるぞふのろ	《オルゾフのロケット》	名詞
＠おるぞふのろけ	《オルゾフのロケット》	名詞
＠おるぞふのろけっ	《オルゾフのロケット》	名詞
＠おるぞふのろけっと	《オルゾフのロケット》	名詞
＠お	《オルゾフの処罰者》	名詞
＠おる	《オルゾフの処罰者》	名詞
＠おるぞ	《オルゾフの処罰者》	名詞
＠おるぞふ	《オルゾフの処罰者》	名詞
＠おるぞふの	《オルゾフの処罰者》	名詞
＠おるぞふのし	《オルゾフの処罰者》	名詞
＠おるぞふのしょ	《オルゾフの処罰者》	名詞
＠おるぞふのしょば	《オルゾフの処罰者》	名詞
＠おるぞふのしょばつ	《オルゾフの処罰者》	名詞
＠おるぞふのしょばつし	《オルゾフの処罰者》	名詞
＠おるぞふのしょばつしゃ	《オルゾフの処罰者》	名詞
＠お	《オルゾフの強請り屋》	名詞
＠おる	《オルゾフの強請り屋》	名詞
＠おるぞ	《オルゾフの強請り屋》	名詞
＠おるぞふ	《オルゾフの強請り屋》	名詞
＠おるぞふの	《オルゾフの強請り屋》	名詞
＠おるぞふのね	《オルゾフの強請り屋》	名詞
＠おるぞふのねだ	《オルゾフの強請り屋》	名詞
＠おるぞふのねだり	《オルゾフの強請り屋》	名詞
＠おるぞふのねだりや	《オルゾフの強請り屋》	名詞
＠お	《オルゾフの簒奪者、ケイヤ》	名詞
＠おる	《オルゾフの簒奪者、ケイヤ》	名詞
＠おるぞ	《オルゾフの簒奪者、ケイヤ》	名詞
＠おるぞふ	《オルゾフの簒奪者、ケイヤ》	名詞
＠おるぞふの	《オルゾフの簒奪者、ケイヤ》	名詞
＠おるぞふのさ	《オルゾフの簒奪者、ケイヤ》	名詞
＠おるぞふのさん	《オルゾフの簒奪者、ケイヤ》	名詞
＠おるぞふのさんだ	《オルゾフの簒奪者、ケイヤ》	名詞
＠おるぞふのさんだつ	《オルゾフの簒奪者、ケイヤ》	名詞
＠おるぞふのさんだつし	《オルゾフの簒奪者、ケイヤ》	名詞
＠おるぞふのさんだつしゃ	《オルゾフの簒奪者、ケイヤ》	名詞
＠おるぞふのさんだつしゃ、	《オルゾフの簒奪者、ケイヤ》	名詞
＠おるぞふのさんだつしゃ、け	《オルゾフの簒奪者、ケイヤ》	名詞
＠おるぞふのさんだつしゃ、けい	《オルゾフの簒奪者、ケイヤ》	名詞
＠おるぞふのさんだつしゃ、けいや	《オルゾフの簒奪者、ケイヤ》	名詞
＠ぎ	《ギルドパクトのガラス壁》	名詞
＠ぎる	《ギルドパクトのガラス壁》	名詞
＠ぎるど	《ギルドパクトのガラス壁》	名詞
＠ぎるどぱ	《ギルドパクトのガラス壁》	名詞
＠ぎるどぱく	《ギルドパクトのガラス壁》	名詞
＠ぎるどぱくと	《ギルドパクトのガラス壁》	名詞
＠ぎるどぱくとの	《ギルドパクトのガラス壁》	名詞
＠ぎるどぱくとのが	《ギルドパクトのガラス壁》	名詞
＠ぎるどぱくとのがら	《ギルドパクトのガラス壁》	名詞
＠ぎるどぱくとのがらす	《ギルドパクトのガラス壁》	名詞
＠ぎるどぱくとのがらすか	《ギルドパクトのガラス壁》	名詞
＠ぎるどぱくとのがらすかべ	《ギルドパクトのガラス壁》	名詞
＠ぎ	《ギルドパクトのスフィンクス》	名詞
＠ぎる	《ギルドパクトのスフィンクス》	名詞
＠ぎるど	《ギルドパクトのスフィンクス》	名詞
＠ぎるどぱ	《ギルドパクトのスフィンクス》	名詞
＠ぎるどぱく	《ギルドパクトのスフィンクス》	名詞
＠ぎるどぱくと	《ギルドパクトのスフィンクス》	名詞
＠ぎるどぱくとの	《ギルドパクトのスフィンクス》	名詞
＠ぎるどぱくとのす	《ギルドパクトのスフィンクス》	名詞
＠ぎるどぱくとのすふ	《ギルドパクトのスフィンクス》	名詞
＠ぎるどぱくとのすふぃ	《ギルドパクトのスフィンクス》	名詞
＠ぎるどぱくとのすふぃん	《ギルドパクトのスフィンクス》	名詞
＠ぎるどぱくとのすふぃんく	《ギルドパクトのスフィンクス》	名詞
＠ぎるどぱくとのすふぃんくす	《ギルドパクトのスフィンクス》	名詞
＠ぎ	《ギルドパクトの秘本》	名詞
＠ぎる	《ギルドパクトの秘本》	名詞
＠ぎるど	《ギルドパクトの秘本》	名詞
＠ぎるどぱ	《ギルドパクトの秘本》	名詞
＠ぎるどぱく	《ギルドパクトの秘本》	名詞
＠ぎるどぱくと	《ギルドパクトの秘本》	名詞
＠ぎるどぱくとの	《ギルドパクトの秘本》	名詞
＠ぎるどぱくとのひ	《ギルドパクトの秘本》	名詞
＠ぎるどぱくとのひほ	《ギルドパクトの秘本》	名詞
＠ぎるどぱくとのひほん	《ギルドパクトの秘本》	名詞
＠ぎ	《ギルド門通りの公有地》	名詞
＠ぎる	《ギルド門通りの公有地》	名詞
＠ぎるど	《ギルド門通りの公有地》	名詞
＠ぎるども	《ギルド門通りの公有地》	名詞
＠ぎるどもん	《ギルド門通りの公有地》	名詞
＠ぎるどもんど	《ギルド門通りの公有地》	名詞
＠ぎるどもんどお	《ギルド門通りの公有地》	名詞
＠ぎるどもんどおり	《ギルド門通りの公有地》	名詞
＠ぎるどもんどおりの	《ギルド門通りの公有地》	名詞
＠ぎるどもんどおりのこ	《ギルド門通りの公有地》	名詞
＠ぎるどもんどおりのこう	《ギルド門通りの公有地》	名詞
＠ぎるどもんどおりのこうゆ	《ギルド門通りの公有地》	名詞
＠ぎるどもんどおりのこうゆう	《ギルド門通りの公有地》	名詞
＠ぎるどもんどおりのこうゆうち	《ギルド門通りの公有地》	名詞
＠ぐ	《グルールのギルド門》	名詞
＠ぐる	《グルールのギルド門》	名詞
＠ぐるー	《グルールのギルド門》	名詞
＠ぐるーる	《グルールのギルド門》	名詞
＠ぐるーるの	《グルールのギルド門》	名詞
＠ぐるーるのぎ	《グルールのギルド門》	名詞
＠ぐるーるのぎる	《グルールのギルド門》	名詞
＠ぐるーるのぎるど	《グルールのギルド門》	名詞
＠ぐるーるのぎるども	《グルールのギルド門》	名詞
＠ぐるーるのぎるどもん	《グルールのギルド門》	名詞
＠ぐ	《グルールのロケット》	名詞
＠ぐる	《グルールのロケット》	名詞
＠ぐるー	《グルールのロケット》	名詞
＠ぐるーる	《グルールのロケット》	名詞
＠ぐるーるの	《グルールのロケット》	名詞
＠ぐるーるのろ	《グルールのロケット》	名詞
＠ぐるーるのろけ	《グルールのロケット》	名詞
＠ぐるーるのろけっ	《グルールのロケット》	名詞
＠ぐるーるのろけっと	《グルールのロケット》	名詞
＠ぐ	《グルールの呪文砕き》	名詞
＠ぐる	《グルールの呪文砕き》	名詞
＠ぐるー	《グルールの呪文砕き》	名詞
＠ぐるーる	《グルールの呪文砕き》	名詞
＠ぐるーるの	《グルールの呪文砕き》	名詞
＠ぐるーるのじ	《グルールの呪文砕き》	名詞
＠ぐるーるのじゅ	《グルールの呪文砕き》	名詞
＠ぐるーるのじゅも	《グルールの呪文砕き》	名詞
＠ぐるーるのじゅもん	《グルールの呪文砕き》	名詞
＠ぐるーるのじゅもんく	《グルールの呪文砕き》	名詞
＠ぐるーるのじゅもんくだ	《グルールの呪文砕き》	名詞
＠ぐるーるのじゅもんくだき	《グルールの呪文砕き》	名詞
＠ぐ	《グルールの獣使い》	名詞
＠ぐる	《グルールの獣使い》	名詞
＠ぐるー	《グルールの獣使い》	名詞
＠ぐるーる	《グルールの獣使い》	名詞
＠ぐるーるの	《グルールの獣使い》	名詞
＠ぐるーるのけ	《グルールの獣使い》	名詞
＠ぐるーるのけも	《グルールの獣使い》	名詞
＠ぐるーるのけもの	《グルールの獣使い》	名詞
＠ぐるーるのけものつ	《グルールの獣使い》	名詞
＠ぐるーるのけものつか	《グルールの獣使い》	名詞
＠ぐるーるのけものつかい	《グルールの獣使い》	名詞
＠け	《ケイヤの怒り》	名詞
＠けい	《ケイヤの怒り》	名詞
＠けいや	《ケイヤの怒り》	名詞
＠けいやの	《ケイヤの怒り》	名詞
＠けいやのい	《ケイヤの怒り》	名詞
＠けいやのいか	《ケイヤの怒り》	名詞
＠けいやのいかり	《ケイヤの怒り》	名詞
＠ご	《ゴブリンの集会》	名詞
＠ごぶ	《ゴブリンの集会》	名詞
＠ごぶり	《ゴブリンの集会》	名詞
＠ごぶりん	《ゴブリンの集会》	名詞
＠ごぶりんの	《ゴブリンの集会》	名詞
＠ごぶりんのし	《ゴブリンの集会》	名詞
＠ごぶりんのしゅ	《ゴブリンの集会》	名詞
＠ごぶりんのしゅう	《ゴブリンの集会》	名詞
＠ごぶりんのしゅうか	《ゴブリンの集会》	名詞
＠ごぶりんのしゅうかい	《ゴブリンの集会》	名詞
＠ご	《ゴーア族の破壊者》	名詞
＠ごー	《ゴーア族の破壊者》	名詞
＠ごーあ	《ゴーア族の破壊者》	名詞
＠ごーあぞ	《ゴーア族の破壊者》	名詞
＠ごーあぞく	《ゴーア族の破壊者》	名詞
＠ごーあぞくの	《ゴーア族の破壊者》	名詞
＠ごーあぞくのは	《ゴーア族の破壊者》	名詞
＠ごーあぞくのはか	《ゴーア族の破壊者》	名詞
＠ごーあぞくのはかい	《ゴーア族の破壊者》	名詞
＠ごーあぞくのはかいし	《ゴーア族の破壊者》	名詞
＠ごーあぞくのはかいしゃ	《ゴーア族の破壊者》	名詞
＠さ	《サルーリの世話人》	名詞
＠さる	《サルーリの世話人》	名詞
＠さるー	《サルーリの世話人》	名詞
＠さるーり	《サルーリの世話人》	名詞
＠さるーりの	《サルーリの世話人》	名詞
＠さるーりのせ	《サルーリの世話人》	名詞
＠さるーりのせわ	《サルーリの世話人》	名詞
＠さるーりのせわに	《サルーリの世話人》	名詞
＠さるーりのせわにん	《サルーリの世話人》	名詞
＠ざ	《ザル＝ターのゴブリン》	名詞
＠ざる	《ザル＝ターのゴブリン》	名詞
＠ざる＝	《ザル＝ターのゴブリン》	名詞
＠ざる＝た	《ザル＝ターのゴブリン》	名詞
＠ざる＝たー	《ザル＝ターのゴブリン》	名詞
＠ざる＝たーの	《ザル＝ターのゴブリン》	名詞
＠ざる＝たーのご	《ザル＝ターのゴブリン》	名詞
＠ざる＝たーのごぶ	《ザル＝ターのゴブリン》	名詞
＠ざる＝たーのごぶり	《ザル＝ターのゴブリン》	名詞
＠ざる＝たーのごぶりん	《ザル＝ターのゴブリン》	名詞
＠し	《シミックのギルド門》	名詞
＠しみ	《シミックのギルド門》	名詞
＠しみっ	《シミックのギルド門》	名詞
＠しみっく	《シミックのギルド門》	名詞
＠しみっくの	《シミックのギルド門》	名詞
＠しみっくのぎ	《シミックのギルド門》	名詞
＠しみっくのぎる	《シミックのギルド門》	名詞
＠しみっくのぎるど	《シミックのギルド門》	名詞
＠しみっくのぎるども	《シミックのギルド門》	名詞
＠しみっくのぎるどもん	《シミックのギルド門》	名詞
＠し	《シミックのロケット》	名詞
＠しみ	《シミックのロケット》	名詞
＠しみっ	《シミックのロケット》	名詞
＠しみっく	《シミックのロケット》	名詞
＠しみっくの	《シミックのロケット》	名詞
＠しみっくのろ	《シミックのロケット》	名詞
＠しみっくのろけ	《シミックのロケット》	名詞
＠しみっくのろけっ	《シミックのロケット》	名詞
＠しみっくのろけっと	《シミックのロケット》	名詞
＠し	《シミックの隆盛》	名詞
＠しみ	《シミックの隆盛》	名詞
＠しみっ	《シミックの隆盛》	名詞
＠しみっく	《シミックの隆盛》	名詞
＠しみっくの	《シミックの隆盛》	名詞
＠しみっくのり	《シミックの隆盛》	名詞
＠しみっくのりゅ	《シミックの隆盛》	名詞
＠しみっくのりゅう	《シミックの隆盛》	名詞
＠しみっくのりゅうせ	《シミックの隆盛》	名詞
＠しみっくのりゅうせい	《シミックの隆盛》	名詞
＠し	《シラナの道探し》	名詞
＠しら	《シラナの道探し》	名詞
＠しらな	《シラナの道探し》	名詞
＠しらなの	《シラナの道探し》	名詞
＠しらなのみ	《シラナの道探し》	名詞
＠しらなのみち	《シラナの道探し》	名詞
＠しらなのみちさ	《シラナの道探し》	名詞
＠しらなのみちさが	《シラナの道探し》	名詞
＠しらなのみちさがし	《シラナの道探し》	名詞
＠す	《スカルガンのヘルカイト》	名詞
＠すか	《スカルガンのヘルカイト》	名詞
＠すかる	《スカルガンのヘルカイト》	名詞
＠すかるが	《スカルガンのヘルカイト》	名詞
＠すかるがん	《スカルガンのヘルカイト》	名詞
＠すかるがんの	《スカルガンのヘルカイト》	名詞
＠すかるがんのへ	《スカルガンのヘルカイト》	名詞
＠すかるがんのへる	《スカルガンのヘルカイト》	名詞
＠すかるがんのへるか	《スカルガンのヘルカイト》	名詞
＠すかるがんのへるかい	《スカルガンのヘルカイト》	名詞
＠すかるがんのへるかいと	《スカルガンのヘルカイト》	名詞
＠す	《スフィンクスの眼識》	名詞
＠すふ	《スフィンクスの眼識》	名詞
＠すふぃ	《スフィンクスの眼識》	名詞
＠すふぃん	《スフィンクスの眼識》	名詞
＠すふぃんく	《スフィンクスの眼識》	名詞
＠すふぃんくす	《スフィンクスの眼識》	名詞
＠すふぃんくすの	《スフィンクスの眼識》	名詞
＠すふぃんくすのが	《スフィンクスの眼識》	名詞
＠すふぃんくすのがん	《スフィンクスの眼識》	名詞
＠すふぃんくすのがんし	《スフィンクスの眼識》	名詞
＠すふぃんくすのがんしき	《スフィンクスの眼識》	名詞
＠す	《スライム縛り》	名詞
＠すら	《スライム縛り》	名詞
＠すらい	《スライム縛り》	名詞
＠すらいむ	《スライム縛り》	名詞
＠すらいむし	《スライム縛り》	名詞
＠すらいむしば	《スライム縛り》	名詞
＠すらいむしばり	《スライム縛り》	名詞
＠て	《テイサ・カルロフ》	名詞
＠てい	《テイサ・カルロフ》	名詞
＠ていさ	《テイサ・カルロフ》	名詞
＠ていさ・	《テイサ・カルロフ》	名詞
＠ていさ・か	《テイサ・カルロフ》	名詞
＠ていさ・かる	《テイサ・カルロフ》	名詞
＠ていさ・かるろ	《テイサ・カルロフ》	名詞
＠ていさ・かるろふ	《テイサ・カルロフ》	名詞
＠と	《トカゲ体の混種》	名詞
＠とか	《トカゲ体の混種》	名詞
＠とかげ	《トカゲ体の混種》	名詞
＠とかげか	《トカゲ体の混種》	名詞
＠とかげから	《トカゲ体の混種》	名詞
＠とかげからだ	《トカゲ体の混種》	名詞
＠とかげからだの	《トカゲ体の混種》	名詞
＠とかげからだのま	《トカゲ体の混種》	名詞
＠とかげからだのまじ	《トカゲ体の混種》	名詞
＠とかげからだのまじり	《トカゲ体の混種》	名詞
＠とかげからだのまじりた	《トカゲ体の混種》	名詞
＠とかげからだのまじりたね	《トカゲ体の混種》	名詞
＠と	《トロール種の守護者》	名詞
＠とろ	《トロール種の守護者》	名詞
＠とろー	《トロール種の守護者》	名詞
＠とろーる	《トロール種の守護者》	名詞
＠とろーるた	《トロール種の守護者》	名詞
＠とろーるたね	《トロール種の守護者》	名詞
＠とろーるたねの	《トロール種の守護者》	名詞
＠とろーるたねのし	《トロール種の守護者》	名詞
＠とろーるたねのしゅ	《トロール種の守護者》	名詞
＠とろーるたねのしゅご	《トロール種の守護者》	名詞
＠とろーるたねのしゅごし	《トロール種の守護者》	名詞
＠とろーるたねのしゅごしゃ	《トロール種の守護者》	名詞
＠ど	《ドビンの放逐》	名詞
＠どび	《ドビンの放逐》	名詞
＠どびん	《ドビンの放逐》	名詞
＠どびんの	《ドビンの放逐》	名詞
＠どびんのほ	《ドビンの放逐》	名詞
＠どびんのほう	《ドビンの放逐》	名詞
＠どびんのほうち	《ドビンの放逐》	名詞
＠どびんのほうちく	《ドビンの放逐》	名詞
＠ど	《ドビンの自動機械》	名詞
＠どび	《ドビンの自動機械》	名詞
＠どびん	《ドビンの自動機械》	名詞
＠どびんの	《ドビンの自動機械》	名詞
＠どびんのじ	《ドビンの自動機械》	名詞
＠どびんのじど	《ドビンの自動機械》	名詞
＠どびんのじどう	《ドビンの自動機械》	名詞
＠どびんのじどうき	《ドビンの自動機械》	名詞
＠どびんのじどうきか	《ドビンの自動機械》	名詞
＠どびんのじどうきかい	《ドビンの自動機械》	名詞
＠ど	《ドビンの鋭感》	名詞
＠どび	《ドビンの鋭感》	名詞
＠どびん	《ドビンの鋭感》	名詞
＠どびんの	《ドビンの鋭感》	名詞
＠どびんのえ	《ドビンの鋭感》	名詞
＠どびんのえい	《ドビンの鋭感》	名詞
＠どびんのえいか	《ドビンの鋭感》	名詞
＠どびんのえいかん	《ドビンの鋭感》	名詞
＠ど	《ドムリのノドログ》	名詞
＠どむ	《ドムリのノドログ》	名詞
＠どむり	《ドムリのノドログ》	名詞
＠どむりの	《ドムリのノドログ》	名詞
＠どむりのの	《ドムリのノドログ》	名詞
＠どむりののど	《ドムリのノドログ》	名詞
＠どむりののどろ	《ドムリのノドログ》	名詞
＠どむりののどろぐ	《ドムリのノドログ》	名詞
＠ど	《ドリルビット》	名詞
＠どり	《ドリルビット》	名詞
＠どりる	《ドリルビット》	名詞
＠どりるび	《ドリルビット》	名詞
＠どりるびっ	《ドリルビット》	名詞
＠どりるびっと	《ドリルビット》	名詞
＠は	《ハイドロイド混成体》	名詞
＠はい	《ハイドロイド混成体》	名詞
＠はいど	《ハイドロイド混成体》	名詞
＠はいどろ	《ハイドロイド混成体》	名詞
＠はいどろい	《ハイドロイド混成体》	名詞
＠はいどろいど	《ハイドロイド混成体》	名詞
＠はいどろいどま	《ハイドロイド混成体》	名詞
＠はいどろいどまじ	《ハイドロイド混成体》	名詞
＠はいどろいどまじり	《ハイドロイド混成体》	名詞
＠はいどろいどまじりせ	《ハイドロイド混成体》	名詞
＠はいどろいどまじりせい	《ハイドロイド混成体》	名詞
＠はいどろいどまじりせいた	《ハイドロイド混成体》	名詞
＠はいどろいどまじりせいたい	《ハイドロイド混成体》	名詞
＠は	《ハズダーの士官》	名詞
＠はず	《ハズダーの士官》	名詞
＠はずだ	《ハズダーの士官》	名詞
＠はずだー	《ハズダーの士官》	名詞
＠はずだーの	《ハズダーの士官》	名詞
＠はずだーのし	《ハズダーの士官》	名詞
＠はずだーのしか	《ハズダーの士官》	名詞
＠はずだーのしかん	《ハズダーの士官》	名詞
＠は	《ハックロバット》	名詞
＠はっ	《ハックロバット》	名詞
＠はっく	《ハックロバット》	名詞
＠はっくろ	《ハックロバット》	名詞
＠はっくろば	《ハックロバット》	名詞
＠はっくろばっ	《ハックロバット》	名詞
＠はっくろばっと	《ハックロバット》	名詞
＠ひ	《ヒレバサミダコ》	名詞
＠ひれ	《ヒレバサミダコ》	名詞
＠ひれば	《ヒレバサミダコ》	名詞
＠ひればさ	《ヒレバサミダコ》	名詞
＠ひればさみ	《ヒレバサミダコ》	名詞
＠ひればさみだ	《ヒレバサミダコ》	名詞
＠ひればさみだこ	《ヒレバサミダコ》	名詞
＠ふ	《フェアリーの決闘者》	名詞
＠ふぇ	《フェアリーの決闘者》	名詞
＠ふぇあ	《フェアリーの決闘者》	名詞
＠ふぇあり	《フェアリーの決闘者》	名詞
＠ふぇありー	《フェアリーの決闘者》	名詞
＠ふぇありーの	《フェアリーの決闘者》	名詞
＠ふぇありーのけ	《フェアリーの決闘者》	名詞
＠ふぇありーのけっ	《フェアリーの決闘者》	名詞
＠ふぇありーのけっと	《フェアリーの決闘者》	名詞
＠ふぇありーのけっとう	《フェアリーの決闘者》	名詞
＠ふぇありーのけっとうし	《フェアリーの決闘者》	名詞
＠ふぇありーのけっとうしゃ	《フェアリーの決闘者》	名詞
＠ぶ	《ブリキ通りの身かわし》	名詞
＠ぶり	《ブリキ通りの身かわし》	名詞
＠ぶりき	《ブリキ通りの身かわし》	名詞
＠ぶりきど	《ブリキ通りの身かわし》	名詞
＠ぶりきどお	《ブリキ通りの身かわし》	名詞
＠ぶりきどおり	《ブリキ通りの身かわし》	名詞
＠ぶりきどおりの	《ブリキ通りの身かわし》	名詞
＠ぶりきどおりのみ	《ブリキ通りの身かわし》	名詞
＠ぶりきどおりのみか	《ブリキ通りの身かわし》	名詞
＠ぶりきどおりのみかわ	《ブリキ通りの身かわし》	名詞
＠ぶりきどおりのみかわし	《ブリキ通りの身かわし》	名詞
＠ぷ	《プテラマンダー》	名詞
＠ぷて	《プテラマンダー》	名詞
＠ぷてら	《プテラマンダー》	名詞
＠ぷてらま	《プテラマンダー》	名詞
＠ぷてらまん	《プテラマンダー》	名詞
＠ぷてらまんだ	《プテラマンダー》	名詞
＠ぷてらまんだー	《プテラマンダー》	名詞
＠ぼ	《ボーラク族の破壊者》	名詞
＠ぼー	《ボーラク族の破壊者》	名詞
＠ぼーら	《ボーラク族の破壊者》	名詞
＠ぼーらく	《ボーラク族の破壊者》	名詞
＠ぼーらくぞ	《ボーラク族の破壊者》	名詞
＠ぼーらくぞく	《ボーラク族の破壊者》	名詞
＠ぼーらくぞくの	《ボーラク族の破壊者》	名詞
＠ぼーらくぞくのは	《ボーラク族の破壊者》	名詞
＠ぼーらくぞくのはか	《ボーラク族の破壊者》	名詞
＠ぼーらくぞくのはかい	《ボーラク族の破壊者》	名詞
＠ぼーらくぞくのはかいし	《ボーラク族の破壊者》	名詞
＠ぼーらくぞくのはかいしゃ	《ボーラク族の破壊者》	名詞
＠ま	《マンモスグモ》	名詞
＠まん	《マンモスグモ》	名詞
＠まんも	《マンモスグモ》	名詞
＠まんもす	《マンモスグモ》	名詞
＠まんもすぐ	《マンモスグモ》	名詞
＠まんもすぐも	《マンモスグモ》	名詞
＠ら	《ラクドスのギルド門》	名詞
＠らく	《ラクドスのギルド門》	名詞
＠らくど	《ラクドスのギルド門》	名詞
＠らくどす	《ラクドスのギルド門》	名詞
＠らくどすの	《ラクドスのギルド門》	名詞
＠らくどすのぎ	《ラクドスのギルド門》	名詞
＠らくどすのぎる	《ラクドスのギルド門》	名詞
＠らくどすのぎるど	《ラクドスのギルド門》	名詞
＠らくどすのぎるども	《ラクドスのギルド門》	名詞
＠らくどすのぎるどもん	《ラクドスのギルド門》	名詞
＠ら	《ラクドスのラッパ吹き》	名詞
＠らく	《ラクドスのラッパ吹き》	名詞
＠らくど	《ラクドスのラッパ吹き》	名詞
＠らくどす	《ラクドスのラッパ吹き》	名詞
＠らくどすの	《ラクドスのラッパ吹き》	名詞
＠らくどすのら	《ラクドスのラッパ吹き》	名詞
＠らくどすのらっ	《ラクドスのラッパ吹き》	名詞
＠らくどすのらっぱ	《ラクドスのラッパ吹き》	名詞
＠らくどすのらっぱふ	《ラクドスのラッパ吹き》	名詞
＠らくどすのらっぱふき	《ラクドスのラッパ吹き》	名詞
＠ら	《ラクドスのロケット》	名詞
＠らく	《ラクドスのロケット》	名詞
＠らくど	《ラクドスのロケット》	名詞
＠らくどす	《ラクドスのロケット》	名詞
＠らくどすの	《ラクドスのロケット》	名詞
＠らくどすのろ	《ラクドスのロケット》	名詞
＠らくどすのろけ	《ラクドスのロケット》	名詞
＠らくどすのろけっ	《ラクドスのロケット》	名詞
＠らくどすのろけっと	《ラクドスのロケット》	名詞
＠ら	《ラクドスの人足》	名詞
＠らく	《ラクドスの人足》	名詞
＠らくど	《ラクドスの人足》	名詞
＠らくどす	《ラクドスの人足》	名詞
＠らくどすの	《ラクドスの人足》	名詞
＠らくどすのに	《ラクドスの人足》	名詞
＠らくどすのにん	《ラクドスの人足》	名詞
＠らくどすのにんそ	《ラクドスの人足》	名詞
＠らくどすのにんそく	《ラクドスの人足》	名詞
＠ら	《ラクドスの火輪使い》	名詞
＠らく	《ラクドスの火輪使い》	名詞
＠らくど	《ラクドスの火輪使い》	名詞
＠らくどす	《ラクドスの火輪使い》	名詞
＠らくどすの	《ラクドスの火輪使い》	名詞
＠らくどすのか	《ラクドスの火輪使い》	名詞
＠らくどすのかり	《ラクドスの火輪使い》	名詞
＠らくどすのかりん	《ラクドスの火輪使い》	名詞
＠らくどすのかりんつ	《ラクドスの火輪使い》	名詞
＠らくどすのかりんつか	《ラクドスの火輪使い》	名詞
＠らくどすのかりんつかい	《ラクドスの火輪使い》	名詞
＠り	《リックス・マーディの歓楽者》	名詞
＠りっ	《リックス・マーディの歓楽者》	名詞
＠りっく	《リックス・マーディの歓楽者》	名詞
＠りっくす	《リックス・マーディの歓楽者》	名詞
＠りっくす・	《リックス・マーディの歓楽者》	名詞
＠りっくす・ま	《リックス・マーディの歓楽者》	名詞
＠りっくす・まー	《リックス・マーディの歓楽者》	名詞
＠りっくす・まーで	《リックス・マーディの歓楽者》	名詞
＠りっくす・まーでぃ	《リックス・マーディの歓楽者》	名詞
＠りっくす・まーでぃの	《リックス・マーディの歓楽者》	名詞
＠りっくす・まーでぃのか	《リックス・マーディの歓楽者》	名詞
＠りっくす・まーでぃのかん	《リックス・マーディの歓楽者》	名詞
＠りっくす・まーでぃのかんら	《リックス・マーディの歓楽者》	名詞
＠りっくす・まーでぃのかんらく	《リックス・マーディの歓楽者》	名詞
＠りっくす・まーでぃのかんらくし	《リックス・マーディの歓楽者》	名詞
＠りっくす・まーでぃのかんらくしゃ	《リックス・マーディの歓楽者》	名詞
＠ヴ	《ヴィズコーパの吸血鬼》	名詞
＠ヴぃ	《ヴィズコーパの吸血鬼》	名詞
＠ヴぃず	《ヴィズコーパの吸血鬼》	名詞
＠ヴぃずこ	《ヴィズコーパの吸血鬼》	名詞
＠ヴぃずこー	《ヴィズコーパの吸血鬼》	名詞
＠ヴぃずこーぱ	《ヴィズコーパの吸血鬼》	名詞
＠ヴぃずこーぱの	《ヴィズコーパの吸血鬼》	名詞
＠ヴぃずこーぱのき	《ヴィズコーパの吸血鬼》	名詞
＠ヴぃずこーぱのきゅ	《ヴィズコーパの吸血鬼》	名詞
＠ヴぃずこーぱのきゅう	《ヴィズコーパの吸血鬼》	名詞
＠ヴぃずこーぱのきゅうけ	《ヴィズコーパの吸血鬼》	名詞
＠ヴぃずこーぱのきゅうけつ	《ヴィズコーパの吸血鬼》	名詞
＠ヴぃずこーぱのきゅうけつき	《ヴィズコーパの吸血鬼》	名詞
＠い	《一族のギルド魔道士》	名詞
＠いち	《一族のギルド魔道士》	名詞
＠いちぞ	《一族のギルド魔道士》	名詞
＠いちぞく	《一族のギルド魔道士》	名詞
＠いちぞくの	《一族のギルド魔道士》	名詞
＠いちぞくのぎ	《一族のギルド魔道士》	名詞
＠いちぞくのぎる	《一族のギルド魔道士》	名詞
＠いちぞくのぎるど	《一族のギルド魔道士》	名詞
＠いちぞくのぎるどま	《一族のギルド魔道士》	名詞
＠いちぞくのぎるどまど	《一族のギルド魔道士》	名詞
＠いちぞくのぎるどまどう	《一族のギルド魔道士》	名詞
＠いちぞくのぎるどまどうし	《一族のギルド魔道士》	名詞
＠い	《一族の暴行》	名詞
＠いち	《一族の暴行》	名詞
＠いちぞ	《一族の暴行》	名詞
＠いちぞく	《一族の暴行》	名詞
＠いちぞくの	《一族の暴行》	名詞
＠いちぞくのぼ	《一族の暴行》	名詞
＠いちぞくのぼう	《一族の暴行》	名詞
＠いちぞくのぼうこ	《一族の暴行》	名詞
＠いちぞくのぼうこう	《一族の暴行》	名詞
＠い	《一面の視線》	名詞
＠いち	《一面の視線》	名詞
＠いちめ	《一面の視線》	名詞
＠いちめん	《一面の視線》	名詞
＠いちめんの	《一面の視線》	名詞
＠いちめんのし	《一面の視線》	名詞
＠いちめんのしせ	《一面の視線》	名詞
＠いちめんのしせん	《一面の視線》	名詞
＠ば	《万全》	名詞
＠ばん	《万全》	名詞
＠ばんぜ	《万全》	名詞
＠ばんぜん	《万全》	名詞
＠ば	《万全+番人》	名詞
＠ばん	《万全+番人》	名詞
＠ばんぜ	《万全+番人》	名詞
＠ばんぜん	《万全+番人》	名詞
＠ばんぜん+	《万全+番人》	名詞
＠ばんぜん+ば	《万全+番人》	名詞
＠ばんぜん+ばん	《万全+番人》	名詞
＠ばんぜん+ばんに	《万全+番人》	名詞
＠ばんぜん+ばんにん	《万全+番人》	名詞
＠ふ	《不和》	名詞
＠ふわ	《不和》	名詞
＠ふ	《不敗の陣形》	名詞
＠ふは	《不敗の陣形》	名詞
＠ふはい	《不敗の陣形》	名詞
＠ふはいの	《不敗の陣形》	名詞
＠ふはいのじ	《不敗の陣形》	名詞
＠ふはいのじん	《不敗の陣形》	名詞
＠ふはいのじんけ	《不敗の陣形》	名詞
＠ふはいのじんけい	《不敗の陣形》	名詞
＠ふ	《不正相続》	名詞
＠ふせ	《不正相続》	名詞
＠ふせい	《不正相続》	名詞
＠ふせいそ	《不正相続》	名詞
＠ふせいそう	《不正相続》	名詞
＠ふせいそうぞ	《不正相続》	名詞
＠ふせいそうぞく	《不正相続》	名詞
＠よ	《予知覚》	名詞
＠よち	《予知覚》	名詞
＠よちか	《予知覚》	名詞
＠よちかく	《予知覚》	名詞
＠よ	《予見のスフィンクス》	名詞
＠よけ	《予見のスフィンクス》	名詞
＠よけん	《予見のスフィンクス》	名詞
＠よけんの	《予見のスフィンクス》	名詞
＠よけんのす	《予見のスフィンクス》	名詞
＠よけんのすふ	《予見のスフィンクス》	名詞
＠よけんのすふぃ	《予見のスフィンクス》	名詞
＠よけんのすふぃん	《予見のスフィンクス》	名詞
＠よけんのすふぃんく	《予見のスフィンクス》	名詞
＠よけんのすふぃんくす	《予見のスフィンクス》	名詞
＠そ	《争闘》	名詞
＠そう	《争闘》	名詞
＠そうと	《争闘》	名詞
＠そうとう	《争闘》	名詞
＠そ	《争闘+壮大》	名詞
＠そう	《争闘+壮大》	名詞
＠そうと	《争闘+壮大》	名詞
＠そうとう	《争闘+壮大》	名詞
＠そうとう+	《争闘+壮大》	名詞
＠そうとう+そ	《争闘+壮大》	名詞
＠そうとう+そう	《争闘+壮大》	名詞
＠そうとう+そうだ	《争闘+壮大》	名詞
＠そうとう+そうだい	《争闘+壮大》	名詞
＠か	《会稽》	名詞
＠かい	《会稽》	名詞
＠かいけ	《会稽》	名詞
＠かいけい	《会稽》	名詞
＠ば	《倍火》	名詞
＠ばい	《倍火》	名詞
＠ばいひ	《倍火》	名詞
＠ご	《傲慢な支配者》	名詞
＠ごう	《傲慢な支配者》	名詞
＠ごうま	《傲慢な支配者》	名詞
＠ごうまん	《傲慢な支配者》	名詞
＠ごうまんな	《傲慢な支配者》	名詞
＠ごうまんなし	《傲慢な支配者》	名詞
＠ごうまんなしは	《傲慢な支配者》	名詞
＠ごうまんなしはい	《傲慢な支配者》	名詞
＠ごうまんなしはいし	《傲慢な支配者》	名詞
＠ごうまんなしはいしゃ	《傲慢な支配者》	名詞
＠さ	《債務の聖職者》	名詞
＠さい	《債務の聖職者》	名詞
＠さいむ	《債務の聖職者》	名詞
＠さいむの	《債務の聖職者》	名詞
＠さいむのせ	《債務の聖職者》	名詞
＠さいむのせい	《債務の聖職者》	名詞
＠さいむのせいし	《債務の聖職者》	名詞
＠さいむのせいしょ	《債務の聖職者》	名詞
＠さいむのせいしょく	《債務の聖職者》	名詞
＠さいむのせいしょくし	《債務の聖職者》	名詞
＠さいむのせいしょくしゃ	《債務の聖職者》	名詞
＠さ	《債務者の輸送》	名詞
＠さい	《債務者の輸送》	名詞
＠さいむ	《債務者の輸送》	名詞
＠さいむし	《債務者の輸送》	名詞
＠さいむしゃ	《債務者の輸送》	名詞
＠さいむしゃの	《債務者の輸送》	名詞
＠さいむしゃのゆ	《債務者の輸送》	名詞
＠さいむしゃのゆそ	《債務者の輸送》	名詞
＠さいむしゃのゆそう	《債務者の輸送》	名詞
＠こ	《公判への移送》	名詞
＠こう	《公判への移送》	名詞
＠こうは	《公判への移送》	名詞
＠こうはん	《公判への移送》	名詞
＠こうはんへ	《公判への移送》	名詞
＠こうはんへの	《公判への移送》	名詞
＠こうはんへのい	《公判への移送》	名詞
＠こうはんへのいそ	《公判への移送》	名詞
＠こうはんへのいそう	《公判への移送》	名詞
＠え	《円環技師》	名詞
＠えん	《円環技師》	名詞
＠えんか	《円環技師》	名詞
＠えんかん	《円環技師》	名詞
＠えんかんぎ	《円環技師》	名詞
＠えんかんぎし	《円環技師》	名詞
＠さ	《再発生》	名詞
＠さい	《再発生》	名詞
＠さいは	《再発生》	名詞
＠さいはっ	《再発生》	名詞
＠さいはっせ	《再発生》	名詞
＠さいはっせい	《再発生》	名詞
＠れ	《冷気をもたらす者》	名詞
＠れい	《冷気をもたらす者》	名詞
＠れいき	《冷気をもたらす者》	名詞
＠れいきを	《冷気をもたらす者》	名詞
＠れいきをも	《冷気をもたらす者》	名詞
＠れいきをもた	《冷気をもたらす者》	名詞
＠れいきをもたら	《冷気をもたらす者》	名詞
＠れいきをもたらす	《冷気をもたらす者》	名詞
＠れいきをもたらすも	《冷気をもたらす者》	名詞
＠れいきをもたらすもの	《冷気をもたらす者》	名詞
＠は	《刃の曲芸人》	名詞
＠はの	《刃の曲芸人》	名詞
＠はのき	《刃の曲芸人》	名詞
＠はのきょ	《刃の曲芸人》	名詞
＠はのきょく	《刃の曲芸人》	名詞
＠はのきょくげ	《刃の曲芸人》	名詞
＠はのきょくげい	《刃の曲芸人》	名詞
＠はのきょくげいに	《刃の曲芸人》	名詞
＠はのきょくげいにん	《刃の曲芸人》	名詞
＠せ	《制動規範》	名詞
＠せい	《制動規範》	名詞
＠せいど	《制動規範》	名詞
＠せいどう	《制動規範》	名詞
＠せいどうき	《制動規範》	名詞
＠せいどうきは	《制動規範》	名詞
＠せいどうきはん	《制動規範》	名詞
＠ご	《剛力の殴り合い》	名詞
＠ごう	《剛力の殴り合い》	名詞
＠ごうり	《剛力の殴り合い》	名詞
＠ごうりき	《剛力の殴り合い》	名詞
＠ごうりきの	《剛力の殴り合い》	名詞
＠ごうりきのな	《剛力の殴り合い》	名詞
＠ごうりきのなぐ	《剛力の殴り合い》	名詞
＠ごうりきのなぐり	《剛力の殴り合い》	名詞
＠ごうりきのなぐりあ	《剛力の殴り合い》	名詞
＠ごうりきのなぐりあい	《剛力の殴り合い》	名詞
＠き	《協約のペガサス》	名詞
＠きょ	《協約のペガサス》	名詞
＠きょう	《協約のペガサス》	名詞
＠きょうや	《協約のペガサス》	名詞
＠きょうやく	《協約のペガサス》	名詞
＠きょうやくの	《協約のペガサス》	名詞
＠きょうやくのぺ	《協約のペガサス》	名詞
＠きょうやくのぺが	《協約のペガサス》	名詞
＠きょうやくのぺがさ	《協約のペガサス》	名詞
＠きょうやくのぺがさす	《協約のペガサス》	名詞
＠げ	《厳戒態勢》	名詞
＠げん	《厳戒態勢》	名詞
＠げんか	《厳戒態勢》	名詞
＠げんかい	《厳戒態勢》	名詞
＠げんかいた	《厳戒態勢》	名詞
＠げんかいたい	《厳戒態勢》	名詞
＠げんかいたいせ	《厳戒態勢》	名詞
＠げんかいたいせい	《厳戒態勢》	名詞
＠は	《反逆の行動》	名詞
＠はん	《反逆の行動》	名詞
＠はんぎ	《反逆の行動》	名詞
＠はんぎゃ	《反逆の行動》	名詞
＠はんぎゃく	《反逆の行動》	名詞
＠はんぎゃくの	《反逆の行動》	名詞
＠はんぎゃくのこ	《反逆の行動》	名詞
＠はんぎゃくのこう	《反逆の行動》	名詞
＠はんぎゃくのこうど	《反逆の行動》	名詞
＠はんぎゃくのこうどう	《反逆の行動》	名詞
＠た	《叩打》	名詞
＠たた	《叩打》	名詞
＠たたき	《叩打》	名詞
＠たたきだ	《叩打》	名詞
＠さ	《叫び盾》	名詞
＠さけ	《叫び盾》	名詞
＠さけび	《叫び盾》	名詞
＠さけびだ	《叫び盾》	名詞
＠さけびだて	《叫び盾》	名詞
＠か	《可能性の揺らぎ》	名詞
＠かの	《可能性の揺らぎ》	名詞
＠かのう	《可能性の揺らぎ》	名詞
＠かのうせ	《可能性の揺らぎ》	名詞
＠かのうせい	《可能性の揺らぎ》	名詞
＠かのうせいの	《可能性の揺らぎ》	名詞
＠かのうせいのゆ	《可能性の揺らぎ》	名詞
＠かのうせいのゆら	《可能性の揺らぎ》	名詞
＠かのうせいのゆらぎ	《可能性の揺らぎ》	名詞
＠め	《名演撃、ラクドス》	名詞
＠めい	《名演撃、ラクドス》	名詞
＠めいえ	《名演撃、ラクドス》	名詞
＠めいえん	《名演撃、ラクドス》	名詞
＠めいえんう	《名演撃、ラクドス》	名詞
＠めいえんうち	《名演撃、ラクドス》	名詞
＠めいえんうち、	《名演撃、ラクドス》	名詞
＠めいえんうち、ら	《名演撃、ラクドス》	名詞
＠めいえんうち、らく	《名演撃、ラクドス》	名詞
＠めいえんうち、らくど	《名演撃、ラクドス》	名詞
＠めいえんうち、らくどす	《名演撃、ラクドス》	名詞
＠き	《吸収》	名詞
＠きゅ	《吸収》	名詞
＠きゅう	《吸収》	名詞
＠きゅうし	《吸収》	名詞
＠きゅうしゅ	《吸収》	名詞
＠きゅうしゅう	《吸収》	名詞
＠と	《囚われの聴衆》	名詞
＠とら	《囚われの聴衆》	名詞
＠とらわ	《囚われの聴衆》	名詞
＠とらわれ	《囚われの聴衆》	名詞
＠とらわれの	《囚われの聴衆》	名詞
＠とらわれのち	《囚われの聴衆》	名詞
＠とらわれのちょ	《囚われの聴衆》	名詞
＠とらわれのちょう	《囚われの聴衆》	名詞
＠とらわれのちょうし	《囚われの聴衆》	名詞
＠とらわれのちょうしゅ	《囚われの聴衆》	名詞
＠とらわれのちょうしゅう	《囚われの聴衆》	名詞
＠か	《回生》	名詞
＠かい	《回生》	名詞
＠かいせ	《回生》	名詞
＠かいせい	《回生》	名詞
＠か	《回生+会稽》	名詞
＠かい	《回生+会稽》	名詞
＠かいせ	《回生+会稽》	名詞
＠かいせい	《回生+会稽》	名詞
＠かいせい+	《回生+会稽》	名詞
＠かいせい+か	《回生+会稽》	名詞
＠かいせい+かい	《回生+会稽》	名詞
＠かいせい+かいけ	《回生+会稽》	名詞
＠かいせい+かいけい	《回生+会稽》	名詞
＠ち	《地下墓地のクロコダイル》	名詞
＠ちか	《地下墓地のクロコダイル》	名詞
＠ちかぼ	《地下墓地のクロコダイル》	名詞
＠ちかぼち	《地下墓地のクロコダイル》	名詞
＠ちかぼちの	《地下墓地のクロコダイル》	名詞
＠ちかぼちのく	《地下墓地のクロコダイル》	名詞
＠ちかぼちのくろ	《地下墓地のクロコダイル》	名詞
＠ちかぼちのくろこ	《地下墓地のクロコダイル》	名詞
＠ちかぼちのくろこだ	《地下墓地のクロコダイル》	名詞
＠ちかぼちのくろこだい	《地下墓地のクロコダイル》	名詞
＠ちかぼちのくろこだいる	《地下墓地のクロコダイル》	名詞
＠ち	《地底街のゴミあさり》	名詞
＠ちて	《地底街のゴミあさり》	名詞
＠ちてい	《地底街のゴミあさり》	名詞
＠ちていま	《地底街のゴミあさり》	名詞
＠ちていまち	《地底街のゴミあさり》	名詞
＠ちていまちの	《地底街のゴミあさり》	名詞
＠ちていまちのご	《地底街のゴミあさり》	名詞
＠ちていまちのごみ	《地底街のゴミあさり》	名詞
＠ちていまちのごみあ	《地底街のゴミあさり》	名詞
＠ちていまちのごみあさ	《地底街のゴミあさり》	名詞
＠ちていまちのごみあさり	《地底街のゴミあさり》	名詞
＠ち	《地底街の抱擁》	名詞
＠ちて	《地底街の抱擁》	名詞
＠ちてい	《地底街の抱擁》	名詞
＠ちていま	《地底街の抱擁》	名詞
＠ちていまち	《地底街の抱擁》	名詞
＠ちていまちの	《地底街の抱擁》	名詞
＠ちていまちのほ	《地底街の抱擁》	名詞
＠ちていまちのほう	《地底街の抱擁》	名詞
＠ちていまちのほうよ	《地底街の抱擁》	名詞
＠ちていまちのほうよう	《地底街の抱擁》	名詞
＠し	《垂木の悪魔》	名詞
＠しだ	《垂木の悪魔》	名詞
＠しだれ	《垂木の悪魔》	名詞
＠しだれぎ	《垂木の悪魔》	名詞
＠しだれぎの	《垂木の悪魔》	名詞
＠しだれぎのあ	《垂木の悪魔》	名詞
＠しだれぎのあく	《垂木の悪魔》	名詞
＠しだれぎのあくま	《垂木の悪魔》	名詞
＠し	《執念深い吸血鬼》	名詞
＠しゅ	《執念深い吸血鬼》	名詞
＠しゅう	《執念深い吸血鬼》	名詞
＠しゅうね	《執念深い吸血鬼》	名詞
＠しゅうねん	《執念深い吸血鬼》	名詞
＠しゅうねんぶ	《執念深い吸血鬼》	名詞
＠しゅうねんぶか	《執念深い吸血鬼》	名詞
＠しゅうねんぶかい	《執念深い吸血鬼》	名詞
＠しゅうねんぶかいき	《執念深い吸血鬼》	名詞
＠しゅうねんぶかいきゅ	《執念深い吸血鬼》	名詞
＠しゅうねんぶかいきゅう	《執念深い吸血鬼》	名詞
＠しゅうねんぶかいきゅうけ	《執念深い吸血鬼》	名詞
＠しゅうねんぶかいきゅうけつ	《執念深い吸血鬼》	名詞
＠しゅうねんぶかいきゅうけつき	《執念深い吸血鬼》	名詞
＠ば	《培養ドルイド》	名詞
＠ばい	《培養ドルイド》	名詞
＠ばいよ	《培養ドルイド》	名詞
＠ばいよう	《培養ドルイド》	名詞
＠ばいようど	《培養ドルイド》	名詞
＠ばいようどる	《培養ドルイド》	名詞
＠ばいようどるい	《培養ドルイド》	名詞
＠ばいようどるいど	《培養ドルイド》	名詞
＠と	《塔の防衛》	名詞
＠とう	《塔の防衛》	名詞
＠とうの	《塔の防衛》	名詞
＠とうのぼ	《塔の防衛》	名詞
＠とうのぼう	《塔の防衛》	名詞
＠とうのぼうえ	《塔の防衛》	名詞
＠とうのぼうえい	《塔の防衛》	名詞
＠そ	《壮大》	名詞
＠そう	《壮大》	名詞
＠そうだ	《壮大》	名詞
＠そうだい	《壮大》	名詞
＠だ	《大ムンクルス》	名詞
＠だい	《大ムンクルス》	名詞
＠だいむ	《大ムンクルス》	名詞
＠だいむん	《大ムンクルス》	名詞
＠だいむんく	《大ムンクルス》	名詞
＠だいむんくる	《大ムンクルス》	名詞
＠だいむんくるす	《大ムンクルス》	名詞
＠だ	《大判事、ドビン》	名詞
＠だい	《大判事、ドビン》	名詞
＠だいは	《大判事、ドビン》	名詞
＠だいはん	《大判事、ドビン》	名詞
＠だいはんじ	《大判事、ドビン》	名詞
＠だいはんじ、	《大判事、ドビン》	名詞
＠だいはんじ、ど	《大判事、ドビン》	名詞
＠だいはんじ、どび	《大判事、ドビン》	名詞
＠だいはんじ、どびん	《大判事、ドビン》	名詞
＠だ	《大司法官の扉》	名詞
＠だい	《大司法官の扉》	名詞
＠だいし	《大司法官の扉》	名詞
＠だいしほ	《大司法官の扉》	名詞
＠だいしほう	《大司法官の扉》	名詞
＠だいしほうか	《大司法官の扉》	名詞
＠だいしほうかん	《大司法官の扉》	名詞
＠だいしほうかんの	《大司法官の扉》	名詞
＠だいしほうかんのと	《大司法官の扉》	名詞
＠だいしほうかんのとび	《大司法官の扉》	名詞
＠だいしほうかんのとびら	《大司法官の扉》	名詞
＠て	《天上の赦免》	名詞
＠てん	《天上の赦免》	名詞
＠てんじ	《天上の赦免》	名詞
＠てんじょ	《天上の赦免》	名詞
＠てんじょう	《天上の赦免》	名詞
＠てんじょうの	《天上の赦免》	名詞
＠てんじょうのし	《天上の赦免》	名詞
＠てんじょうのしゃ	《天上の赦免》	名詞
＠てんじょうのしゃめ	《天上の赦免》	名詞
＠てんじょうのしゃめん	《天上の赦免》	名詞
＠て	《天使の称賛》	名詞
＠てん	《天使の称賛》	名詞
＠てんし	《天使の称賛》	名詞
＠てんしの	《天使の称賛》	名詞
＠てんしのし	《天使の称賛》	名詞
＠てんしのしょ	《天使の称賛》	名詞
＠てんしのしょう	《天使の称賛》	名詞
＠てんしのしょうさ	《天使の称賛》	名詞
＠てんしのしょうさん	《天使の称賛》	名詞
＠き	《奇怪な死》	名詞
＠きか	《奇怪な死》	名詞
＠きかい	《奇怪な死》	名詞
＠きかいな	《奇怪な死》	名詞
＠きかいなし	《奇怪な死》	名詞
＠な	《奈落への放逐》	名詞
＠なら	《奈落への放逐》	名詞
＠ならく	《奈落への放逐》	名詞
＠ならくへ	《奈落への放逐》	名詞
＠ならくへの	《奈落への放逐》	名詞
＠ならくへのほ	《奈落への放逐》	名詞
＠ならくへのほう	《奈落への放逐》	名詞
＠ならくへのほうち	《奈落への放逐》	名詞
＠ならくへのほうちく	《奈落への放逐》	名詞
＠ふ	《孵化》	名詞
＠ふか	《孵化》	名詞
＠ふ	《孵化+不和》	名詞
＠ふか	《孵化+不和》	名詞
＠ふか+	《孵化+不和》	名詞
＠ふか+ふ	《孵化+不和》	名詞
＠ふか+ふわ	《孵化+不和》	名詞
＠し	《守護者計画》	名詞
＠しゅ	《守護者計画》	名詞
＠しゅご	《守護者計画》	名詞
＠しゅごし	《守護者計画》	名詞
＠しゅごしゃ	《守護者計画》	名詞
＠しゅごしゃけ	《守護者計画》	名詞
＠しゅごしゃけい	《守護者計画》	名詞
＠しゅごしゃけいか	《守護者計画》	名詞
＠しゅごしゃけいかく	《守護者計画》	名詞
＠こ	《小走りワニ》	名詞
＠こば	《小走りワニ》	名詞
＠こばし	《小走りワニ》	名詞
＠こばしり	《小走りワニ》	名詞
＠こばしりわ	《小走りワニ》	名詞
＠こばしりわに	《小走りワニ》	名詞
＠せ	《尖塔に忍び寄るもの》	名詞
＠せん	《尖塔に忍び寄るもの》	名詞
＠せんと	《尖塔に忍び寄るもの》	名詞
＠せんとう	《尖塔に忍び寄るもの》	名詞
＠せんとうに	《尖塔に忍び寄るもの》	名詞
＠せんとうにし	《尖塔に忍び寄るもの》	名詞
＠せんとうにしの	《尖塔に忍び寄るもの》	名詞
＠せんとうにしのび	《尖塔に忍び寄るもの》	名詞
＠せんとうにしのびよ	《尖塔に忍び寄るもの》	名詞
＠せんとうにしのびよる	《尖塔に忍び寄るもの》	名詞
＠せんとうにしのびよるも	《尖塔に忍び寄るもの》	名詞
＠せんとうにしのびよるもの	《尖塔に忍び寄るもの》	名詞
＠せ	《尖塔の刻み虫》	名詞
＠せん	《尖塔の刻み虫》	名詞
＠せんと	《尖塔の刻み虫》	名詞
＠せんとう	《尖塔の刻み虫》	名詞
＠せんとうの	《尖塔の刻み虫》	名詞
＠せんとうのき	《尖塔の刻み虫》	名詞
＠せんとうのきざ	《尖塔の刻み虫》	名詞
＠せんとうのきざみ	《尖塔の刻み虫》	名詞
＠せんとうのきざみむ	《尖塔の刻み虫》	名詞
＠せんとうのきざみむし	《尖塔の刻み虫》	名詞
＠せ	《尖塔の霊》	名詞
＠せん	《尖塔の霊》	名詞
＠せんと	《尖塔の霊》	名詞
＠せんとう	《尖塔の霊》	名詞
＠せんとうの	《尖塔の霊》	名詞
＠せんとうのれ	《尖塔の霊》	名詞
＠せんとうのれい	《尖塔の霊》	名詞
＠く	《屈辱》	名詞
＠くつ	《屈辱》	名詞
＠くつじ	《屈辱》	名詞
＠くつじょ	《屈辱》	名詞
＠くつじょく	《屈辱》	名詞
＠し	《屍肉インプ》	名詞
＠しに	《屍肉インプ》	名詞
＠しにく	《屍肉インプ》	名詞
＠しにくい	《屍肉インプ》	名詞
＠しにくいん	《屍肉インプ》	名詞
＠しにくいんぷ	《屍肉インプ》	名詞
＠や	《山》	名詞
＠やま	《山》	名詞
＠じ	《島》	名詞
＠じま	《島》	名詞
＠あ	《嵐の一撃》	名詞
＠あら	《嵐の一撃》	名詞
＠あらし	《嵐の一撃》	名詞
＠あらしの	《嵐の一撃》	名詞
＠あらしのい	《嵐の一撃》	名詞
＠あらしのいち	《嵐の一撃》	名詞
＠あらしのいちげ	《嵐の一撃》	名詞
＠あらしのいちげき	《嵐の一撃》	名詞
＠へ	《平地》	名詞
＠へい	《平地》	名詞
＠へいち	《平地》	名詞
＠ひ	《引き裂くシャーマン》	名詞
＠ひき	《引き裂くシャーマン》	名詞
＠ひきさ	《引き裂くシャーマン》	名詞
＠ひきさく	《引き裂くシャーマン》	名詞
＠ひきさくし	《引き裂くシャーマン》	名詞
＠ひきさくしゃ	《引き裂くシャーマン》	名詞
＠ひきさくしゃー	《引き裂くシャーマン》	名詞
＠ひきさくしゃーま	《引き裂くシャーマン》	名詞
＠ひきさくしゃーまん	《引き裂くシャーマン》	名詞
＠き	《強撃》	名詞
＠きょ	《強撃》	名詞
＠きょう	《強撃》	名詞
＠きょうう	《強撃》	名詞
＠きょううち	《強撃》	名詞
＠き	《強撃+脅威》	名詞
＠きょ	《強撃+脅威》	名詞
＠きょう	《強撃+脅威》	名詞
＠きょうう	《強撃+脅威》	名詞
＠きょううち	《強撃+脅威》	名詞
＠きょううち+	《強撃+脅威》	名詞
＠きょううち+き	《強撃+脅威》	名詞
＠きょううち+きょ	《強撃+脅威》	名詞
＠きょううち+きょう	《強撃+脅威》	名詞
＠きょううち+きょうい	《強撃+脅威》	名詞
＠お	《往時軍の覚醒》	名詞
＠おう	《往時軍の覚醒》	名詞
＠おうじ	《往時軍の覚醒》	名詞
＠おうじぐ	《往時軍の覚醒》	名詞
＠おうじぐん	《往時軍の覚醒》	名詞
＠おうじぐんの	《往時軍の覚醒》	名詞
＠おうじぐんのか	《往時軍の覚醒》	名詞
＠おうじぐんのかく	《往時軍の覚醒》	名詞
＠おうじぐんのかくせ	《往時軍の覚醒》	名詞
＠おうじぐんのかくせい	《往時軍の覚醒》	名詞
＠ち	《徴税人》	名詞
＠ちょ	《徴税人》	名詞
＠ちょう	《徴税人》	名詞
＠ちょうぜ	《徴税人》	名詞
＠ちょうぜい	《徴税人》	名詞
＠ちょうぜいじ	《徴税人》	名詞
＠ちょうぜいじん	《徴税人》	名詞
＠わ	《忘れられた神々の僧侶》	名詞
＠わす	《忘れられた神々の僧侶》	名詞
＠わすれ	《忘れられた神々の僧侶》	名詞
＠わすれら	《忘れられた神々の僧侶》	名詞
＠わすれられ	《忘れられた神々の僧侶》	名詞
＠わすれられた	《忘れられた神々の僧侶》	名詞
＠わすれられたか	《忘れられた神々の僧侶》	名詞
＠わすれられたかみ	《忘れられた神々の僧侶》	名詞
＠わすれられたかみが	《忘れられた神々の僧侶》	名詞
＠わすれられたかみがみ	《忘れられた神々の僧侶》	名詞
＠わすれられたかみがみの	《忘れられた神々の僧侶》	名詞
＠わすれられたかみがみのそ	《忘れられた神々の僧侶》	名詞
＠わすれられたかみがみのそう	《忘れられた神々の僧侶》	名詞
＠わすれられたかみがみのそうり	《忘れられた神々の僧侶》	名詞
＠わすれられたかみがみのそうりょ	《忘れられた神々の僧侶》	名詞
＠お	《応用生術》	名詞
＠おう	《応用生術》	名詞
＠おうよ	《応用生術》	名詞
＠おうよう	《応用生術》	名詞
＠おうような	《応用生術》	名詞
＠おうようなま	《応用生術》	名詞
＠おうようなまじ	《応用生術》	名詞
＠おうようなまじゅ	《応用生術》	名詞
＠おうようなまじゅつ	《応用生術》	名詞
＠い	《怒り火》	名詞
＠いか	《怒り火》	名詞
＠いかり	《怒り火》	名詞
＠いかりひ	《怒り火》	名詞
＠し	《思考崩壊》	名詞
＠しこ	《思考崩壊》	名詞
＠しこう	《思考崩壊》	名詞
＠しこうほ	《思考崩壊》	名詞
＠しこうほう	《思考崩壊》	名詞
＠しこうほうか	《思考崩壊》	名詞
＠しこうほうかい	《思考崩壊》	名詞
＠き	《恐怖の劇場》	名詞
＠きょ	《恐怖の劇場》	名詞
＠きょう	《恐怖の劇場》	名詞
＠きょうふ	《恐怖の劇場》	名詞
＠きょうふの	《恐怖の劇場》	名詞
＠きょうふのげ	《恐怖の劇場》	名詞
＠きょうふのげき	《恐怖の劇場》	名詞
＠きょうふのげきじ	《恐怖の劇場》	名詞
＠きょうふのげきじょ	《恐怖の劇場》	名詞
＠きょうふのげきじょう	《恐怖の劇場》	名詞
＠お	《恩寵の天使》	名詞
＠おん	《恩寵の天使》	名詞
＠おんち	《恩寵の天使》	名詞
＠おんちょ	《恩寵の天使》	名詞
＠おんちょう	《恩寵の天使》	名詞
＠おんちょうの	《恩寵の天使》	名詞
＠おんちょうのて	《恩寵の天使》	名詞
＠おんちょうのてん	《恩寵の天使》	名詞
＠おんちょうのてんし	《恩寵の天使》	名詞
＠い	《息詰まる徴税》	名詞
＠いき	《息詰まる徴税》	名詞
＠いきづ	《息詰まる徴税》	名詞
＠いきづま	《息詰まる徴税》	名詞
＠いきづまる	《息詰まる徴税》	名詞
＠いきづまるち	《息詰まる徴税》	名詞
＠いきづまるちょ	《息詰まる徴税》	名詞
＠いきづまるちょう	《息詰まる徴税》	名詞
＠いきづまるちょうぜ	《息詰まる徴税》	名詞
＠いきづまるちょうぜい	《息詰まる徴税》	名詞
＠か	《悲しみの騎士》	名詞
＠かな	《悲しみの騎士》	名詞
＠かなし	《悲しみの騎士》	名詞
＠かなしみ	《悲しみの騎士》	名詞
＠かなしみの	《悲しみの騎士》	名詞
＠かなしみのき	《悲しみの騎士》	名詞
＠かなしみのきし	《悲しみの騎士》	名詞
＠じ	《情熱的な扇動者》	名詞
＠じょ	《情熱的な扇動者》	名詞
＠じょう	《情熱的な扇動者》	名詞
＠じょうね	《情熱的な扇動者》	名詞
＠じょうねつ	《情熱的な扇動者》	名詞
＠じょうねつて	《情熱的な扇動者》	名詞
＠じょうねつてき	《情熱的な扇動者》	名詞
＠じょうねつてきな	《情熱的な扇動者》	名詞
＠じょうねつてきなせ	《情熱的な扇動者》	名詞
＠じょうねつてきなせん	《情熱的な扇動者》	名詞
＠じょうねつてきなせんど	《情熱的な扇動者》	名詞
＠じょうねつてきなせんどう	《情熱的な扇動者》	名詞
＠じょうねつてきなせんどうし	《情熱的な扇動者》	名詞
＠じょうねつてきなせんどうしゃ	《情熱的な扇動者》	名詞
＠せ	《成長のらせん》	名詞
＠せい	《成長のらせん》	名詞
＠せいち	《成長のらせん》	名詞
＠せいちょ	《成長のらせん》	名詞
＠せいちょう	《成長のらせん》	名詞
＠せいちょうの	《成長のらせん》	名詞
＠せいちょうのら	《成長のらせん》	名詞
＠せいちょうのらせ	《成長のらせん》	名詞
＠せいちょうのらせん	《成長のらせん》	名詞
＠せ	《成長室の守護者》	名詞
＠せい	《成長室の守護者》	名詞
＠せいち	《成長室の守護者》	名詞
＠せいちょ	《成長室の守護者》	名詞
＠せいちょう	《成長室の守護者》	名詞
＠せいちょうし	《成長室の守護者》	名詞
＠せいちょうしつ	《成長室の守護者》	名詞
＠せいちょうしつの	《成長室の守護者》	名詞
＠せいちょうしつのし	《成長室の守護者》	名詞
＠せいちょうしつのしゅ	《成長室の守護者》	名詞
＠せいちょうしつのしゅご	《成長室の守護者》	名詞
＠せいちょうしつのしゅごし	《成長室の守護者》	名詞
＠せいちょうしつのしゅごしゃ	《成長室の守護者》	名詞
＠た	《戦いへの結集》	名詞
＠たた	《戦いへの結集》	名詞
＠たたか	《戦いへの結集》	名詞
＠たたかい	《戦いへの結集》	名詞
＠たたかいへ	《戦いへの結集》	名詞
＠たたかいへの	《戦いへの結集》	名詞
＠たたかいへのけ	《戦いへの結集》	名詞
＠たたかいへのけっ	《戦いへの結集》	名詞
＠たたかいへのけっし	《戦いへの結集》	名詞
＠たたかいへのけっしゅ	《戦いへの結集》	名詞
＠たたかいへのけっしゅう	《戦いへの結集》	名詞
＠ひ	《批判家刺殺》	名詞
＠ひは	《批判家刺殺》	名詞
＠ひはん	《批判家刺殺》	名詞
＠ひはんい	《批判家刺殺》	名詞
＠ひはんいえ	《批判家刺殺》	名詞
＠ひはんいえし	《批判家刺殺》	名詞
＠ひはんいえしさ	《批判家刺殺》	名詞
＠ひはんいえしさつ	《批判家刺殺》	名詞
＠こ	《拘引者の忠告》	名詞
＠こう	《拘引者の忠告》	名詞
＠こうい	《拘引者の忠告》	名詞
＠こういん	《拘引者の忠告》	名詞
＠こういんし	《拘引者の忠告》	名詞
＠こういんしゃ	《拘引者の忠告》	名詞
＠こういんしゃの	《拘引者の忠告》	名詞
＠こういんしゃのち	《拘引者の忠告》	名詞
＠こういんしゃのちゅ	《拘引者の忠告》	名詞
＠こういんしゃのちゅう	《拘引者の忠告》	名詞
＠こういんしゃのちゅうこ	《拘引者の忠告》	名詞
＠こういんしゃのちゅうこく	《拘引者の忠告》	名詞
＠こ	《拘引者の熱情》	名詞
＠こう	《拘引者の熱情》	名詞
＠こうい	《拘引者の熱情》	名詞
＠こういん	《拘引者の熱情》	名詞
＠こういんし	《拘引者の熱情》	名詞
＠こういんしゃ	《拘引者の熱情》	名詞
＠こういんしゃの	《拘引者の熱情》	名詞
＠こういんしゃのね	《拘引者の熱情》	名詞
＠こういんしゃのねつ	《拘引者の熱情》	名詞
＠こういんしゃのねつじ	《拘引者の熱情》	名詞
＠こういんしゃのねつじょ	《拘引者の熱情》	名詞
＠こういんしゃのねつじょう	《拘引者の熱情》	名詞
＠こ	《拘留代理人》	名詞
＠こう	《拘留代理人》	名詞
＠こうり	《拘留代理人》	名詞
＠こうりゅ	《拘留代理人》	名詞
＠こうりゅう	《拘留代理人》	名詞
＠こうりゅうだ	《拘留代理人》	名詞
＠こうりゅうだい	《拘留代理人》	名詞
＠こうりゅうだいり	《拘留代理人》	名詞
＠こうりゅうだいりに	《拘留代理人》	名詞
＠こうりゅうだいりにん	《拘留代理人》	名詞
＠ま	《摩損》	名詞
＠まそ	《摩損》	名詞
＠まそん	《摩損》	名詞
＠き	《教団のギルド魔道士》	名詞
＠きょ	《教団のギルド魔道士》	名詞
＠きょう	《教団のギルド魔道士》	名詞
＠きょうだ	《教団のギルド魔道士》	名詞
＠きょうだん	《教団のギルド魔道士》	名詞
＠きょうだんの	《教団のギルド魔道士》	名詞
＠きょうだんのぎ	《教団のギルド魔道士》	名詞
＠きょうだんのぎる	《教団のギルド魔道士》	名詞
＠きょうだんのぎるど	《教団のギルド魔道士》	名詞
＠きょうだんのぎるどま	《教団のギルド魔道士》	名詞
＠きょうだんのぎるどまど	《教団のギルド魔道士》	名詞
＠きょうだんのぎるどまどう	《教団のギルド魔道士》	名詞
＠きょうだんのぎるどまどうし	《教団のギルド魔道士》	名詞
＠お	《斧折りの獣》	名詞
＠おの	《斧折りの獣》	名詞
＠おのお	《斧折りの獣》	名詞
＠おのおり	《斧折りの獣》	名詞
＠おのおりの	《斧折りの獣》	名詞
＠おのおりのけ	《斧折りの獣》	名詞
＠おのおりのけも	《斧折りの獣》	名詞
＠おのおりのけもの	《斧折りの獣》	名詞
＠し	《新プラーフのスフィンクス》	名詞
＠しん	《新プラーフのスフィンクス》	名詞
＠しんぷ	《新プラーフのスフィンクス》	名詞
＠しんぷら	《新プラーフのスフィンクス》	名詞
＠しんぷらー	《新プラーフのスフィンクス》	名詞
＠しんぷらーふ	《新プラーフのスフィンクス》	名詞
＠しんぷらーふの	《新プラーフのスフィンクス》	名詞
＠しんぷらーふのす	《新プラーフのスフィンクス》	名詞
＠しんぷらーふのすふ	《新プラーフのスフィンクス》	名詞
＠しんぷらーふのすふぃ	《新プラーフのスフィンクス》	名詞
＠しんぷらーふのすふぃん	《新プラーフのスフィンクス》	名詞
＠しんぷらーふのすふぃんく	《新プラーフのスフィンクス》	名詞
＠しんぷらーふのすふぃんくす	《新プラーフのスフィンクス》	名詞
＠ひ	《日晒し》	名詞
＠ひざ	《日晒し》	名詞
＠ひざら	《日晒し》	名詞
＠ひざらし	《日晒し》	名詞
＠ふ	《旧き道のニーキャ》	名詞
＠ふる	《旧き道のニーキャ》	名詞
＠ふるき	《旧き道のニーキャ》	名詞
＠ふるきみ	《旧き道のニーキャ》	名詞
＠ふるきみち	《旧き道のニーキャ》	名詞
＠ふるきみちの	《旧き道のニーキャ》	名詞
＠ふるきみちのに	《旧き道のニーキャ》	名詞
＠ふるきみちのにー	《旧き道のニーキャ》	名詞
＠ふるきみちのにーき	《旧き道のニーキャ》	名詞
＠ふるきみちのにーきゃ	《旧き道のニーキャ》	名詞
＠は	《早駆けるトカゲ蛙》	名詞
＠はや	《早駆けるトカゲ蛙》	名詞
＠はやか	《早駆けるトカゲ蛙》	名詞
＠はやかけ	《早駆けるトカゲ蛙》	名詞
＠はやかける	《早駆けるトカゲ蛙》	名詞
＠はやかけると	《早駆けるトカゲ蛙》	名詞
＠はやかけるとか	《早駆けるトカゲ蛙》	名詞
＠はやかけるとかげ	《早駆けるトカゲ蛙》	名詞
＠はやかけるとかげか	《早駆けるトカゲ蛙》	名詞
＠はやかけるとかげかえ	《早駆けるトカゲ蛙》	名詞
＠はやかけるとかげかえる	《早駆けるトカゲ蛙》	名詞
＠し	《昇華》	名詞
＠しょ	《昇華》	名詞
＠しょう	《昇華》	名詞
＠しょうか	《昇華》	名詞
＠し	《昇華+消耗》	名詞
＠しょ	《昇華+消耗》	名詞
＠しょう	《昇華+消耗》	名詞
＠しょうか	《昇華+消耗》	名詞
＠しょうか+	《昇華+消耗》	名詞
＠しょうか+し	《昇華+消耗》	名詞
＠しょうか+しょ	《昇華+消耗》	名詞
＠しょうか+しょう	《昇華+消耗》	名詞
＠しょうか+しょうも	《昇華+消耗》	名詞
＠しょうか+しょうもう	《昇華+消耗》	名詞
＠あ	《暴れ回る裂き角》	名詞
＠あば	《暴れ回る裂き角》	名詞
＠あばれ	《暴れ回る裂き角》	名詞
＠あばれま	《暴れ回る裂き角》	名詞
＠あばれまわ	《暴れ回る裂き角》	名詞
＠あばれまわる	《暴れ回る裂き角》	名詞
＠あばれまわるさ	《暴れ回る裂き角》	名詞
＠あばれまわるさき	《暴れ回る裂き角》	名詞
＠あばれまわるさきか	《暴れ回る裂き角》	名詞
＠あばれまわるさきかく	《暴れ回る裂き角》	名詞
＠ぼ	《暴風のドレイク》	名詞
＠ぼう	《暴風のドレイク》	名詞
＠ぼうふ	《暴風のドレイク》	名詞
＠ぼうふう	《暴風のドレイク》	名詞
＠ぼうふうの	《暴風のドレイク》	名詞
＠ぼうふうのど	《暴風のドレイク》	名詞
＠ぼうふうのどれ	《暴風のドレイク》	名詞
＠ぼうふうのどれい	《暴風のドレイク》	名詞
＠ぼうふうのどれいく	《暴風のドレイク》	名詞
＠さ	《最後の支払い》	名詞
＠さい	《最後の支払い》	名詞
＠さいご	《最後の支払い》	名詞
＠さいごの	《最後の支払い》	名詞
＠さいごのし	《最後の支払い》	名詞
＠さいごのしは	《最後の支払い》	名詞
＠さいごのしはら	《最後の支払い》	名詞
＠さいごのしはらい	《最後の支払い》	名詞
＠ゆ	《有事の力》	名詞
＠ゆう	《有事の力》	名詞
＠ゆうじ	《有事の力》	名詞
＠ゆうじの	《有事の力》	名詞
＠ゆうじのち	《有事の力》	名詞
＠ゆうじのちか	《有事の力》	名詞
＠ゆうじのちから	《有事の力》	名詞
＠ゆ	《有毒グルーディオン》	名詞
＠ゆう	《有毒グルーディオン》	名詞
＠ゆうど	《有毒グルーディオン》	名詞
＠ゆうどく	《有毒グルーディオン》	名詞
＠ゆうどくぐ	《有毒グルーディオン》	名詞
＠ゆうどくぐる	《有毒グルーディオン》	名詞
＠ゆうどくぐるー	《有毒グルーディオン》	名詞
＠ゆうどくぐるーで	《有毒グルーディオン》	名詞
＠ゆうどくぐるーでぃ	《有毒グルーディオン》	名詞
＠ゆうどくぐるーでぃお	《有毒グルーディオン》	名詞
＠ゆうどくぐるーでぃおん	《有毒グルーディオン》	名詞
＠ほ	《本質の把捉》	名詞
＠ほん	《本質の把捉》	名詞
＠ほんし	《本質の把捉》	名詞
＠ほんしつ	《本質の把捉》	名詞
＠ほんしつの	《本質の把捉》	名詞
＠ほんしつのは	《本質の把捉》	名詞
＠ほんしつのはそ	《本質の把捉》	名詞
＠ほんしつのはそく	《本質の把捉》	名詞
＠ね	《根の罠》	名詞
＠ねの	《根の罠》	名詞
＠ねのわ	《根の罠》	名詞
＠ねのわな	《根の罠》	名詞
＠と	《棘輪の曲芸》	名詞
＠とげ	《棘輪の曲芸》	名詞
＠とげわ	《棘輪の曲芸》	名詞
＠とげわの	《棘輪の曲芸》	名詞
＠とげわのき	《棘輪の曲芸》	名詞
＠とげわのきょ	《棘輪の曲芸》	名詞
＠とげわのきょく	《棘輪の曲芸》	名詞
＠とげわのきょくげ	《棘輪の曲芸》	名詞
＠とげわのきょくげい	《棘輪の曲芸》	名詞
＠も	《森》	名詞
＠もり	《森》	名詞
＠も	《森の刷毛履き》	名詞
＠もり	《森の刷毛履き》	名詞
＠もりの	《森の刷毛履き》	名詞
＠もりのは	《森の刷毛履き》	名詞
＠もりのはけ	《森の刷毛履き》	名詞
＠もりのはけば	《森の刷毛履き》	名詞
＠もりのはけばき	《森の刷毛履き》	名詞
＠ら	《楽園党の議長、ゼガーナ》	名詞
＠らく	《楽園党の議長、ゼガーナ》	名詞
＠らくえ	《楽園党の議長、ゼガーナ》	名詞
＠らくえん	《楽園党の議長、ゼガーナ》	名詞
＠らくえんと	《楽園党の議長、ゼガーナ》	名詞
＠らくえんとう	《楽園党の議長、ゼガーナ》	名詞
＠らくえんとうの	《楽園党の議長、ゼガーナ》	名詞
＠らくえんとうのぎ	《楽園党の議長、ゼガーナ》	名詞
＠らくえんとうのぎち	《楽園党の議長、ゼガーナ》	名詞
＠らくえんとうのぎちょ	《楽園党の議長、ゼガーナ》	名詞
＠らくえんとうのぎちょう	《楽園党の議長、ゼガーナ》	名詞
＠らくえんとうのぎちょう、	《楽園党の議長、ゼガーナ》	名詞
＠らくえんとうのぎちょう、ぜ	《楽園党の議長、ゼガーナ》	名詞
＠らくえんとうのぎちょう、ぜが	《楽園党の議長、ゼガーナ》	名詞
＠らくえんとうのぎちょう、ぜがー	《楽園党の議長、ゼガーナ》	名詞
＠らくえんとうのぎちょう、ぜがーな	《楽園党の議長、ゼガーナ》	名詞
＠や	《槍播き》	名詞
＠やり	《槍播き》	名詞
＠やりま	《槍播き》	名詞
＠やりまき	《槍播き》	名詞
＠よ	《欲深いスラル》	名詞
＠よく	《欲深いスラル》	名詞
＠よくふ	《欲深いスラル》	名詞
＠よくふか	《欲深いスラル》	名詞
＠よくふかい	《欲深いスラル》	名詞
＠よくふかいす	《欲深いスラル》	名詞
＠よくふかいすら	《欲深いスラル》	名詞
＠よくふかいすらる	《欲深いスラル》	名詞
＠ほ	《歩哨の印》	名詞
＠ほし	《歩哨の印》	名詞
＠ほしょ	《歩哨の印》	名詞
＠ほしょう	《歩哨の印》	名詞
＠ほしょうの	《歩哨の印》	名詞
＠ほしょうのし	《歩哨の印》	名詞
＠ほしょうのしる	《歩哨の印》	名詞
＠ほしょうのしるし	《歩哨の印》	名詞
＠し	《死に到る霊》	名詞
＠しに	《死に到る霊》	名詞
＠しにい	《死に到る霊》	名詞
＠しにいた	《死に到る霊》	名詞
＠しにいたる	《死に到る霊》	名詞
＠しにいたるれ	《死に到る霊》	名詞
＠しにいたるれい	《死に到る霊》	名詞
＠し	《死の嘲り》	名詞
＠しの	《死の嘲り》	名詞
＠しのあ	《死の嘲り》	名詞
＠しのあざ	《死の嘲り》	名詞
＠しのあざけ	《死の嘲り》	名詞
＠しのあざけり	《死の嘲り》	名詞
＠し	《死の歓楽》	名詞
＠しの	《死の歓楽》	名詞
＠しのか	《死の歓楽》	名詞
＠しのかん	《死の歓楽》	名詞
＠しのかんら	《死の歓楽》	名詞
＠しのかんらく	《死の歓楽》	名詞
＠き	《毅然たる番犬》	名詞
＠きぜ	《毅然たる番犬》	名詞
＠きぜん	《毅然たる番犬》	名詞
＠きぜんた	《毅然たる番犬》	名詞
＠きぜんたる	《毅然たる番犬》	名詞
＠きぜんたるば	《毅然たる番犬》	名詞
＠きぜんたるばん	《毅然たる番犬》	名詞
＠きぜんたるばんけ	《毅然たる番犬》	名詞
＠きぜんたるばんけん	《毅然たる番犬》	名詞
＠す	《水底の生術師》	名詞
＠すい	《水底の生術師》	名詞
＠すいて	《水底の生術師》	名詞
＠すいてい	《水底の生術師》	名詞
＠すいていの	《水底の生術師》	名詞
＠すいていのな	《水底の生術師》	名詞
＠すいていのなま	《水底の生術師》	名詞
＠すいていのなまじ	《水底の生術師》	名詞
＠すいていのなまじゅ	《水底の生術師》	名詞
＠すいていのなまじゅつ	《水底の生術師》	名詞
＠すいていのなまじゅつし	《水底の生術師》	名詞
＠ぬ	《沼》	名詞
＠ぬま	《沼》	名詞
＠ほ	《法を築く者、ドビン》	名詞
＠ほう	《法を築く者、ドビン》	名詞
＠ほうを	《法を築く者、ドビン》	名詞
＠ほうをき	《法を築く者、ドビン》	名詞
＠ほうをきず	《法を築く者、ドビン》	名詞
＠ほうをきずく	《法を築く者、ドビン》	名詞
＠ほうをきずくも	《法を築く者、ドビン》	名詞
＠ほうをきずくもの	《法を築く者、ドビン》	名詞
＠ほうをきずくもの、	《法を築く者、ドビン》	名詞
＠ほうをきずくもの、ど	《法を築く者、ドビン》	名詞
＠ほうをきずくもの、どび	《法を築く者、ドビン》	名詞
＠ほうをきずくもの、どびん	《法を築く者、ドビン》	名詞
＠ほ	《法魔道士の束縛》	名詞
＠ほう	《法魔道士の束縛》	名詞
＠ほうま	《法魔道士の束縛》	名詞
＠ほうまど	《法魔道士の束縛》	名詞
＠ほうまどう	《法魔道士の束縛》	名詞
＠ほうまどうし	《法魔道士の束縛》	名詞
＠ほうまどうしの	《法魔道士の束縛》	名詞
＠ほうまどうしのそ	《法魔道士の束縛》	名詞
＠ほうまどうしのそく	《法魔道士の束縛》	名詞
＠ほうまどうしのそくば	《法魔道士の束縛》	名詞
＠ほうまどうしのそくばく	《法魔道士の束縛》	名詞
＠か	《活力の贈り物》	名詞
＠かつ	《活力の贈り物》	名詞
＠かつり	《活力の贈り物》	名詞
＠かつりょ	《活力の贈り物》	名詞
＠かつりょく	《活力の贈り物》	名詞
＠かつりょくの	《活力の贈り物》	名詞
＠かつりょくのお	《活力の贈り物》	名詞
＠かつりょくのおく	《活力の贈り物》	名詞
＠かつりょくのおくり	《活力の贈り物》	名詞
＠かつりょくのおくりも	《活力の贈り物》	名詞
＠かつりょくのおくりもの	《活力の贈り物》	名詞
＠し	《消耗》	名詞
＠しょ	《消耗》	名詞
＠しょう	《消耗》	名詞
＠しょうも	《消耗》	名詞
＠しょうもう	《消耗》	名詞
＠こ	《混沌をもたらす者、ドムリ》	名詞
＠こん	《混沌をもたらす者、ドムリ》	名詞
＠こんと	《混沌をもたらす者、ドムリ》	名詞
＠こんとん	《混沌をもたらす者、ドムリ》	名詞
＠こんとんを	《混沌をもたらす者、ドムリ》	名詞
＠こんとんをも	《混沌をもたらす者、ドムリ》	名詞
＠こんとんをもた	《混沌をもたらす者、ドムリ》	名詞
＠こんとんをもたら	《混沌をもたらす者、ドムリ》	名詞
＠こんとんをもたらす	《混沌をもたらす者、ドムリ》	名詞
＠こんとんをもたらすも	《混沌をもたらす者、ドムリ》	名詞
＠こんとんをもたらすもの	《混沌をもたらす者、ドムリ》	名詞
＠こんとんをもたらすもの、	《混沌をもたらす者、ドムリ》	名詞
＠こんとんをもたらすもの、ど	《混沌をもたらす者、ドムリ》	名詞
＠こんとんをもたらすもの、どむ	《混沌をもたらす者、ドムリ》	名詞
＠こんとんをもたらすもの、どむり	《混沌をもたらす者、ドムリ》	名詞
＠う	《渦巻く激流》	名詞
＠うず	《渦巻く激流》	名詞
＠うずま	《渦巻く激流》	名詞
＠うずまく	《渦巻く激流》	名詞
＠うずまくげ	《渦巻く激流》	名詞
＠うずまくげき	《渦巻く激流》	名詞
＠うずまくげきり	《渦巻く激流》	名詞
＠うずまくげきりゅ	《渦巻く激流》	名詞
＠うずまくげきりゅう	《渦巻く激流》	名詞
＠よ	《溶解区のイグナス》	名詞
＠よう	《溶解区のイグナス》	名詞
＠ようか	《溶解区のイグナス》	名詞
＠ようかい	《溶解区のイグナス》	名詞
＠ようかいく	《溶解区のイグナス》	名詞
＠ようかいくの	《溶解区のイグナス》	名詞
＠ようかいくのい	《溶解区のイグナス》	名詞
＠ようかいくのいぐ	《溶解区のイグナス》	名詞
＠ようかいくのいぐな	《溶解区のイグナス》	名詞
＠ようかいくのいぐなす	《溶解区のイグナス》	名詞
＠げ	《激情のエイリンクス》	名詞
＠げき	《激情のエイリンクス》	名詞
＠げきじ	《激情のエイリンクス》	名詞
＠げきじょ	《激情のエイリンクス》	名詞
＠げきじょう	《激情のエイリンクス》	名詞
＠げきじょうの	《激情のエイリンクス》	名詞
＠げきじょうのえ	《激情のエイリンクス》	名詞
＠げきじょうのえい	《激情のエイリンクス》	名詞
＠げきじょうのえいり	《激情のエイリンクス》	名詞
＠げきじょうのえいりん	《激情のエイリンクス》	名詞
＠げきじょうのえいりんく	《激情のエイリンクス》	名詞
＠げきじょうのえいりんくす	《激情のエイリンクス》	名詞
＠げ	《激昂した角獣》	名詞
＠げき	《激昂した角獣》	名詞
＠げきこ	《激昂した角獣》	名詞
＠げきこう	《激昂した角獣》	名詞
＠げきこうし	《激昂した角獣》	名詞
＠げきこうした	《激昂した角獣》	名詞
＠げきこうしたか	《激昂した角獣》	名詞
＠げきこうしたかく	《激昂した角獣》	名詞
＠げきこうしたかくけ	《激昂した角獣》	名詞
＠げきこうしたかくけも	《激昂した角獣》	名詞
＠げきこうしたかくけもの	《激昂した角獣》	名詞
＠ひ	《火刃の芸術家》	名詞
＠ひは	《火刃の芸術家》	名詞
＠ひはの	《火刃の芸術家》	名詞
＠ひはのげ	《火刃の芸術家》	名詞
＠ひはのげい	《火刃の芸術家》	名詞
＠ひはのげいじ	《火刃の芸術家》	名詞
＠ひはのげいじゅ	《火刃の芸術家》	名詞
＠ひはのげいじゅつ	《火刃の芸術家》	名詞
＠ひはのげいじゅつか	《火刃の芸術家》	名詞
＠ひ	《火消し》	名詞
＠ひけ	《火消し》	名詞
＠ひけし	《火消し》	名詞
＠わ	《災いの歌姫、ジュディス》	名詞
＠わざ	《災いの歌姫、ジュディス》	名詞
＠わざわ	《災いの歌姫、ジュディス》	名詞
＠わざわい	《災いの歌姫、ジュディス》	名詞
＠わざわいの	《災いの歌姫、ジュディス》	名詞
＠わざわいのう	《災いの歌姫、ジュディス》	名詞
＠わざわいのうた	《災いの歌姫、ジュディス》	名詞
＠わざわいのうたひ	《災いの歌姫、ジュディス》	名詞
＠わざわいのうたひめ	《災いの歌姫、ジュディス》	名詞
＠わざわいのうたひめ、	《災いの歌姫、ジュディス》	名詞
＠わざわいのうたひめ、じ	《災いの歌姫、ジュディス》	名詞
＠わざわいのうたひめ、じゅ	《災いの歌姫、ジュディス》	名詞
＠わざわいのうたひめ、じゅで	《災いの歌姫、ジュディス》	名詞
＠わざわいのうたひめ、じゅでぃ	《災いの歌姫、ジュディス》	名詞
＠わざわいのうたひめ、じゅでぃす	《災いの歌姫、ジュディス》	名詞
＠さ	《災厄の行進》	名詞
＠さい	《災厄の行進》	名詞
＠さいや	《災厄の行進》	名詞
＠さいやく	《災厄の行進》	名詞
＠さいやくの	《災厄の行進》	名詞
＠さいやくのこ	《災厄の行進》	名詞
＠さいやくのこう	《災厄の行進》	名詞
＠さいやくのこうし	《災厄の行進》	名詞
＠さいやくのこうしん	《災厄の行進》	名詞
＠え	《炎樹族の蛮人》	名詞
＠えん	《炎樹族の蛮人》	名詞
＠えんき	《炎樹族の蛮人》	名詞
＠えんきぞ	《炎樹族の蛮人》	名詞
＠えんきぞく	《炎樹族の蛮人》	名詞
＠えんきぞくの	《炎樹族の蛮人》	名詞
＠えんきぞくのば	《炎樹族の蛮人》	名詞
＠えんきぞくのばん	《炎樹族の蛮人》	名詞
＠えんきぞくのばんじ	《炎樹族の蛮人》	名詞
＠えんきぞくのばんじん	《炎樹族の蛮人》	名詞
＠む	《無慈悲な司教》	名詞
＠むじ	《無慈悲な司教》	名詞
＠むじひ	《無慈悲な司教》	名詞
＠むじひな	《無慈悲な司教》	名詞
＠むじひなし	《無慈悲な司教》	名詞
＠むじひなしき	《無慈悲な司教》	名詞
＠むじひなしきょ	《無慈悲な司教》	名詞
＠むじひなしきょう	《無慈悲な司教》	名詞
＠あ	《焦印》	名詞
＠あせ	《焦印》	名詞
＠あせり	《焦印》	名詞
＠あせりし	《焦印》	名詞
＠あせりしる	《焦印》	名詞
＠あせりしるし	《焦印》	名詞
＠や	《焼印刃》	名詞
＠やき	《焼印刃》	名詞
＠やきい	《焼印刃》	名詞
＠やきいん	《焼印刃》	名詞
＠やきいんは	《焼印刃》	名詞
＠し	《焼身のシャーマン》	名詞
＠しょ	《焼身のシャーマン》	名詞
＠しょう	《焼身のシャーマン》	名詞
＠しょうし	《焼身のシャーマン》	名詞
＠しょうしん	《焼身のシャーマン》	名詞
＠しょうしんの	《焼身のシャーマン》	名詞
＠しょうしんのし	《焼身のシャーマン》	名詞
＠しょうしんのしゃ	《焼身のシャーマン》	名詞
＠しょうしんのしゃー	《焼身のシャーマン》	名詞
＠しょうしんのしゃーま	《焼身のシャーマン》	名詞
＠しょうしんのしゃーまん	《焼身のシャーマン》	名詞
＠も	《燃えがら蔦》	名詞
＠もえ	《燃えがら蔦》	名詞
＠もえが	《燃えがら蔦》	名詞
＠もえがら	《燃えがら蔦》	名詞
＠もえがらつ	《燃えがら蔦》	名詞
＠もえがらつた	《燃えがら蔦》	名詞
＠も	《燃えさかる炎》	名詞
＠もえ	《燃えさかる炎》	名詞
＠もえさ	《燃えさかる炎》	名詞
＠もえさか	《燃えさかる炎》	名詞
＠もえさかる	《燃えさかる炎》	名詞
＠もえさかるほ	《燃えさかる炎》	名詞
＠もえさかるほの	《燃えさかる炎》	名詞
＠もえさかるほのお	《燃えさかる炎》	名詞
＠も	《燃え立つ門》	名詞
＠もえ	《燃え立つ門》	名詞
＠もえた	《燃え立つ門》	名詞
＠もえたつ	《燃え立つ門》	名詞
＠もえたつも	《燃え立つ門》	名詞
＠もえたつもん	《燃え立つ門》	名詞
＠い	《猪の祟神の炎》	名詞
＠いの	《猪の祟神の炎》	名詞
＠いのし	《猪の祟神の炎》	名詞
＠いのしし	《猪の祟神の炎》	名詞
＠いのししの	《猪の祟神の炎》	名詞
＠いのししのた	《猪の祟神の炎》	名詞
＠いのししのたた	《猪の祟神の炎》	名詞
＠いのししのたたり	《猪の祟神の炎》	名詞
＠いのししのたたりか	《猪の祟神の炎》	名詞
＠いのししのたたりかみ	《猪の祟神の炎》	名詞
＠いのししのたたりかみの	《猪の祟神の炎》	名詞
＠いのししのたたりかみのほ	《猪の祟神の炎》	名詞
＠いのししのたたりかみのほの	《猪の祟神の炎》	名詞
＠いのししのたたりかみのほのお	《猪の祟神の炎》	名詞
＠さ	《珊瑚の猛士》	名詞
＠さん	《珊瑚の猛士》	名詞
＠さんご	《珊瑚の猛士》	名詞
＠さんごの	《珊瑚の猛士》	名詞
＠さんごのた	《珊瑚の猛士》	名詞
＠さんごのたけ	《珊瑚の猛士》	名詞
＠さんごのたけし	《珊瑚の猛士》	名詞
＠が	《瓦礫の投げ手》	名詞
＠がれ	《瓦礫の投げ手》	名詞
＠がれき	《瓦礫の投げ手》	名詞
＠がれきの	《瓦礫の投げ手》	名詞
＠がれきのな	《瓦礫の投げ手》	名詞
＠がれきのなげ	《瓦礫の投げ手》	名詞
＠がれきのなげて	《瓦礫の投げ手》	名詞
＠が	《瓦礫帯の世捨て人》	名詞
＠がれ	《瓦礫帯の世捨て人》	名詞
＠がれき	《瓦礫帯の世捨て人》	名詞
＠がれきお	《瓦礫帯の世捨て人》	名詞
＠がれきおび	《瓦礫帯の世捨て人》	名詞
＠がれきおびの	《瓦礫帯の世捨て人》	名詞
＠がれきおびのよ	《瓦礫帯の世捨て人》	名詞
＠がれきおびのよす	《瓦礫帯の世捨て人》	名詞
＠がれきおびのよすて	《瓦礫帯の世捨て人》	名詞
＠がれきおびのよすてび	《瓦礫帯の世捨て人》	名詞
＠がれきおびのよすてびと	《瓦礫帯の世捨て人》	名詞
＠が	《瓦礫帯走り》	名詞
＠がれ	《瓦礫帯走り》	名詞
＠がれき	《瓦礫帯走り》	名詞
＠がれきお	《瓦礫帯走り》	名詞
＠がれきおび	《瓦礫帯走り》	名詞
＠がれきおびは	《瓦礫帯走り》	名詞
＠がれきおびはし	《瓦礫帯走り》	名詞
＠がれきおびはしり	《瓦礫帯走り》	名詞
＠が	《瓦礫読み》	名詞
＠がれ	《瓦礫読み》	名詞
＠がれき	《瓦礫読み》	名詞
＠がれきよ	《瓦礫読み》	名詞
＠がれきよみ	《瓦礫読み》	名詞
＠せ	《生体性改造》	名詞
＠せい	《生体性改造》	名詞
＠せいた	《生体性改造》	名詞
＠せいたい	《生体性改造》	名詞
＠せいたいせ	《生体性改造》	名詞
＠せいたいせい	《生体性改造》	名詞
＠せいたいせいか	《生体性改造》	名詞
＠せいたいせいかい	《生体性改造》	名詞
＠せいたいせいかいぞ	《生体性改造》	名詞
＠せいたいせいかいぞう	《生体性改造》	名詞
＠せ	《生体性軟泥》	名詞
＠せい	《生体性軟泥》	名詞
＠せいた	《生体性軟泥》	名詞
＠せいたい	《生体性軟泥》	名詞
＠せいたいせ	《生体性軟泥》	名詞
＠せいたいせい	《生体性軟泥》	名詞
＠せいたいせいや	《生体性軟泥》	名詞
＠せいたいせいやわ	《生体性軟泥》	名詞
＠せいたいせいやわど	《生体性軟泥》	名詞
＠せいたいせいやわどろ	《生体性軟泥》	名詞
＠せ	《生術師の使い魔》	名詞
＠せい	《生術師の使い魔》	名詞
＠せいや	《生術師の使い魔》	名詞
＠せいやす	《生術師の使い魔》	名詞
＠せいやすし	《生術師の使い魔》	名詞
＠せいやすしし	《生術師の使い魔》	名詞
＠せいやすししの	《生術師の使い魔》	名詞
＠せいやすししのつ	《生術師の使い魔》	名詞
＠せいやすししのつか	《生術師の使い魔》	名詞
＠せいやすししのつかい	《生術師の使い魔》	名詞
＠せいやすししのつかいま	《生術師の使い魔》	名詞
＠よ	《用心深い巨人》	名詞
＠よう	《用心深い巨人》	名詞
＠ようじ	《用心深い巨人》	名詞
＠ようじん	《用心深い巨人》	名詞
＠ようじんぶ	《用心深い巨人》	名詞
＠ようじんぶか	《用心深い巨人》	名詞
＠ようじんぶかい	《用心深い巨人》	名詞
＠ようじんぶかいき	《用心深い巨人》	名詞
＠ようじんぶかいきょ	《用心深い巨人》	名詞
＠ようじんぶかいきょじ	《用心深い巨人》	名詞
＠ようじんぶかいきょじん	《用心深い巨人》	名詞
＠り	《略式判決》	名詞
＠りゃ	《略式判決》	名詞
＠りゃく	《略式判決》	名詞
＠りゃくし	《略式判決》	名詞
＠りゃくしき	《略式判決》	名詞
＠りゃくしきは	《略式判決》	名詞
＠りゃくしきはん	《略式判決》	名詞
＠りゃくしきはんけ	《略式判決》	名詞
＠りゃくしきはんけつ	《略式判決》	名詞
＠ば	《番人》	名詞
＠ばん	《番人》	名詞
＠ばんに	《番人》	名詞
＠ばんにん	《番人》	名詞
＠え	《疫病ワイト》	名詞
＠えき	《疫病ワイト》	名詞
＠えきび	《疫病ワイト》	名詞
＠えきびょ	《疫病ワイト》	名詞
＠えきびょう	《疫病ワイト》	名詞
＠えきびょうわ	《疫病ワイト》	名詞
＠えきびょうわい	《疫病ワイト》	名詞
＠えきびょうわいと	《疫病ワイト》	名詞
＠て	《的中》	名詞
＠てき	《的中》	名詞
＠てきち	《的中》	名詞
＠てきちゅ	《的中》	名詞
＠てきちゅう	《的中》	名詞
＠し	《真理の円》	名詞
＠しん	《真理の円》	名詞
＠しんり	《真理の円》	名詞
＠しんりの	《真理の円》	名詞
＠しんりのえ	《真理の円》	名詞
＠しんりのえん	《真理の円》	名詞
＠げ	《眩惑する水底種》	名詞
＠げん	《眩惑する水底種》	名詞
＠げんわ	《眩惑する水底種》	名詞
＠げんわく	《眩惑する水底種》	名詞
＠げんわくす	《眩惑する水底種》	名詞
＠げんわくする	《眩惑する水底種》	名詞
＠げんわくするす	《眩惑する水底種》	名詞
＠げんわくするすい	《眩惑する水底種》	名詞
＠げんわくするすいて	《眩惑する水底種》	名詞
＠げんわくするすいてい	《眩惑する水底種》	名詞
＠げんわくするすいていた	《眩惑する水底種》	名詞
＠げんわくするすいていたね	《眩惑する水底種》	名詞
＠た	《短剣使い》	名詞
＠たん	《短剣使い》	名詞
＠たんけ	《短剣使い》	名詞
＠たんけん	《短剣使い》	名詞
＠たんけんつ	《短剣使い》	名詞
＠たんけんつか	《短剣使い》	名詞
＠たんけんつかい	《短剣使い》	名詞
＠い	《石のような強さ》	名詞
＠いし	《石のような強さ》	名詞
＠いしの	《石のような強さ》	名詞
＠いしのよ	《石のような強さ》	名詞
＠いしのよう	《石のような強さ》	名詞
＠いしのような	《石のような強さ》	名詞
＠いしのようなつ	《石のような強さ》	名詞
＠いしのようなつよ	《石のような強さ》	名詞
＠いしのようなつよさ	《石のような強さ》	名詞
＠じ	《砂利皮のゴブリン》	名詞
＠じゃ	《砂利皮のゴブリン》	名詞
＠じゃり	《砂利皮のゴブリン》	名詞
＠じゃりか	《砂利皮のゴブリン》	名詞
＠じゃりかわ	《砂利皮のゴブリン》	名詞
＠じゃりかわの	《砂利皮のゴブリン》	名詞
＠じゃりかわのご	《砂利皮のゴブリン》	名詞
＠じゃりかわのごぶ	《砂利皮のゴブリン》	名詞
＠じゃりかわのごぶり	《砂利皮のゴブリン》	名詞
＠じゃりかわのごぶりん	《砂利皮のゴブリン》	名詞
＠は	《破壊獣》	名詞
＠はか	《破壊獣》	名詞
＠はかい	《破壊獣》	名詞
＠はかいけ	《破壊獣》	名詞
＠はかいけも	《破壊獣》	名詞
＠はかいけもの	《破壊獣》	名詞
＠か	《神無き祭殿》	名詞
＠かみ	《神無き祭殿》	名詞
＠かみな	《神無き祭殿》	名詞
＠かみなき	《神無き祭殿》	名詞
＠かみなきさ	《神無き祭殿》	名詞
＠かみなきさい	《神無き祭殿》	名詞
＠かみなきさいで	《神無き祭殿》	名詞
＠かみなきさいでん	《神無き祭殿》	名詞
＠し	《神聖なる泉》	名詞
＠しん	《神聖なる泉》	名詞
＠しんせ	《神聖なる泉》	名詞
＠しんせい	《神聖なる泉》	名詞
＠しんせいな	《神聖なる泉》	名詞
＠しんせいなる	《神聖なる泉》	名詞
＠しんせいなるい	《神聖なる泉》	名詞
＠しんせいなるいず	《神聖なる泉》	名詞
＠しんせいなるいずみ	《神聖なる泉》	名詞
＠ば	《秤の熾天使》	名詞
＠ばか	《秤の熾天使》	名詞
＠ばかり	《秤の熾天使》	名詞
＠ばかりの	《秤の熾天使》	名詞
＠ばかりのお	《秤の熾天使》	名詞
＠ばかりのおき	《秤の熾天使》	名詞
＠ばかりのおきて	《秤の熾天使》	名詞
＠ばかりのおきてん	《秤の熾天使》	名詞
＠ばかりのおきてんし	《秤の熾天使》	名詞
＠そ	《空の縛め》	名詞
＠そら	《空の縛め》	名詞
＠そらの	《空の縛め》	名詞
＠そらのい	《空の縛め》	名詞
＠そらのいま	《空の縛め》	名詞
＠そらのいまし	《空の縛め》	名詞
＠そらのいましめ	《空の縛め》	名詞
＠と	《突進する戦猪》	名詞
＠とっ	《突進する戦猪》	名詞
＠とっし	《突進する戦猪》	名詞
＠とっしん	《突進する戦猪》	名詞
＠とっしんす	《突進する戦猪》	名詞
＠とっしんする	《突進する戦猪》	名詞
＠とっしんするい	《突進する戦猪》	名詞
＠とっしんするいく	《突進する戦猪》	名詞
＠とっしんするいくさ	《突進する戦猪》	名詞
＠とっしんするいくさい	《突進する戦猪》	名詞
＠とっしんするいくさいの	《突進する戦猪》	名詞
＠とっしんするいくさいのし	《突進する戦猪》	名詞
＠とっしんするいくさいのしし	《突進する戦猪》	名詞
＠た	《立ちふさがる霊》	名詞
＠たち	《立ちふさがる霊》	名詞
＠たちふ	《立ちふさがる霊》	名詞
＠たちふさ	《立ちふさがる霊》	名詞
＠たちふさが	《立ちふさがる霊》	名詞
＠たちふさがる	《立ちふさがる霊》	名詞
＠たちふさがるれ	《立ちふさがる霊》	名詞
＠たちふさがるれい	《立ちふさがる霊》	名詞
＠だ	《第10管区の古参兵》	名詞
＠だい	《第10管区の古参兵》	名詞
＠だい1	《第10管区の古参兵》	名詞
＠だい10	《第10管区の古参兵》	名詞
＠だい10か	《第10管区の古参兵》	名詞
＠だい10かん	《第10管区の古参兵》	名詞
＠だい10かんく	《第10管区の古参兵》	名詞
＠だい10かんくの	《第10管区の古参兵》	名詞
＠だい10かんくのこ	《第10管区の古参兵》	名詞
＠だい10かんくのこさ	《第10管区の古参兵》	名詞
＠だい10かんくのこさん	《第10管区の古参兵》	名詞
＠だい10かんくのこさんへ	《第10管区の古参兵》	名詞
＠だい10かんくのこさんへい	《第10管区の古参兵》	名詞
＠だ	《第１管区の勇士》	名詞
＠だい	《第１管区の勇士》	名詞
＠だい１	《第１管区の勇士》	名詞
＠だい１か	《第１管区の勇士》	名詞
＠だい１かん	《第１管区の勇士》	名詞
＠だい１かんく	《第１管区の勇士》	名詞
＠だい１かんくの	《第１管区の勇士》	名詞
＠だい１かんくのゆ	《第１管区の勇士》	名詞
＠だい１かんくのゆう	《第１管区の勇士》	名詞
＠だい１かんくのゆうし	《第１管区の勇士》	名詞
＠せ	《精神純化》	名詞
＠せい	《精神純化》	名詞
＠せいし	《精神純化》	名詞
＠せいしん	《精神純化》	名詞
＠せいしんじ	《精神純化》	名詞
＠せいしんじゅ	《精神純化》	名詞
＠せいしんじゅん	《精神純化》	名詞
＠せいしんじゅんか	《精神純化》	名詞
＠せ	《精鋭拘引者》	名詞
＠せい	《精鋭拘引者》	名詞
＠せいえ	《精鋭拘引者》	名詞
＠せいえい	《精鋭拘引者》	名詞
＠せいえいこ	《精鋭拘引者》	名詞
＠せいえいこう	《精鋭拘引者》	名詞
＠せいえいこうい	《精鋭拘引者》	名詞
＠せいえいこういん	《精鋭拘引者》	名詞
＠せいえいこういんし	《精鋭拘引者》	名詞
＠せいえいこういんしゃ	《精鋭拘引者》	名詞
＠し	《終末の祟りの先陣》	名詞
＠しゅ	《終末の祟りの先陣》	名詞
＠しゅう	《終末の祟りの先陣》	名詞
＠しゅうま	《終末の祟りの先陣》	名詞
＠しゅうまつ	《終末の祟りの先陣》	名詞
＠しゅうまつの	《終末の祟りの先陣》	名詞
＠しゅうまつのた	《終末の祟りの先陣》	名詞
＠しゅうまつのたた	《終末の祟りの先陣》	名詞
＠しゅうまつのたたり	《終末の祟りの先陣》	名詞
＠しゅうまつのたたりの	《終末の祟りの先陣》	名詞
＠しゅうまつのたたりのせ	《終末の祟りの先陣》	名詞
＠しゅうまつのたたりのせん	《終末の祟りの先陣》	名詞
＠しゅうまつのたたりのせんじ	《終末の祟りの先陣》	名詞
＠しゅうまつのたたりのせんじん	《終末の祟りの先陣》	名詞
＠そ	《組織のギルド魔道士》	名詞
＠そし	《組織のギルド魔道士》	名詞
＠そしき	《組織のギルド魔道士》	名詞
＠そしきの	《組織のギルド魔道士》	名詞
＠そしきのぎ	《組織のギルド魔道士》	名詞
＠そしきのぎる	《組織のギルド魔道士》	名詞
＠そしきのぎるど	《組織のギルド魔道士》	名詞
＠そしきのぎるどま	《組織のギルド魔道士》	名詞
＠そしきのぎるどまど	《組織のギルド魔道士》	名詞
＠そしきのぎるどまどう	《組織のギルド魔道士》	名詞
＠そしきのぎるどまどうし	《組織のギルド魔道士》	名詞
＠そ	《組織の伝書使》	名詞
＠そし	《組織の伝書使》	名詞
＠そしき	《組織の伝書使》	名詞
＠そしきの	《組織の伝書使》	名詞
＠そしきので	《組織の伝書使》	名詞
＠そしきのでん	《組織の伝書使》	名詞
＠そしきのでんし	《組織の伝書使》	名詞
＠そしきのでんしょ	《組織の伝書使》	名詞
＠そしきのでんしょづ	《組織の伝書使》	名詞
＠そしきのでんしょづか	《組織の伝書使》	名詞
＠そしきのでんしょづかい	《組織の伝書使》	名詞
＠ぜ	《絶息の騎士》	名詞
＠ぜっ	《絶息の騎士》	名詞
＠ぜっそ	《絶息の騎士》	名詞
＠ぜっそく	《絶息の騎士》	名詞
＠ぜっそくの	《絶息の騎士》	名詞
＠ぜっそくのき	《絶息の騎士》	名詞
＠ぜっそくのきし	《絶息の騎士》	名詞
＠な	《縄張り持ちの猪》	名詞
＠なわ	《縄張り持ちの猪》	名詞
＠なわば	《縄張り持ちの猪》	名詞
＠なわばり	《縄張り持ちの猪》	名詞
＠なわばりも	《縄張り持ちの猪》	名詞
＠なわばりもち	《縄張り持ちの猪》	名詞
＠なわばりもちの	《縄張り持ちの猪》	名詞
＠なわばりもちのい	《縄張り持ちの猪》	名詞
＠なわばりもちのいの	《縄張り持ちの猪》	名詞
＠なわばりもちのいのし	《縄張り持ちの猪》	名詞
＠なわばりもちのいのしし	《縄張り持ちの猪》	名詞
＠は	《繁殖池》	名詞
＠はん	《繁殖池》	名詞
＠はんし	《繁殖池》	名詞
＠はんしょ	《繁殖池》	名詞
＠はんしょく	《繁殖池》	名詞
＠はんしょくい	《繁殖池》	名詞
＠はんしょくいけ	《繁殖池》	名詞
＠せ	《聖堂の鐘憑き》	名詞
＠せい	《聖堂の鐘憑き》	名詞
＠せいど	《聖堂の鐘憑き》	名詞
＠せいどう	《聖堂の鐘憑き》	名詞
＠せいどうの	《聖堂の鐘憑き》	名詞
＠せいどうのか	《聖堂の鐘憑き》	名詞
＠せいどうのかね	《聖堂の鐘憑き》	名詞
＠せいどうのかねつ	《聖堂の鐘憑き》	名詞
＠せいどうのかねつき	《聖堂の鐘憑き》	名詞
＠に	《肉儀場の叫び》	名詞
＠にく	《肉儀場の叫び》	名詞
＠にくぎ	《肉儀場の叫び》	名詞
＠にくぎじ	《肉儀場の叫び》	名詞
＠にくぎじょ	《肉儀場の叫び》	名詞
＠にくぎじょう	《肉儀場の叫び》	名詞
＠にくぎじょうの	《肉儀場の叫び》	名詞
＠にくぎじょうのさ	《肉儀場の叫び》	名詞
＠にくぎじょうのさけ	《肉儀場の叫び》	名詞
＠にくぎじょうのさけび	《肉儀場の叫び》	名詞
＠き	《脅威》	名詞
＠きょ	《脅威》	名詞
＠きょう	《脅威》	名詞
＠きょうい	《脅威》	名詞
＠き	《脚光の悪鬼》	名詞
＠きゃ	《脚光の悪鬼》	名詞
＠きゃっ	《脚光の悪鬼》	名詞
＠きゃっこ	《脚光の悪鬼》	名詞
＠きゃっこう	《脚光の悪鬼》	名詞
＠きゃっこうの	《脚光の悪鬼》	名詞
＠きゃっこうのあ	《脚光の悪鬼》	名詞
＠きゃっこうのあっ	《脚光の悪鬼》	名詞
＠きゃっこうのあっき	《脚光の悪鬼》	名詞
＠こ	《興行》	名詞
＠こう	《興行》	名詞
＠こうぎ	《興行》	名詞
＠こうぎょ	《興行》	名詞
＠こうぎょう	《興行》	名詞
＠こ	《興行+叩打》	名詞
＠こう	《興行+叩打》	名詞
＠こうぎ	《興行+叩打》	名詞
＠こうぎょ	《興行+叩打》	名詞
＠こうぎょう	《興行+叩打》	名詞
＠こうぎょう+	《興行+叩打》	名詞
＠こうぎょう+た	《興行+叩打》	名詞
＠こうぎょう+たた	《興行+叩打》	名詞
＠こうぎょう+たたき	《興行+叩打》	名詞
＠こうぎょう+たたきだ	《興行+叩打》	名詞
＠ぶ	《舞台一掃》	名詞
＠ぶた	《舞台一掃》	名詞
＠ぶたい	《舞台一掃》	名詞
＠ぶたいい	《舞台一掃》	名詞
＠ぶたいいっ	《舞台一掃》	名詞
＠ぶたいいっそ	《舞台一掃》	名詞
＠ぶたいいっそう	《舞台一掃》	名詞
＠ぶ	《舞台照らし》	名詞
＠ぶた	《舞台照らし》	名詞
＠ぶたい	《舞台照らし》	名詞
＠ぶたいて	《舞台照らし》	名詞
＠ぶたいてら	《舞台照らし》	名詞
＠ぶたいてらし	《舞台照らし》	名詞
＠く	《苦悶の泉》	名詞
＠くも	《苦悶の泉》	名詞
＠くもん	《苦悶の泉》	名詞
＠くもんの	《苦悶の泉》	名詞
＠くもんのい	《苦悶の泉》	名詞
＠くもんのいず	《苦悶の泉》	名詞
＠くもんのいずみ	《苦悶の泉》	名詞
＠こ	《荒廃ワーム》	名詞
＠こう	《荒廃ワーム》	名詞
＠こうは	《荒廃ワーム》	名詞
＠こうはい	《荒廃ワーム》	名詞
＠こうはいわ	《荒廃ワーム》	名詞
＠こうはいわー	《荒廃ワーム》	名詞
＠こうはいわーむ	《荒廃ワーム》	名詞
＠こ	《荒野の再生》	名詞
＠こう	《荒野の再生》	名詞
＠こうや	《荒野の再生》	名詞
＠こうやの	《荒野の再生》	名詞
＠こうやのさ	《荒野の再生》	名詞
＠こうやのさい	《荒野の再生》	名詞
＠こうやのさいせ	《荒野の再生》	名詞
＠こうやのさいせい	《荒野の再生》	名詞
＠ち	《血に飢えた影》	名詞
＠ちに	《血に飢えた影》	名詞
＠ちにう	《血に飢えた影》	名詞
＠ちにうえ	《血に飢えた影》	名詞
＠ちにうえた	《血に飢えた影》	名詞
＠ちにうえたか	《血に飢えた影》	名詞
＠ちにうえたかげ	《血に飢えた影》	名詞
＠ち	《血の墓所》	名詞
＠ちの	《血の墓所》	名詞
＠ちのぼ	《血の墓所》	名詞
＠ちのぼし	《血の墓所》	名詞
＠ちのぼしょ	《血の墓所》	名詞
＠け	《血液破綻》	名詞
＠けつ	《血液破綻》	名詞
＠けつえ	《血液破綻》	名詞
＠けつえき	《血液破綻》	名詞
＠けつえきは	《血液破綻》	名詞
＠けつえきはた	《血液破綻》	名詞
＠けつえきはたん	《血液破綻》	名詞
＠ち	《血霧の潜入者》	名詞
＠ちぎ	《血霧の潜入者》	名詞
＠ちぎり	《血霧の潜入者》	名詞
＠ちぎりの	《血霧の潜入者》	名詞
＠ちぎりのせ	《血霧の潜入者》	名詞
＠ちぎりのせん	《血霧の潜入者》	名詞
＠ちぎりのせんに	《血霧の潜入者》	名詞
＠ちぎりのせんにゅ	《血霧の潜入者》	名詞
＠ちぎりのせんにゅう	《血霧の潜入者》	名詞
＠ちぎりのせんにゅうし	《血霧の潜入者》	名詞
＠ちぎりのせんにゅうしゃ	《血霧の潜入者》	名詞
＠ま	《街潰し、ドムリ》	名詞
＠まち	《街潰し、ドムリ》	名詞
＠まちつ	《街潰し、ドムリ》	名詞
＠まちつぶ	《街潰し、ドムリ》	名詞
＠まちつぶし	《街潰し、ドムリ》	名詞
＠まちつぶし、	《街潰し、ドムリ》	名詞
＠まちつぶし、ど	《街潰し、ドムリ》	名詞
＠まちつぶし、どむ	《街潰し、ドムリ》	名詞
＠まちつぶし、どむり	《街潰し、ドムリ》	名詞
＠ふ	《複製》	名詞
＠ふく	《複製》	名詞
＠ふくせ	《複製》	名詞
＠ふくせい	《複製》	名詞
＠ふ	《覆滅》	名詞
＠ふく	《覆滅》	名詞
＠ふくめ	《覆滅》	名詞
＠ふくめつ	《覆滅》	名詞
＠ふ	《覆滅+複製》	名詞
＠ふく	《覆滅+複製》	名詞
＠ふくめ	《覆滅+複製》	名詞
＠ふくめつ	《覆滅+複製》	名詞
＠ふくめつ+	《覆滅+複製》	名詞
＠ふくめつ+ふ	《覆滅+複製》	名詞
＠ふくめつ+ふく	《覆滅+複製》	名詞
＠ふくめつ+ふくせ	《覆滅+複製》	名詞
＠ふくめつ+ふくせい	《覆滅+複製》	名詞
＠か	《解任》	名詞
＠かい	《解任》	名詞
＠かいに	《解任》	名詞
＠かいにん	《解任》	名詞
＠か	《解任+開展》	名詞
＠かい	《解任+開展》	名詞
＠かいに	《解任+開展》	名詞
＠かいにん	《解任+開展》	名詞
＠かいにん+	《解任+開展》	名詞
＠かいにん+か	《解任+開展》	名詞
＠かいにん+かい	《解任+開展》	名詞
＠かいにん+かいて	《解任+開展》	名詞
＠かいにん+かいてん	《解任+開展》	名詞
＠ひ	《評議会のギルド魔道士》	名詞
＠ひょ	《評議会のギルド魔道士》	名詞
＠ひょう	《評議会のギルド魔道士》	名詞
＠ひょうぎ	《評議会のギルド魔道士》	名詞
＠ひょうぎか	《評議会のギルド魔道士》	名詞
＠ひょうぎかい	《評議会のギルド魔道士》	名詞
＠ひょうぎかいの	《評議会のギルド魔道士》	名詞
＠ひょうぎかいのぎ	《評議会のギルド魔道士》	名詞
＠ひょうぎかいのぎる	《評議会のギルド魔道士》	名詞
＠ひょうぎかいのぎるど	《評議会のギルド魔道士》	名詞
＠ひょうぎかいのぎるどま	《評議会のギルド魔道士》	名詞
＠ひょうぎかいのぎるどまど	《評議会のギルド魔道士》	名詞
＠ひょうぎかいのぎるどまどう	《評議会のギルド魔道士》	名詞
＠ひょうぎかいのぎるどまどうし	《評議会のギルド魔道士》	名詞
＠ひ	《評議会のグリフィン》	名詞
＠ひょ	《評議会のグリフィン》	名詞
＠ひょう	《評議会のグリフィン》	名詞
＠ひょうぎ	《評議会のグリフィン》	名詞
＠ひょうぎか	《評議会のグリフィン》	名詞
＠ひょうぎかい	《評議会のグリフィン》	名詞
＠ひょうぎかいの	《評議会のグリフィン》	名詞
＠ひょうぎかいのぐ	《評議会のグリフィン》	名詞
＠ひょうぎかいのぐり	《評議会のグリフィン》	名詞
＠ひょうぎかいのぐりふ	《評議会のグリフィン》	名詞
＠ひょうぎかいのぐりふぃ	《評議会のグリフィン》	名詞
＠ひょうぎかいのぐりふぃん	《評議会のグリフィン》	名詞
＠ひ	《評議会の急使》	名詞
＠ひょ	《評議会の急使》	名詞
＠ひょう	《評議会の急使》	名詞
＠ひょうぎ	《評議会の急使》	名詞
＠ひょうぎか	《評議会の急使》	名詞
＠ひょうぎかい	《評議会の急使》	名詞
＠ひょうぎかいの	《評議会の急使》	名詞
＠ひょうぎかいのき	《評議会の急使》	名詞
＠ひょうぎかいのきゅ	《評議会の急使》	名詞
＠ひょうぎかいのきゅう	《評議会の急使》	名詞
＠ひょうぎかいのきゅうし	《評議会の急使》	名詞
＠せ	《詮索の目》	名詞
＠せん	《詮索の目》	名詞
＠せんさ	《詮索の目》	名詞
＠せんさく	《詮索の目》	名詞
＠せんさくの	《詮索の目》	名詞
＠せんさくのめ	《詮索の目》	名詞
＠ご	《誤認》	名詞
＠ごに	《誤認》	名詞
＠ごにん	《誤認》	名詞
＠ち	《調和の公有地》	名詞
＠ちょ	《調和の公有地》	名詞
＠ちょう	《調和の公有地》	名詞
＠ちょうわ	《調和の公有地》	名詞
＠ちょうわの	《調和の公有地》	名詞
＠ちょうわのこ	《調和の公有地》	名詞
＠ちょうわのこう	《調和の公有地》	名詞
＠ちょうわのこうゆ	《調和の公有地》	名詞
＠ちょうわのこうゆう	《調和の公有地》	名詞
＠ちょうわのこうゆうち	《調和の公有地》	名詞
＠ご	《護民官の重鎮》	名詞
＠ごみ	《護民官の重鎮》	名詞
＠ごみん	《護民官の重鎮》	名詞
＠ごみんか	《護民官の重鎮》	名詞
＠ごみんかん	《護民官の重鎮》	名詞
＠ごみんかんの	《護民官の重鎮》	名詞
＠ごみんかんのじ	《護民官の重鎮》	名詞
＠ごみんかんのじゅ	《護民官の重鎮》	名詞
＠ごみんかんのじゅう	《護民官の重鎮》	名詞
＠ごみんかんのじゅうち	《護民官の重鎮》	名詞
＠ごみんかんのじゅうちん	《護民官の重鎮》	名詞
＠ご	《豪奢》	名詞
＠ごう	《豪奢》	名詞
＠ごうし	《豪奢》	名詞
＠ごうしゃ	《豪奢》	名詞
＠ご	《豪奢+誤認》	名詞
＠ごう	《豪奢+誤認》	名詞
＠ごうし	《豪奢+誤認》	名詞
＠ごうしゃ	《豪奢+誤認》	名詞
＠ごうしゃ+	《豪奢+誤認》	名詞
＠ごうしゃ+ご	《豪奢+誤認》	名詞
＠ごうしゃ+ごに	《豪奢+誤認》	名詞
＠ごうしゃ+ごにん	《豪奢+誤認》	名詞
＠け	《賢者街の学者》	名詞
＠けん	《賢者街の学者》	名詞
＠けんじ	《賢者街の学者》	名詞
＠けんじゃ	《賢者街の学者》	名詞
＠けんじゃま	《賢者街の学者》	名詞
＠けんじゃまち	《賢者街の学者》	名詞
＠けんじゃまちの	《賢者街の学者》	名詞
＠けんじゃまちのが	《賢者街の学者》	名詞
＠けんじゃまちのがく	《賢者街の学者》	名詞
＠けんじゃまちのがくし	《賢者街の学者》	名詞
＠けんじゃまちのがくしゃ	《賢者街の学者》	名詞
＠ふ	《踏み鳴らされる地》	名詞
＠ふみ	《踏み鳴らされる地》	名詞
＠ふみな	《踏み鳴らされる地》	名詞
＠ふみなら	《踏み鳴らされる地》	名詞
＠ふみならさ	《踏み鳴らされる地》	名詞
＠ふみならされ	《踏み鳴らされる地》	名詞
＠ふみならされる	《踏み鳴らされる地》	名詞
＠ふみならされるち	《踏み鳴らされる地》	名詞
＠と	《轟く遺跡》	名詞
＠とど	《轟く遺跡》	名詞
＠とどろ	《轟く遺跡》	名詞
＠とどろく	《轟く遺跡》	名詞
＠とどろくい	《轟く遺跡》	名詞
＠とどろくいせ	《轟く遺跡》	名詞
＠とどろくいせき	《轟く遺跡》	名詞
＠ま	《迷える思考の壁》	名詞
＠まよ	《迷える思考の壁》	名詞
＠まよえ	《迷える思考の壁》	名詞
＠まよえる	《迷える思考の壁》	名詞
＠まよえるし	《迷える思考の壁》	名詞
＠まよえるしこ	《迷える思考の壁》	名詞
＠まよえるしこう	《迷える思考の壁》	名詞
＠まよえるしこうの	《迷える思考の壁》	名詞
＠まよえるしこうのか	《迷える思考の壁》	名詞
＠まよえるしこうのかべ	《迷える思考の壁》	名詞
＠は	《速足ウツボ》	名詞
＠はや	《速足ウツボ》	名詞
＠はやあ	《速足ウツボ》	名詞
＠はやあし	《速足ウツボ》	名詞
＠はやあしう	《速足ウツボ》	名詞
＠はやあしうつ	《速足ウツボ》	名詞
＠はやあしうつぼ	《速足ウツボ》	名詞
＠れ	《連合のギルド魔道士》	名詞
＠れん	《連合のギルド魔道士》	名詞
＠れんご	《連合のギルド魔道士》	名詞
＠れんごう	《連合のギルド魔道士》	名詞
＠れんごうの	《連合のギルド魔道士》	名詞
＠れんごうのぎ	《連合のギルド魔道士》	名詞
＠れんごうのぎる	《連合のギルド魔道士》	名詞
＠れんごうのぎるど	《連合のギルド魔道士》	名詞
＠れんごうのぎるどま	《連合のギルド魔道士》	名詞
＠れんごうのぎるどまど	《連合のギルド魔道士》	名詞
＠れんごうのぎるどまどう	《連合のギルド魔道士》	名詞
＠れんごうのぎるどまどうし	《連合のギルド魔道士》	名詞
＠や	《野生のマーカ》	名詞
＠やせ	《野生のマーカ》	名詞
＠やせい	《野生のマーカ》	名詞
＠やせいの	《野生のマーカ》	名詞
＠やせいのま	《野生のマーカ》	名詞
＠やせいのまー	《野生のマーカ》	名詞
＠やせいのまーか	《野生のマーカ》	名詞
＠や	《野生の律動》	名詞
＠やせ	《野生の律動》	名詞
＠やせい	《野生の律動》	名詞
＠やせいの	《野生の律動》	名詞
＠やせいのり	《野生の律動》	名詞
＠やせいのりつ	《野生の律動》	名詞
＠やせいのりつど	《野生の律動》	名詞
＠やせいのりつどう	《野生の律動》	名詞
＠や	《野蛮な一撃》	名詞
＠やば	《野蛮な一撃》	名詞
＠やばん	《野蛮な一撃》	名詞
＠やばんな	《野蛮な一撃》	名詞
＠やばんない	《野蛮な一撃》	名詞
＠やばんないち	《野蛮な一撃》	名詞
＠やばんないちげ	《野蛮な一撃》	名詞
＠やばんないちげき	《野蛮な一撃》	名詞
＠え	《鋭射手の斉射》	名詞
＠えい	《鋭射手の斉射》	名詞
＠えいし	《鋭射手の斉射》	名詞
＠えいしゃ	《鋭射手の斉射》	名詞
＠えいしゃし	《鋭射手の斉射》	名詞
＠えいしゃしゅ	《鋭射手の斉射》	名詞
＠えいしゃしゅの	《鋭射手の斉射》	名詞
＠えいしゃしゅのせ	《鋭射手の斉射》	名詞
＠えいしゃしゅのせい	《鋭射手の斉射》	名詞
＠えいしゃしゅのせいし	《鋭射手の斉射》	名詞
＠えいしゃしゅのせいしゃ	《鋭射手の斉射》	名詞
＠か	《鏡の行進》	名詞
＠かが	《鏡の行進》	名詞
＠かがみ	《鏡の行進》	名詞
＠かがみの	《鏡の行進》	名詞
＠かがみのこ	《鏡の行進》	名詞
＠かがみのこう	《鏡の行進》	名詞
＠かがみのこうし	《鏡の行進》	名詞
＠かがみのこうしん	《鏡の行進》	名詞
＠も	《門の巨像》	名詞
＠もん	《門の巨像》	名詞
＠もんの	《門の巨像》	名詞
＠もんのき	《門の巨像》	名詞
＠もんのきょ	《門の巨像》	名詞
＠もんのきょぞ	《門の巨像》	名詞
＠もんのきょぞう	《門の巨像》	名詞
＠も	《門破りの雄羊》	名詞
＠もん	《門破りの雄羊》	名詞
＠もんや	《門破りの雄羊》	名詞
＠もんやぶ	《門破りの雄羊》	名詞
＠もんやぶり	《門破りの雄羊》	名詞
＠もんやぶりの	《門破りの雄羊》	名詞
＠もんやぶりのお	《門破りの雄羊》	名詞
＠もんやぶりのおひ	《門破りの雄羊》	名詞
＠もんやぶりのおひつ	《門破りの雄羊》	名詞
＠もんやぶりのおひつじ	《門破りの雄羊》	名詞
＠も	《門道の密行者》	名詞
＠もん	《門道の密行者》	名詞
＠もんみ	《門道の密行者》	名詞
＠もんみち	《門道の密行者》	名詞
＠もんみちの	《門道の密行者》	名詞
＠もんみちのみ	《門道の密行者》	名詞
＠もんみちのみっ	《門道の密行者》	名詞
＠もんみちのみっこ	《門道の密行者》	名詞
＠もんみちのみっこう	《門道の密行者》	名詞
＠もんみちのみっこうし	《門道の密行者》	名詞
＠もんみちのみっこうしゃ	《門道の密行者》	名詞
＠か	《開展》	名詞
＠かい	《開展》	名詞
＠かいて	《開展》	名詞
＠かいてん	《開展》	名詞
＠か	《開門》	名詞
＠かい	《開門》	名詞
＠かいも	《開門》	名詞
＠かいもん	《開門》	名詞
＠し	《集団強制》	名詞
＠しゅ	《集団強制》	名詞
＠しゅう	《集団強制》	名詞
＠しゅうだ	《集団強制》	名詞
＠しゅうだん	《集団強制》	名詞
＠しゅうだんき	《集団強制》	名詞
＠しゅうだんきょ	《集団強制》	名詞
＠しゅうだんきょう	《集団強制》	名詞
＠しゅうだんきょうせ	《集団強制》	名詞
＠しゅうだんきょうせい	《集団強制》	名詞
＠ら	《雷電支配》	名詞
＠らい	《雷電支配》	名詞
＠らいで	《雷電支配》	名詞
＠らいでん	《雷電支配》	名詞
＠らいでんし	《雷電支配》	名詞
＠らいでんしは	《雷電支配》	名詞
＠らいでんしはい	《雷電支配》	名詞
＠し	《首席議長ヴァニファール》	名詞
＠しゅ	《首席議長ヴァニファール》	名詞
＠しゅせ	《首席議長ヴァニファール》	名詞
＠しゅせき	《首席議長ヴァニファール》	名詞
＠しゅせきぎ	《首席議長ヴァニファール》	名詞
＠しゅせきぎち	《首席議長ヴァニファール》	名詞
＠しゅせきぎちょ	《首席議長ヴァニファール》	名詞
＠しゅせきぎちょう	《首席議長ヴァニファール》	名詞
＠しゅせきぎちょうヴ	《首席議長ヴァニファール》	名詞
＠しゅせきぎちょうヴぁ	《首席議長ヴァニファール》	名詞
＠しゅせきぎちょうヴぁに	《首席議長ヴァニファール》	名詞
＠しゅせきぎちょうヴぁにふ	《首席議長ヴァニファール》	名詞
＠しゅせきぎちょうヴぁにふぁ	《首席議長ヴァニファール》	名詞
＠しゅせきぎちょうヴぁにふぁー	《首席議長ヴァニファール》	名詞
＠しゅせきぎちょうヴぁにふぁーる	《首席議長ヴァニファール》	名詞
＠さ	《騒がしいシャーマン》	名詞
＠さわ	《騒がしいシャーマン》	名詞
＠さわが	《騒がしいシャーマン》	名詞
＠さわがし	《騒がしいシャーマン》	名詞
＠さわがしい	《騒がしいシャーマン》	名詞
＠さわがしいし	《騒がしいシャーマン》	名詞
＠さわがしいしゃ	《騒がしいシャーマン》	名詞
＠さわがしいしゃー	《騒がしいシャーマン》	名詞
＠さわがしいしゃーま	《騒がしいシャーマン》	名詞
＠さわがしいしゃーまん	《騒がしいシャーマン》	名詞
＠そ	《騒乱の落とし子》	名詞
＠そう	《騒乱の落とし子》	名詞
＠そうら	《騒乱の落とし子》	名詞
＠そうらん	《騒乱の落とし子》	名詞
＠そうらんの	《騒乱の落とし子》	名詞
＠そうらんのお	《騒乱の落とし子》	名詞
＠そうらんのおと	《騒乱の落とし子》	名詞
＠そうらんのおとし	《騒乱の落とし子》	名詞
＠そうらんのおとしご	《騒乱の落とし子》	名詞
＠た	《高塔の憑依者》	名詞
＠たか	《高塔の憑依者》	名詞
＠たかと	《高塔の憑依者》	名詞
＠たかとう	《高塔の憑依者》	名詞
＠たかとうの	《高塔の憑依者》	名詞
＠たかとうのひ	《高塔の憑依者》	名詞
＠たかとうのひょ	《高塔の憑依者》	名詞
＠たかとうのひょう	《高塔の憑依者》	名詞
＠たかとうのひょうい	《高塔の憑依者》	名詞
＠たかとうのひょういし	《高塔の憑依者》	名詞
＠たかとうのひょういしゃ	《高塔の憑依者》	名詞
＠ま	《魔性》	名詞
＠まし	《魔性》	名詞
＠ましょ	《魔性》	名詞
＠ましょう	《魔性》	名詞
＠た	《黄昏の豹》	名詞
＠たそ	《黄昏の豹》	名詞
＠たそが	《黄昏の豹》	名詞
＠たそがれ	《黄昏の豹》	名詞
＠たそがれの	《黄昏の豹》	名詞
＠たそがれのひ	《黄昏の豹》	名詞
＠たそがれのひょ	《黄昏の豹》	名詞
＠たそがれのひょう	《黄昏の豹》	名詞
