＠つ	《つぶやく神秘家》	名詞
＠つぶ	《つぶやく神秘家》	名詞
＠つぶや	《つぶやく神秘家》	名詞
＠つぶやく	《つぶやく神秘家》	名詞
＠つぶやくし	《つぶやく神秘家》	名詞
＠つぶやくしん	《つぶやく神秘家》	名詞
＠つぶやくしんぴ	《つぶやく神秘家》	名詞
＠つぶやくしんぴか	《つぶやく神秘家》	名詞
＠な	《なかったことに》	名詞
＠なか	《なかったことに》	名詞
＠なかっ	《なかったことに》	名詞
＠なかった	《なかったことに》	名詞
＠なかったこ	《なかったことに》	名詞
＠なかったこと	《なかったことに》	名詞
＠なかったことに	《なかったことに》	名詞
＠よ	《よろめく根茎》	名詞
＠よろ	《よろめく根茎》	名詞
＠よろめ	《よろめく根茎》	名詞
＠よろめく	《よろめく根茎》	名詞
＠よろめくこ	《よろめく根茎》	名詞
＠よろめくこん	《よろめく根茎》	名詞
＠よろめくこんけ	《よろめく根茎》	名詞
＠よろめくこんけい	《よろめく根茎》	名詞
＠い	《イオン化》	名詞
＠いお	《イオン化》	名詞
＠いおん	《イオン化》	名詞
＠いおんか	《イオン化》	名詞
＠い	《イゼットのギルド門》	名詞
＠いぜ	《イゼットのギルド門》	名詞
＠いぜっ	《イゼットのギルド門》	名詞
＠いぜっと	《イゼットのギルド門》	名詞
＠いぜっとの	《イゼットのギルド門》	名詞
＠いぜっとのぎ	《イゼットのギルド門》	名詞
＠いぜっとのぎる	《イゼットのギルド門》	名詞
＠いぜっとのぎるど	《イゼットのギルド門》	名詞
＠いぜっとのぎるども	《イゼットのギルド門》	名詞
＠いぜっとのぎるどもん	《イゼットのギルド門》	名詞
＠い	《イゼットのロケット》	名詞
＠いぜ	《イゼットのロケット》	名詞
＠いぜっ	《イゼットのロケット》	名詞
＠いぜっと	《イゼットのロケット》	名詞
＠いぜっとの	《イゼットのロケット》	名詞
＠いぜっとのろ	《イゼットのロケット》	名詞
＠いぜっとのろけ	《イゼットのロケット》	名詞
＠いぜっとのろけっ	《イゼットのロケット》	名詞
＠いぜっとのろけっと	《イゼットのロケット》	名詞
＠い	《イゼット副長、ラル》	名詞
＠いぜ	《イゼット副長、ラル》	名詞
＠いぜっ	《イゼット副長、ラル》	名詞
＠いぜっと	《イゼット副長、ラル》	名詞
＠いぜっとふ	《イゼット副長、ラル》	名詞
＠いぜっとふく	《イゼット副長、ラル》	名詞
＠いぜっとふくち	《イゼット副長、ラル》	名詞
＠いぜっとふくちょ	《イゼット副長、ラル》	名詞
＠いぜっとふくちょう	《イゼット副長、ラル》	名詞
＠いぜっとふくちょう、	《イゼット副長、ラル》	名詞
＠いぜっとふくちょう、ら	《イゼット副長、ラル》	名詞
＠いぜっとふくちょう、らる	《イゼット副長、ラル》	名詞
＠う	《ウォジェクの護衛》	名詞
＠うぉ	《ウォジェクの護衛》	名詞
＠うぉじ	《ウォジェクの護衛》	名詞
＠うぉじぇ	《ウォジェクの護衛》	名詞
＠うぉじぇく	《ウォジェクの護衛》	名詞
＠うぉじぇくの	《ウォジェクの護衛》	名詞
＠うぉじぇくのご	《ウォジェクの護衛》	名詞
＠うぉじぇくのごえ	《ウォジェクの護衛》	名詞
＠うぉじぇくのごえい	《ウォジェクの護衛》	名詞
＠お	《オクランの暗殺者》	名詞
＠おく	《オクランの暗殺者》	名詞
＠おくら	《オクランの暗殺者》	名詞
＠おくらん	《オクランの暗殺者》	名詞
＠おくらんの	《オクランの暗殺者》	名詞
＠おくらんのあ	《オクランの暗殺者》	名詞
＠おくらんのあん	《オクランの暗殺者》	名詞
＠おくらんのあんさ	《オクランの暗殺者》	名詞
＠おくらんのあんさつ	《オクランの暗殺者》	名詞
＠おくらんのあんさつし	《オクランの暗殺者》	名詞
＠おくらんのあんさつしゃ	《オクランの暗殺者》	名詞
＠ぎ	《ギルドパクトの大剣》	名詞
＠ぎる	《ギルドパクトの大剣》	名詞
＠ぎるど	《ギルドパクトの大剣》	名詞
＠ぎるどぱ	《ギルドパクトの大剣》	名詞
＠ぎるどぱく	《ギルドパクトの大剣》	名詞
＠ぎるどぱくと	《ギルドパクトの大剣》	名詞
＠ぎるどぱくとの	《ギルドパクトの大剣》	名詞
＠ぎるどぱくとのた	《ギルドパクトの大剣》	名詞
＠ぎるどぱくとのたい	《ギルドパクトの大剣》	名詞
＠ぎるどぱくとのたいけ	《ギルドパクトの大剣》	名詞
＠ぎるどぱくとのたいけん	《ギルドパクトの大剣》	名詞
＠ぎ	《ギルド会談》	名詞
＠ぎる	《ギルド会談》	名詞
＠ぎるど	《ギルド会談》	名詞
＠ぎるどか	《ギルド会談》	名詞
＠ぎるどかい	《ギルド会談》	名詞
＠ぎるどかいだ	《ギルド会談》	名詞
＠ぎるどかいだん	《ギルド会談》	名詞
＠ぎ	《ギルド門通りの公有地》	名詞
＠ぎる	《ギルド門通りの公有地》	名詞
＠ぎるど	《ギルド門通りの公有地》	名詞
＠ぎるども	《ギルド門通りの公有地》	名詞
＠ぎるどもん	《ギルド門通りの公有地》	名詞
＠ぎるどもんど	《ギルド門通りの公有地》	名詞
＠ぎるどもんどお	《ギルド門通りの公有地》	名詞
＠ぎるどもんどおり	《ギルド門通りの公有地》	名詞
＠ぎるどもんどおりの	《ギルド門通りの公有地》	名詞
＠ぎるどもんどおりのこ	《ギルド門通りの公有地》	名詞
＠ぎるどもんどおりのこう	《ギルド門通りの公有地》	名詞
＠ぎるどもんどおりのこうゆ	《ギルド門通りの公有地》	名詞
＠ぎるどもんどおりのこうゆう	《ギルド門通りの公有地》	名詞
＠ぎるどもんどおりのこうゆうち	《ギルド門通りの公有地》	名詞
＠ぎ	《ギルド魔道士の広場》	名詞
＠ぎる	《ギルド魔道士の広場》	名詞
＠ぎるど	《ギルド魔道士の広場》	名詞
＠ぎるどま	《ギルド魔道士の広場》	名詞
＠ぎるどまど	《ギルド魔道士の広場》	名詞
＠ぎるどまどう	《ギルド魔道士の広場》	名詞
＠ぎるどまどうし	《ギルド魔道士の広場》	名詞
＠ぎるどまどうしの	《ギルド魔道士の広場》	名詞
＠ぎるどまどうしのひ	《ギルド魔道士の広場》	名詞
＠ぎるどまどうしのひろ	《ギルド魔道士の広場》	名詞
＠ぎるどまどうしのひろば	《ギルド魔道士の広場》	名詞
＠く	《クロールの略奪者》	名詞
＠くろ	《クロールの略奪者》	名詞
＠くろー	《クロールの略奪者》	名詞
＠くろーる	《クロールの略奪者》	名詞
＠くろーるの	《クロールの略奪者》	名詞
＠くろーるのり	《クロールの略奪者》	名詞
＠くろーるのりゃ	《クロールの略奪者》	名詞
＠くろーるのりゃく	《クロールの略奪者》	名詞
＠くろーるのりゃくだ	《クロールの略奪者》	名詞
＠くろーるのりゃくだつ	《クロールの略奪者》	名詞
＠くろーるのりゃくだつし	《クロールの略奪者》	名詞
＠くろーるのりゃくだつしゃ	《クロールの略奪者》	名詞
＠く	《クロールの群れ》	名詞
＠くろ	《クロールの群れ》	名詞
＠くろー	《クロールの群れ》	名詞
＠くろーる	《クロールの群れ》	名詞
＠くろーるの	《クロールの群れ》	名詞
＠くろーるのむ	《クロールの群れ》	名詞
＠くろーるのむれ	《クロールの群れ》	名詞
＠く	《クロールの銛撃ち》	名詞
＠くろ	《クロールの銛撃ち》	名詞
＠くろー	《クロールの銛撃ち》	名詞
＠くろーる	《クロールの銛撃ち》	名詞
＠くろーるの	《クロールの銛撃ち》	名詞
＠くろーるのも	《クロールの銛撃ち》	名詞
＠くろーるのもり	《クロールの銛撃ち》	名詞
＠くろーるのもりう	《クロールの銛撃ち》	名詞
＠くろーるのもりうち	《クロールの銛撃ち》	名詞
＠く	《クロールの食料隊》	名詞
＠くろ	《クロールの食料隊》	名詞
＠くろー	《クロールの食料隊》	名詞
＠くろーる	《クロールの食料隊》	名詞
＠くろーるの	《クロールの食料隊》	名詞
＠くろーるのし	《クロールの食料隊》	名詞
＠くろーるのしょ	《クロールの食料隊》	名詞
＠くろーるのしょく	《クロールの食料隊》	名詞
＠くろーるのしょくり	《クロールの食料隊》	名詞
＠くろーるのしょくりょ	《クロールの食料隊》	名詞
＠くろーるのしょくりょう	《クロールの食料隊》	名詞
＠くろーるのしょくりょうた	《クロールの食料隊》	名詞
＠くろーるのしょくりょうたい	《クロールの食料隊》	名詞
＠け	《ケンタウルスの仲裁者》	名詞
＠けん	《ケンタウルスの仲裁者》	名詞
＠けんた	《ケンタウルスの仲裁者》	名詞
＠けんたう	《ケンタウルスの仲裁者》	名詞
＠けんたうる	《ケンタウルスの仲裁者》	名詞
＠けんたうるす	《ケンタウルスの仲裁者》	名詞
＠けんたうるすの	《ケンタウルスの仲裁者》	名詞
＠けんたうるすのち	《ケンタウルスの仲裁者》	名詞
＠けんたうるすのちゅ	《ケンタウルスの仲裁者》	名詞
＠けんたうるすのちゅう	《ケンタウルスの仲裁者》	名詞
＠けんたうるすのちゅうさ	《ケンタウルスの仲裁者》	名詞
＠けんたうるすのちゅうさい	《ケンタウルスの仲裁者》	名詞
＠けんたうるすのちゅうさいし	《ケンタウルスの仲裁者》	名詞
＠けんたうるすのちゅうさいしゃ	《ケンタウルスの仲裁者》	名詞
＠ご	《ゴブリンのクレーター掘り》	名詞
＠ごぶ	《ゴブリンのクレーター掘り》	名詞
＠ごぶり	《ゴブリンのクレーター掘り》	名詞
＠ごぶりん	《ゴブリンのクレーター掘り》	名詞
＠ごぶりんの	《ゴブリンのクレーター掘り》	名詞
＠ごぶりんのく	《ゴブリンのクレーター掘り》	名詞
＠ごぶりんのくれ	《ゴブリンのクレーター掘り》	名詞
＠ごぶりんのくれー	《ゴブリンのクレーター掘り》	名詞
＠ごぶりんのくれーた	《ゴブリンのクレーター掘り》	名詞
＠ごぶりんのくれーたー	《ゴブリンのクレーター掘り》	名詞
＠ごぶりんのくれーたーほ	《ゴブリンのクレーター掘り》	名詞
＠ごぶりんのくれーたーほり	《ゴブリンのクレーター掘り》	名詞
＠ご	《ゴブリンの旗持ち》	名詞
＠ごぶ	《ゴブリンの旗持ち》	名詞
＠ごぶり	《ゴブリンの旗持ち》	名詞
＠ごぶりん	《ゴブリンの旗持ち》	名詞
＠ごぶりんの	《ゴブリンの旗持ち》	名詞
＠ごぶりんのは	《ゴブリンの旗持ち》	名詞
＠ごぶりんのはた	《ゴブリンの旗持ち》	名詞
＠ごぶりんのはたも	《ゴブリンの旗持ち》	名詞
＠ごぶりんのはたもち	《ゴブリンの旗持ち》	名詞
＠ご	《ゴブリンの鍵師》	名詞
＠ごぶ	《ゴブリンの鍵師》	名詞
＠ごぶり	《ゴブリンの鍵師》	名詞
＠ごぶりん	《ゴブリンの鍵師》	名詞
＠ごぶりんの	《ゴブリンの鍵師》	名詞
＠ごぶりんのか	《ゴブリンの鍵師》	名詞
＠ごぶりんのかぎ	《ゴブリンの鍵師》	名詞
＠ごぶりんのかぎし	《ゴブリンの鍵師》	名詞
＠ご	《ゴブリンの電術師》	名詞
＠ごぶ	《ゴブリンの電術師》	名詞
＠ごぶり	《ゴブリンの電術師》	名詞
＠ごぶりん	《ゴブリンの電術師》	名詞
＠ごぶりんの	《ゴブリンの電術師》	名詞
＠ごぶりんので	《ゴブリンの電術師》	名詞
＠ごぶりんのでん	《ゴブリンの電術師》	名詞
＠ごぶりんのでんや	《ゴブリンの電術師》	名詞
＠ごぶりんのでんやす	《ゴブリンの電術師》	名詞
＠ごぶりんのでんやすし	《ゴブリンの電術師》	名詞
＠ごぶりんのでんやすしし	《ゴブリンの電術師》	名詞
＠ご	《ゴルガリのギルド門》	名詞
＠ごる	《ゴルガリのギルド門》	名詞
＠ごるが	《ゴルガリのギルド門》	名詞
＠ごるがり	《ゴルガリのギルド門》	名詞
＠ごるがりの	《ゴルガリのギルド門》	名詞
＠ごるがりのぎ	《ゴルガリのギルド門》	名詞
＠ごるがりのぎる	《ゴルガリのギルド門》	名詞
＠ごるがりのぎるど	《ゴルガリのギルド門》	名詞
＠ごるがりのぎるども	《ゴルガリのギルド門》	名詞
＠ごるがりのぎるどもん	《ゴルガリのギルド門》	名詞
＠ご	《ゴルガリのロケット》	名詞
＠ごる	《ゴルガリのロケット》	名詞
＠ごるが	《ゴルガリのロケット》	名詞
＠ごるがり	《ゴルガリのロケット》	名詞
＠ごるがりの	《ゴルガリのロケット》	名詞
＠ごるがりのろ	《ゴルガリのロケット》	名詞
＠ごるがりのろけ	《ゴルガリのロケット》	名詞
＠ごるがりのろけっ	《ゴルガリのロケット》	名詞
＠ごるがりのろけっと	《ゴルガリのロケット》	名詞
＠ご	《ゴルガリの女王、ヴラスカ》	名詞
＠ごる	《ゴルガリの女王、ヴラスカ》	名詞
＠ごるが	《ゴルガリの女王、ヴラスカ》	名詞
＠ごるがり	《ゴルガリの女王、ヴラスカ》	名詞
＠ごるがりの	《ゴルガリの女王、ヴラスカ》	名詞
＠ごるがりのじ	《ゴルガリの女王、ヴラスカ》	名詞
＠ごるがりのじょ	《ゴルガリの女王、ヴラスカ》	名詞
＠ごるがりのじょお	《ゴルガリの女王、ヴラスカ》	名詞
＠ごるがりのじょおう	《ゴルガリの女王、ヴラスカ》	名詞
＠ごるがりのじょおう、	《ゴルガリの女王、ヴラスカ》	名詞
＠ごるがりのじょおう、ヴ	《ゴルガリの女王、ヴラスカ》	名詞
＠ごるがりのじょおう、ヴら	《ゴルガリの女王、ヴラスカ》	名詞
＠ごるがりのじょおう、ヴらす	《ゴルガリの女王、ヴラスカ》	名詞
＠ごるがりのじょおう、ヴらすか	《ゴルガリの女王、ヴラスカ》	名詞
＠ご	《ゴルガリの拾売人》	名詞
＠ごる	《ゴルガリの拾売人》	名詞
＠ごるが	《ゴルガリの拾売人》	名詞
＠ごるがり	《ゴルガリの拾売人》	名詞
＠ごるがりの	《ゴルガリの拾売人》	名詞
＠ごるがりのば	《ゴルガリの拾売人》	名詞
＠ごるがりのばい	《ゴルガリの拾売人》	名詞
＠ごるがりのばいに	《ゴルガリの拾売人》	名詞
＠ごるがりのばいにん	《ゴルガリの拾売人》	名詞
＠ご	《ゴルガリの略奪者》	名詞
＠ごる	《ゴルガリの略奪者》	名詞
＠ごるが	《ゴルガリの略奪者》	名詞
＠ごるがり	《ゴルガリの略奪者》	名詞
＠ごるがりの	《ゴルガリの略奪者》	名詞
＠ごるがりのり	《ゴルガリの略奪者》	名詞
＠ごるがりのりゃ	《ゴルガリの略奪者》	名詞
＠ごるがりのりゃく	《ゴルガリの略奪者》	名詞
＠ごるがりのりゃくだ	《ゴルガリの略奪者》	名詞
＠ごるがりのりゃくだつ	《ゴルガリの略奪者》	名詞
＠ごるがりのりゃくだつし	《ゴルガリの略奪者》	名詞
＠ごるがりのりゃくだつしゃ	《ゴルガリの略奪者》	名詞
＠さ	《サンホームの重鎮》	名詞
＠さん	《サンホームの重鎮》	名詞
＠さんほ	《サンホームの重鎮》	名詞
＠さんほー	《サンホームの重鎮》	名詞
＠さんほーむ	《サンホームの重鎮》	名詞
＠さんほーむの	《サンホームの重鎮》	名詞
＠さんほーむのじ	《サンホームの重鎮》	名詞
＠さんほーむのじゅ	《サンホームの重鎮》	名詞
＠さんほーむのじゅう	《サンホームの重鎮》	名詞
＠さんほーむのじゅうち	《サンホームの重鎮》	名詞
＠さんほーむのじゅうちん	《サンホームの重鎮》	名詞
＠す	《スマーラの森整形師》	名詞
＠すま	《スマーラの森整形師》	名詞
＠すまー	《スマーラの森整形師》	名詞
＠すまーら	《スマーラの森整形師》	名詞
＠すまーらの	《スマーラの森整形師》	名詞
＠すまーらのも	《スマーラの森整形師》	名詞
＠すまーらのもり	《スマーラの森整形師》	名詞
＠すまーらのもりせ	《スマーラの森整形師》	名詞
＠すまーらのもりせい	《スマーラの森整形師》	名詞
＠すまーらのもりせいけ	《スマーラの森整形師》	名詞
＠すまーらのもりせいけい	《スマーラの森整形師》	名詞
＠すまーらのもりせいけいし	《スマーラの森整形師》	名詞
＠せ	《セレズニアのギルド門》	名詞
＠せれ	《セレズニアのギルド門》	名詞
＠せれず	《セレズニアのギルド門》	名詞
＠せれずに	《セレズニアのギルド門》	名詞
＠せれずにあ	《セレズニアのギルド門》	名詞
＠せれずにあの	《セレズニアのギルド門》	名詞
＠せれずにあのぎ	《セレズニアのギルド門》	名詞
＠せれずにあのぎる	《セレズニアのギルド門》	名詞
＠せれずにあのぎるど	《セレズニアのギルド門》	名詞
＠せれずにあのぎるども	《セレズニアのギルド門》	名詞
＠せれずにあのぎるどもん	《セレズニアのギルド門》	名詞
＠せ	《セレズニアのロケット》	名詞
＠せれ	《セレズニアのロケット》	名詞
＠せれず	《セレズニアのロケット》	名詞
＠せれずに	《セレズニアのロケット》	名詞
＠せれずにあ	《セレズニアのロケット》	名詞
＠せれずにあの	《セレズニアのロケット》	名詞
＠せれずにあのろ	《セレズニアのロケット》	名詞
＠せれずにあのろけ	《セレズニアのロケット》	名詞
＠せれずにあのろけっ	《セレズニアのロケット》	名詞
＠せれずにあのろけっと	《セレズニアのロケット》	名詞
＠で	《ディミーアのギルド門》	名詞
＠でぃ	《ディミーアのギルド門》	名詞
＠でぃみ	《ディミーアのギルド門》	名詞
＠でぃみー	《ディミーアのギルド門》	名詞
＠でぃみーあ	《ディミーアのギルド門》	名詞
＠でぃみーあの	《ディミーアのギルド門》	名詞
＠でぃみーあのぎ	《ディミーアのギルド門》	名詞
＠でぃみーあのぎる	《ディミーアのギルド門》	名詞
＠でぃみーあのぎるど	《ディミーアのギルド門》	名詞
＠でぃみーあのぎるども	《ディミーアのギルド門》	名詞
＠でぃみーあのぎるどもん	《ディミーアのギルド門》	名詞
＠で	《ディミーアのロケット》	名詞
＠でぃ	《ディミーアのロケット》	名詞
＠でぃみ	《ディミーアのロケット》	名詞
＠でぃみー	《ディミーアのロケット》	名詞
＠でぃみーあ	《ディミーアのロケット》	名詞
＠でぃみーあの	《ディミーアのロケット》	名詞
＠でぃみーあのろ	《ディミーアのロケット》	名詞
＠でぃみーあのろけ	《ディミーアのロケット》	名詞
＠でぃみーあのろけっ	《ディミーアのロケット》	名詞
＠でぃみーあのろけっと	《ディミーアのロケット》	名詞
＠で	《ディミーアの偵察虫》	名詞
＠でぃ	《ディミーアの偵察虫》	名詞
＠でぃみ	《ディミーアの偵察虫》	名詞
＠でぃみー	《ディミーアの偵察虫》	名詞
＠でぃみーあ	《ディミーアの偵察虫》	名詞
＠でぃみーあの	《ディミーアの偵察虫》	名詞
＠でぃみーあのて	《ディミーアの偵察虫》	名詞
＠でぃみーあのてい	《ディミーアの偵察虫》	名詞
＠でぃみーあのていさ	《ディミーアの偵察虫》	名詞
＠でぃみーあのていさつ	《ディミーアの偵察虫》	名詞
＠でぃみーあのていさつむ	《ディミーアの偵察虫》	名詞
＠でぃみーあのていさつむし	《ディミーアの偵察虫》	名詞
＠で	《ディミーアの密告者》	名詞
＠でぃ	《ディミーアの密告者》	名詞
＠でぃみ	《ディミーアの密告者》	名詞
＠でぃみー	《ディミーアの密告者》	名詞
＠でぃみーあ	《ディミーアの密告者》	名詞
＠でぃみーあの	《ディミーアの密告者》	名詞
＠でぃみーあのみ	《ディミーアの密告者》	名詞
＠でぃみーあのみっ	《ディミーアの密告者》	名詞
＠でぃみーあのみっこ	《ディミーアの密告者》	名詞
＠でぃみーあのみっこく	《ディミーアの密告者》	名詞
＠でぃみーあのみっこくし	《ディミーアの密告者》	名詞
＠でぃみーあのみっこくしゃ	《ディミーアの密告者》	名詞
＠で	《デヴカリンの造反者》	名詞
＠でヴ	《デヴカリンの造反者》	名詞
＠でヴか	《デヴカリンの造反者》	名詞
＠でヴかり	《デヴカリンの造反者》	名詞
＠でヴかりん	《デヴカリンの造反者》	名詞
＠でヴかりんの	《デヴカリンの造反者》	名詞
＠でヴかりんのぞ	《デヴカリンの造反者》	名詞
＠でヴかりんのぞう	《デヴカリンの造反者》	名詞
＠でヴかりんのぞうは	《デヴカリンの造反者》	名詞
＠でヴかりんのぞうはん	《デヴカリンの造反者》	名詞
＠でヴかりんのぞうはんし	《デヴカリンの造反者》	名詞
＠でヴかりんのぞうはんしゃ	《デヴカリンの造反者》	名詞
＠な	《ナルコメーバ》	名詞
＠なる	《ナルコメーバ》	名詞
＠なるこ	《ナルコメーバ》	名詞
＠なるこめ	《ナルコメーバ》	名詞
＠なるこめー	《ナルコメーバ》	名詞
＠なるこめーば	《ナルコメーバ》	名詞
＠は	《ハズダーの司法官》	名詞
＠はず	《ハズダーの司法官》	名詞
＠はずだ	《ハズダーの司法官》	名詞
＠はずだー	《ハズダーの司法官》	名詞
＠はずだーの	《ハズダーの司法官》	名詞
＠はずだーのし	《ハズダーの司法官》	名詞
＠はずだーのしほ	《ハズダーの司法官》	名詞
＠はずだーのしほう	《ハズダーの司法官》	名詞
＠はずだーのしほうか	《ハズダーの司法官》	名詞
＠はずだーのしほうかん	《ハズダーの司法官》	名詞
＠ぱ	《パルヘリオンの巡視兵》	名詞
＠ぱる	《パルヘリオンの巡視兵》	名詞
＠ぱるへ	《パルヘリオンの巡視兵》	名詞
＠ぱるへり	《パルヘリオンの巡視兵》	名詞
＠ぱるへりお	《パルヘリオンの巡視兵》	名詞
＠ぱるへりおん	《パルヘリオンの巡視兵》	名詞
＠ぱるへりおんの	《パルヘリオンの巡視兵》	名詞
＠ぱるへりおんのじ	《パルヘリオンの巡視兵》	名詞
＠ぱるへりおんのじゅ	《パルヘリオンの巡視兵》	名詞
＠ぱるへりおんのじゅん	《パルヘリオンの巡視兵》	名詞
＠ぱるへりおんのじゅんし	《パルヘリオンの巡視兵》	名詞
＠ぱるへりおんのじゅんしへ	《パルヘリオンの巡視兵》	名詞
＠ぱるへりおんのじゅんしへい	《パルヘリオンの巡視兵》	名詞
＠ぱ	《パルン、ニヴ＝ミゼット》	名詞
＠ぱる	《パルン、ニヴ＝ミゼット》	名詞
＠ぱるん	《パルン、ニヴ＝ミゼット》	名詞
＠ぱるん、	《パルン、ニヴ＝ミゼット》	名詞
＠ぱるん、に	《パルン、ニヴ＝ミゼット》	名詞
＠ぱるん、にヴ	《パルン、ニヴ＝ミゼット》	名詞
＠ぱるん、にヴ＝	《パルン、ニヴ＝ミゼット》	名詞
＠ぱるん、にヴ＝み	《パルン、ニヴ＝ミゼット》	名詞
＠ぱるん、にヴ＝みぜ	《パルン、ニヴ＝ミゼット》	名詞
＠ぱるん、にヴ＝みぜっ	《パルン、ニヴ＝ミゼット》	名詞
＠ぱるん、にヴ＝みぜっと	《パルン、ニヴ＝ミゼット》	名詞
＠ぴ	《ピストン拳のサイクロプス》	名詞
＠ぴす	《ピストン拳のサイクロプス》	名詞
＠ぴすと	《ピストン拳のサイクロプス》	名詞
＠ぴすとん	《ピストン拳のサイクロプス》	名詞
＠ぴすとんこ	《ピストン拳のサイクロプス》	名詞
＠ぴすとんこぶ	《ピストン拳のサイクロプス》	名詞
＠ぴすとんこぶし	《ピストン拳のサイクロプス》	名詞
＠ぴすとんこぶしの	《ピストン拳のサイクロプス》	名詞
＠ぴすとんこぶしのさ	《ピストン拳のサイクロプス》	名詞
＠ぴすとんこぶしのさい	《ピストン拳のサイクロプス》	名詞
＠ぴすとんこぶしのさいく	《ピストン拳のサイクロプス》	名詞
＠ぴすとんこぶしのさいくろ	《ピストン拳のサイクロプス》	名詞
＠ぴすとんこぶしのさいくろぷ	《ピストン拳のサイクロプス》	名詞
＠ぴすとんこぶしのさいくろぷす	《ピストン拳のサイクロプス》	名詞
＠へ	《ヘルカイトの仔》	名詞
＠へる	《ヘルカイトの仔》	名詞
＠へるか	《ヘルカイトの仔》	名詞
＠へるかい	《ヘルカイトの仔》	名詞
＠へるかいと	《ヘルカイトの仔》	名詞
＠へるかいとの	《ヘルカイトの仔》	名詞
＠へるかいとのこ	《ヘルカイトの仔》	名詞
＠ぼ	《ボロスのギルド門》	名詞
＠ぼろ	《ボロスのギルド門》	名詞
＠ぼろす	《ボロスのギルド門》	名詞
＠ぼろすの	《ボロスのギルド門》	名詞
＠ぼろすのぎ	《ボロスのギルド門》	名詞
＠ぼろすのぎる	《ボロスのギルド門》	名詞
＠ぼろすのぎるど	《ボロスのギルド門》	名詞
＠ぼろすのぎるども	《ボロスのギルド門》	名詞
＠ぼろすのぎるどもん	《ボロスのギルド門》	名詞
＠ぼ	《ボロスのロケット》	名詞
＠ぼろ	《ボロスのロケット》	名詞
＠ぼろす	《ボロスのロケット》	名詞
＠ぼろすの	《ボロスのロケット》	名詞
＠ぼろすのろ	《ボロスのロケット》	名詞
＠ぼろすのろけ	《ボロスのロケット》	名詞
＠ぼろすのろけっ	《ボロスのロケット》	名詞
＠ぼろすのろけっと	《ボロスのロケット》	名詞
＠ぼ	《ボロスの挑戦者》	名詞
＠ぼろ	《ボロスの挑戦者》	名詞
＠ぼろす	《ボロスの挑戦者》	名詞
＠ぼろすの	《ボロスの挑戦者》	名詞
＠ぼろすのち	《ボロスの挑戦者》	名詞
＠ぼろすのちょ	《ボロスの挑戦者》	名詞
＠ぼろすのちょう	《ボロスの挑戦者》	名詞
＠ぼろすのちょうせ	《ボロスの挑戦者》	名詞
＠ぼろすのちょうせん	《ボロスの挑戦者》	名詞
＠ぼろすのちょうせんし	《ボロスの挑戦者》	名詞
＠ぼろすのちょうせんしゃ	《ボロスの挑戦者》	名詞
＠ら	《ラルの消散》	名詞
＠らる	《ラルの消散》	名詞
＠らるの	《ラルの消散》	名詞
＠らるのし	《ラルの消散》	名詞
＠らるのしょ	《ラルの消散》	名詞
＠らるのしょう	《ラルの消散》	名詞
＠らるのしょうさ	《ラルの消散》	名詞
＠らるのしょうさん	《ラルの消散》	名詞
＠ら	《ラルの静電術師》	名詞
＠らる	《ラルの静電術師》	名詞
＠らるの	《ラルの静電術師》	名詞
＠らるのせ	《ラルの静電術師》	名詞
＠らるのせい	《ラルの静電術師》	名詞
＠らるのせいで	《ラルの静電術師》	名詞
＠らるのせいでん	《ラルの静電術師》	名詞
＠らるのせいでんじ	《ラルの静電術師》	名詞
＠らるのせいでんじゅ	《ラルの静電術師》	名詞
＠らるのせいでんじゅつ	《ラルの静電術師》	名詞
＠らるのせいでんじゅつし	《ラルの静電術師》	名詞
＠れ	《レーデヴの勇者》	名詞
＠れー	《レーデヴの勇者》	名詞
＠れーで	《レーデヴの勇者》	名詞
＠れーでヴ	《レーデヴの勇者》	名詞
＠れーでヴの	《レーデヴの勇者》	名詞
＠れーでヴのゆ	《レーデヴの勇者》	名詞
＠れーでヴのゆう	《レーデヴの勇者》	名詞
＠れーでヴのゆうし	《レーデヴの勇者》	名詞
＠れーでヴのゆうしゃ	《レーデヴの勇者》	名詞
＠れ	《レーデヴの守護者》	名詞
＠れー	《レーデヴの守護者》	名詞
＠れーで	《レーデヴの守護者》	名詞
＠れーでヴ	《レーデヴの守護者》	名詞
＠れーでヴの	《レーデヴの守護者》	名詞
＠れーでヴのし	《レーデヴの守護者》	名詞
＠れーでヴのしゅ	《レーデヴの守護者》	名詞
＠れーでヴのしゅご	《レーデヴの守護者》	名詞
＠れーでヴのしゅごし	《レーデヴの守護者》	名詞
＠れーでヴのしゅごしゃ	《レーデヴの守護者》	名詞
＠ろ	《ロクソドンの修復者》	名詞
＠ろく	《ロクソドンの修復者》	名詞
＠ろくそ	《ロクソドンの修復者》	名詞
＠ろくそど	《ロクソドンの修復者》	名詞
＠ろくそどん	《ロクソドンの修復者》	名詞
＠ろくそどんの	《ロクソドンの修復者》	名詞
＠ろくそどんのし	《ロクソドンの修復者》	名詞
＠ろくそどんのしゅ	《ロクソドンの修復者》	名詞
＠ろくそどんのしゅう	《ロクソドンの修復者》	名詞
＠ろくそどんのしゅうふ	《ロクソドンの修復者》	名詞
＠ろくそどんのしゅうふく	《ロクソドンの修復者》	名詞
＠ろくそどんのしゅうふくし	《ロクソドンの修復者》	名詞
＠ろくそどんのしゅうふくしゃ	《ロクソドンの修復者》	名詞
＠ろ	《ロッテスの巨人》	名詞
＠ろっ	《ロッテスの巨人》	名詞
＠ろって	《ロッテスの巨人》	名詞
＠ろってす	《ロッテスの巨人》	名詞
＠ろってすの	《ロッテスの巨人》	名詞
＠ろってすのき	《ロッテスの巨人》	名詞
＠ろってすのきょ	《ロッテスの巨人》	名詞
＠ろってすのきょじ	《ロッテスの巨人》	名詞
＠ろってすのきょじん	《ロッテスの巨人》	名詞
＠ヴ	《ヴァーナーディーの盾仲間》	名詞
＠ヴぁ	《ヴァーナーディーの盾仲間》	名詞
＠ヴぁー	《ヴァーナーディーの盾仲間》	名詞
＠ヴぁーな	《ヴァーナーディーの盾仲間》	名詞
＠ヴぁーなー	《ヴァーナーディーの盾仲間》	名詞
＠ヴぁーなーで	《ヴァーナーディーの盾仲間》	名詞
＠ヴぁーなーでぃ	《ヴァーナーディーの盾仲間》	名詞
＠ヴぁーなーでぃー	《ヴァーナーディーの盾仲間》	名詞
＠ヴぁーなーでぃーの	《ヴァーナーディーの盾仲間》	名詞
＠ヴぁーなーでぃーのた	《ヴァーナーディーの盾仲間》	名詞
＠ヴぁーなーでぃーのたて	《ヴァーナーディーの盾仲間》	名詞
＠ヴぁーなーでぃーのたてな	《ヴァーナーディーの盾仲間》	名詞
＠ヴぁーなーでぃーのたてなか	《ヴァーナーディーの盾仲間》	名詞
＠ヴぁーなーでぃーのたてなかま	《ヴァーナーディーの盾仲間》	名詞
＠ヴ	《ヴィダルケンの催眠術師》	名詞
＠ヴぃ	《ヴィダルケンの催眠術師》	名詞
＠ヴぃだ	《ヴィダルケンの催眠術師》	名詞
＠ヴぃだる	《ヴィダルケンの催眠術師》	名詞
＠ヴぃだるけ	《ヴィダルケンの催眠術師》	名詞
＠ヴぃだるけん	《ヴィダルケンの催眠術師》	名詞
＠ヴぃだるけんの	《ヴィダルケンの催眠術師》	名詞
＠ヴぃだるけんのさ	《ヴィダルケンの催眠術師》	名詞
＠ヴぃだるけんのさい	《ヴィダルケンの催眠術師》	名詞
＠ヴぃだるけんのさいみ	《ヴィダルケンの催眠術師》	名詞
＠ヴぃだるけんのさいみん	《ヴィダルケンの催眠術師》	名詞
＠ヴぃだるけんのさいみんじ	《ヴィダルケンの催眠術師》	名詞
＠ヴぃだるけんのさいみんじゅ	《ヴィダルケンの催眠術師》	名詞
＠ヴぃだるけんのさいみんじゅつ	《ヴィダルケンの催眠術師》	名詞
＠ヴぃだるけんのさいみんじゅつし	《ヴィダルケンの催眠術師》	名詞
＠ヴ	《ヴラスカの従者》	名詞
＠ヴら	《ヴラスカの従者》	名詞
＠ヴらす	《ヴラスカの従者》	名詞
＠ヴらすか	《ヴラスカの従者》	名詞
＠ヴらすかの	《ヴラスカの従者》	名詞
＠ヴらすかのじ	《ヴラスカの従者》	名詞
＠ヴらすかのじゅ	《ヴラスカの従者》	名詞
＠ヴらすかのじゅう	《ヴラスカの従者》	名詞
＠ヴらすかのじゅうし	《ヴラスカの従者》	名詞
＠ヴらすかのじゅうしゃ	《ヴラスカの従者》	名詞
＠ヴ	《ヴラスカの石睨》	名詞
＠ヴら	《ヴラスカの石睨》	名詞
＠ヴらす	《ヴラスカの石睨》	名詞
＠ヴらすか	《ヴラスカの石睨》	名詞
＠ヴらすかの	《ヴラスカの石睨》	名詞
＠ヴらすかのい	《ヴラスカの石睨》	名詞
＠ヴらすかのいし	《ヴラスカの石睨》	名詞
＠ヴらすかのいしね	《ヴラスカの石睨》	名詞
＠ヴらすかのいしねめ	《ヴラスカの石睨》	名詞
＠い	《一斉検挙》	名詞
＠いっ	《一斉検挙》	名詞
＠いっせ	《一斉検挙》	名詞
＠いっせい	《一斉検挙》	名詞
＠いっせいけ	《一斉検挙》	名詞
＠いっせいけん	《一斉検挙》	名詞
＠いっせいけんき	《一斉検挙》	名詞
＠いっせいけんきょ	《一斉検挙》	名詞
＠ま	《万呪文の達人》	名詞
＠まん	《万呪文の達人》	名詞
＠まんじ	《万呪文の達人》	名詞
＠まんじゅ	《万呪文の達人》	名詞
＠まんじゅも	《万呪文の達人》	名詞
＠まんじゅもん	《万呪文の達人》	名詞
＠まんじゅもんの	《万呪文の達人》	名詞
＠まんじゅもんのた	《万呪文の達人》	名詞
＠まんじゅもんのたつ	《万呪文の達人》	名詞
＠まんじゅもんのたつじ	《万呪文の達人》	名詞
＠まんじゅもんのたつじん	《万呪文の達人》	名詞
＠ま	《万面相、ラザーヴ》	名詞
＠まん	《万面相、ラザーヴ》	名詞
＠まんめ	《万面相、ラザーヴ》	名詞
＠まんめん	《万面相、ラザーヴ》	名詞
＠まんめんし	《万面相、ラザーヴ》	名詞
＠まんめんしょ	《万面相、ラザーヴ》	名詞
＠まんめんしょう	《万面相、ラザーヴ》	名詞
＠まんめんしょう、	《万面相、ラザーヴ》	名詞
＠まんめんしょう、ら	《万面相、ラザーヴ》	名詞
＠まんめんしょう、らざ	《万面相、ラザーヴ》	名詞
＠まんめんしょう、らざー	《万面相、ラザーヴ》	名詞
＠まんめんしょう、らざーヴ	《万面相、ラザーヴ》	名詞
＠ふ	《不和のトロスターニ》	名詞
＠ふわ	《不和のトロスターニ》	名詞
＠ふわの	《不和のトロスターニ》	名詞
＠ふわのと	《不和のトロスターニ》	名詞
＠ふわのとろ	《不和のトロスターニ》	名詞
＠ふわのとろす	《不和のトロスターニ》	名詞
＠ふわのとろすた	《不和のトロスターニ》	名詞
＠ふわのとろすたー	《不和のトロスターニ》	名詞
＠ふわのとろすたーに	《不和のトロスターニ》	名詞
＠せ	《世界魂の巨像》	名詞
＠せか	《世界魂の巨像》	名詞
＠せかい	《世界魂の巨像》	名詞
＠せかいた	《世界魂の巨像》	名詞
＠せかいたま	《世界魂の巨像》	名詞
＠せかいたまし	《世界魂の巨像》	名詞
＠せかいたましい	《世界魂の巨像》	名詞
＠せかいたましいの	《世界魂の巨像》	名詞
＠せかいたましいのき	《世界魂の巨像》	名詞
＠せかいたましいのきょ	《世界魂の巨像》	名詞
＠せかいたましいのきょぞ	《世界魂の巨像》	名詞
＠せかいたましいのきょぞう	《世界魂の巨像》	名詞
＠の	《乗馬兵の飛行》	名詞
＠のり	《乗馬兵の飛行》	名詞
＠のりう	《乗馬兵の飛行》	名詞
＠のりうま	《乗馬兵の飛行》	名詞
＠のりうまへ	《乗馬兵の飛行》	名詞
＠のりうまへい	《乗馬兵の飛行》	名詞
＠のりうまへいの	《乗馬兵の飛行》	名詞
＠のりうまへいのひ	《乗馬兵の飛行》	名詞
＠のりうまへいのひこ	《乗馬兵の飛行》	名詞
＠のりうまへいのひこう	《乗馬兵の飛行》	名詞
＠な	《仲間意識》	名詞
＠なか	《仲間意識》	名詞
＠なかま	《仲間意識》	名詞
＠なかまい	《仲間意識》	名詞
＠なかまいし	《仲間意識》	名詞
＠なかまいしき	《仲間意識》	名詞
＠に	《任務説明》	名詞
＠にん	《任務説明》	名詞
＠にんむ	《任務説明》	名詞
＠にんむせ	《任務説明》	名詞
＠にんむせつ	《任務説明》	名詞
＠にんむせつめ	《任務説明》	名詞
＠にんむせつめい	《任務説明》	名詞
＠や	《優しいインドリク》	名詞
＠やさ	《優しいインドリク》	名詞
＠やさし	《優しいインドリク》	名詞
＠やさしい	《優しいインドリク》	名詞
＠やさしいい	《優しいインドリク》	名詞
＠やさしいいん	《優しいインドリク》	名詞
＠やさしいいんど	《優しいインドリク》	名詞
＠やさしいいんどり	《優しいインドリク》	名詞
＠やさしいいんどりく	《優しいインドリク》	名詞
＠ひ	《光を遮るもの》	名詞
＠ひか	《光を遮るもの》	名詞
＠ひかり	《光を遮るもの》	名詞
＠ひかりを	《光を遮るもの》	名詞
＠ひかりをさ	《光を遮るもの》	名詞
＠ひかりをさえ	《光を遮るもの》	名詞
＠ひかりをさえぎ	《光を遮るもの》	名詞
＠ひかりをさえぎる	《光を遮るもの》	名詞
＠ひかりをさえぎるも	《光を遮るもの》	名詞
＠ひかりをさえぎるもの	《光を遮るもの》	名詞
＠こ	《光明の縛め》	名詞
＠こう	《光明の縛め》	名詞
＠こうみ	《光明の縛め》	名詞
＠こうみょ	《光明の縛め》	名詞
＠こうみょう	《光明の縛め》	名詞
＠こうみょうの	《光明の縛め》	名詞
＠こうみょうのい	《光明の縛め》	名詞
＠こうみょうのいま	《光明の縛め》	名詞
＠こうみょうのいまし	《光明の縛め》	名詞
＠こうみょうのいましめ	《光明の縛め》	名詞
＠こ	《光線分割の魔道士》	名詞
＠こう	《光線分割の魔道士》	名詞
＠こうせ	《光線分割の魔道士》	名詞
＠こうせん	《光線分割の魔道士》	名詞
＠こうせんぶ	《光線分割の魔道士》	名詞
＠こうせんぶん	《光線分割の魔道士》	名詞
＠こうせんぶんか	《光線分割の魔道士》	名詞
＠こうせんぶんかつ	《光線分割の魔道士》	名詞
＠こうせんぶんかつの	《光線分割の魔道士》	名詞
＠こうせんぶんかつのま	《光線分割の魔道士》	名詞
＠こうせんぶんかつのまど	《光線分割の魔道士》	名詞
＠こうせんぶんかつのまどう	《光線分割の魔道士》	名詞
＠こうせんぶんかつのまどうし	《光線分割の魔道士》	名詞
＠ひ	《光胞子のシャーマン》	名詞
＠ひか	《光胞子のシャーマン》	名詞
＠ひかり	《光胞子のシャーマン》	名詞
＠ひかりほ	《光胞子のシャーマン》	名詞
＠ひかりほう	《光胞子のシャーマン》	名詞
＠ひかりほうし	《光胞子のシャーマン》	名詞
＠ひかりほうしの	《光胞子のシャーマン》	名詞
＠ひかりほうしのし	《光胞子のシャーマン》	名詞
＠ひかりほうしのしゃ	《光胞子のシャーマン》	名詞
＠ひかりほうしのしゃー	《光胞子のシャーマン》	名詞
＠ひかりほうしのしゃーま	《光胞子のシャーマン》	名詞
＠ひかりほうしのしゃーまん	《光胞子のシャーマン》	名詞
＠な	《内省のための小休止》	名詞
＠ない	《内省のための小休止》	名詞
＠ないせ	《内省のための小休止》	名詞
＠ないせい	《内省のための小休止》	名詞
＠ないせいの	《内省のための小休止》	名詞
＠ないせいのた	《内省のための小休止》	名詞
＠ないせいのため	《内省のための小休止》	名詞
＠ないせいのための	《内省のための小休止》	名詞
＠ないせいのためのし	《内省のための小休止》	名詞
＠ないせいのためのしょ	《内省のための小休止》	名詞
＠ないせいのためのしょう	《内省のための小休止》	名詞
＠ないせいのためのしょうき	《内省のための小休止》	名詞
＠ないせいのためのしょうきゅ	《内省のための小休止》	名詞
＠ないせいのためのしょうきゅう	《内省のための小休止》	名詞
＠ないせいのためのしょうきゅうし	《内省のための小休止》	名詞
＠れ	《冷酷なゴルゴン》	名詞
＠れい	《冷酷なゴルゴン》	名詞
＠れいこ	《冷酷なゴルゴン》	名詞
＠れいこく	《冷酷なゴルゴン》	名詞
＠れいこくな	《冷酷なゴルゴン》	名詞
＠れいこくなご	《冷酷なゴルゴン》	名詞
＠れいこくなごる	《冷酷なゴルゴン》	名詞
＠れいこくなごるご	《冷酷なゴルゴン》	名詞
＠れいこくなごるごん	《冷酷なゴルゴン》	名詞
＠は	《刃の教官》	名詞
＠はの	《刃の教官》	名詞
＠はのき	《刃の教官》	名詞
＠はのきょ	《刃の教官》	名詞
＠はのきょう	《刃の教官》	名詞
＠はのきょうか	《刃の教官》	名詞
＠はのきょうかん	《刃の教官》	名詞
＠せ	《切断された糸》	名詞
＠せつ	《切断された糸》	名詞
＠せつだ	《切断された糸》	名詞
＠せつだん	《切断された糸》	名詞
＠せつだんさ	《切断された糸》	名詞
＠せつだんされ	《切断された糸》	名詞
＠せつだんされた	《切断された糸》	名詞
＠せつだんされたい	《切断された糸》	名詞
＠せつだんされたいと	《切断された糸》	名詞
＠ふ	《刎頸の友》	名詞
＠ふん	《刎頸の友》	名詞
＠ふんけ	《刎頸の友》	名詞
＠ふんけい	《刎頸の友》	名詞
＠ふんけいの	《刎頸の友》	名詞
＠ふんけいのと	《刎頸の友》	名詞
＠ふんけいのとも	《刎頸の友》	名詞
＠う	《初々しい補充兵》	名詞
＠うい	《初々しい補充兵》	名詞
＠ういう	《初々しい補充兵》	名詞
＠ういうい	《初々しい補充兵》	名詞
＠ういういし	《初々しい補充兵》	名詞
＠ういういしい	《初々しい補充兵》	名詞
＠ういういしいほ	《初々しい補充兵》	名詞
＠ういういしいほじ	《初々しい補充兵》	名詞
＠ういういしいほじゅ	《初々しい補充兵》	名詞
＠ういういしいほじゅう	《初々しい補充兵》	名詞
＠ういういしいほじゅうへ	《初々しい補充兵》	名詞
＠ういういしいほじゅうへい	《初々しい補充兵》	名詞
＠り	《力の報奨》	名詞
＠りょ	《力の報奨》	名詞
＠りょく	《力の報奨》	名詞
＠りょくの	《力の報奨》	名詞
＠りょくのほ	《力の報奨》	名詞
＠りょくのほう	《力の報奨》	名詞
＠りょくのほうし	《力の報奨》	名詞
＠りょくのほうしょ	《力の報奨》	名詞
＠りょくのほうしょう	《力の報奨》	名詞
＠ど	《動じない大ワーム》	名詞
＠どう	《動じない大ワーム》	名詞
＠どうじ	《動じない大ワーム》	名詞
＠どうじな	《動じない大ワーム》	名詞
＠どうじない	《動じない大ワーム》	名詞
＠どうじないだ	《動じない大ワーム》	名詞
＠どうじないだい	《動じない大ワーム》	名詞
＠どうじないだいわ	《動じない大ワーム》	名詞
＠どうじないだいわー	《動じない大ワーム》	名詞
＠どうじないだいわーむ	《動じない大ワーム》	名詞
＠ほ	《包囲ワーム》	名詞
＠ほう	《包囲ワーム》	名詞
＠ほうい	《包囲ワーム》	名詞
＠ほういわ	《包囲ワーム》	名詞
＠ほういわー	《包囲ワーム》	名詞
＠ほういわーむ	《包囲ワーム》	名詞
＠の	《千の目、アイゾーニ》	名詞
＠のめ	《千の目、アイゾーニ》	名詞
＠のめ、	《千の目、アイゾーニ》	名詞
＠のめ、あ	《千の目、アイゾーニ》	名詞
＠のめ、あい	《千の目、アイゾーニ》	名詞
＠のめ、あいぞ	《千の目、アイゾーニ》	名詞
＠のめ、あいぞー	《千の目、アイゾーニ》	名詞
＠のめ、あいぞーに	《千の目、アイゾーニ》	名詞
＠ね	《千年嵐》	名詞
＠ねん	《千年嵐》	名詞
＠ねんあ	《千年嵐》	名詞
＠ねんあら	《千年嵐》	名詞
＠ねんあらし	《千年嵐》	名詞
＠き	《協約の魂、イマーラ》	名詞
＠きょ	《協約の魂、イマーラ》	名詞
＠きょう	《協約の魂、イマーラ》	名詞
＠きょうや	《協約の魂、イマーラ》	名詞
＠きょうやく	《協約の魂、イマーラ》	名詞
＠きょうやくの	《協約の魂、イマーラ》	名詞
＠きょうやくのた	《協約の魂、イマーラ》	名詞
＠きょうやくのたま	《協約の魂、イマーラ》	名詞
＠きょうやくのたまし	《協約の魂、イマーラ》	名詞
＠きょうやくのたましい	《協約の魂、イマーラ》	名詞
＠きょうやくのたましい、	《協約の魂、イマーラ》	名詞
＠きょうやくのたましい、い	《協約の魂、イマーラ》	名詞
＠きょうやくのたましい、いま	《協約の魂、イマーラ》	名詞
＠きょうやくのたましい、いまー	《協約の魂、イマーラ》	名詞
＠きょうやくのたましい、いまーら	《協約の魂、イマーラ》	名詞
＠き	《危険因子》	名詞
＠きけ	《危険因子》	名詞
＠きけん	《危険因子》	名詞
＠きけんい	《危険因子》	名詞
＠きけんいん	《危険因子》	名詞
＠きけんいんし	《危険因子》	名詞
＠げ	《原因不明の消失》	名詞
＠げん	《原因不明の消失》	名詞
＠げんい	《原因不明の消失》	名詞
＠げんいん	《原因不明の消失》	名詞
＠げんいんふ	《原因不明の消失》	名詞
＠げんいんふめ	《原因不明の消失》	名詞
＠げんいんふめい	《原因不明の消失》	名詞
＠げんいんふめいの	《原因不明の消失》	名詞
＠げんいんふめいのし	《原因不明の消失》	名詞
＠げんいんふめいのしょ	《原因不明の消失》	名詞
＠げんいんふめいのしょう	《原因不明の消失》	名詞
＠げんいんふめいのしょうし	《原因不明の消失》	名詞
＠げんいんふめいのしょうしつ	《原因不明の消失》	名詞
＠は	《反応》	名詞
＠はん	《反応》	名詞
＠はんの	《反応》	名詞
＠はんのう	《反応》	名詞
＠は	《反応+反正》	名詞
＠はん	《反応+反正》	名詞
＠はんの	《反応+反正》	名詞
＠はんのう	《反応+反正》	名詞
＠はんのう+	《反応+反正》	名詞
＠はんのう+は	《反応+反正》	名詞
＠はんのう+はん	《反応+反正》	名詞
＠はんのう+はんぜ	《反応+反正》	名詞
＠はんのう+はんぜい	《反応+反正》	名詞
＠は	《反正》	名詞
＠はん	《反正》	名詞
＠はんぜ	《反正》	名詞
＠はんぜい	《反正》	名詞
＠は	《反転》	名詞
＠はん	《反転》	名詞
＠はんて	《反転》	名詞
＠はんてん	《反転》	名詞
＠は	《反転+観点》	名詞
＠はん	《反転+観点》	名詞
＠はんて	《反転+観点》	名詞
＠はんてん	《反転+観点》	名詞
＠はんてん+	《反転+観点》	名詞
＠はんてん+か	《反転+観点》	名詞
＠はんてん+かん	《反転+観点》	名詞
＠はんてん+かんて	《反転+観点》	名詞
＠はんてん+かんてん	《反転+観点》	名詞
＠め	《名声の代価》	名詞
＠めい	《名声の代価》	名詞
＠めいせ	《名声の代価》	名詞
＠めいせい	《名声の代価》	名詞
＠めいせいの	《名声の代価》	名詞
＠めいせいのだ	《名声の代価》	名詞
＠めいせいのだい	《名声の代価》	名詞
＠めいせいのだいか	《名声の代価》	名詞
＠さ	《囁く工作員》	名詞
＠ささ	《囁く工作員》	名詞
＠ささや	《囁く工作員》	名詞
＠ささやく	《囁く工作員》	名詞
＠ささやくこ	《囁く工作員》	名詞
＠ささやくこう	《囁く工作員》	名詞
＠ささやくこうさ	《囁く工作員》	名詞
＠ささやくこうさく	《囁く工作員》	名詞
＠ささやくこうさくい	《囁く工作員》	名詞
＠ささやくこうさくいん	《囁く工作員》	名詞
＠さ	《囁く情報屋》	名詞
＠ささ	《囁く情報屋》	名詞
＠ささや	《囁く情報屋》	名詞
＠ささやく	《囁く情報屋》	名詞
＠ささやくじ	《囁く情報屋》	名詞
＠ささやくじょ	《囁く情報屋》	名詞
＠ささやくじょう	《囁く情報屋》	名詞
＠ささやくじょうほ	《囁く情報屋》	名詞
＠ささやくじょうほう	《囁く情報屋》	名詞
＠ささやくじょうほうや	《囁く情報屋》	名詞
＠だ	《団体のギルド魔道士》	名詞
＠だん	《団体のギルド魔道士》	名詞
＠だんた	《団体のギルド魔道士》	名詞
＠だんたい	《団体のギルド魔道士》	名詞
＠だんたいの	《団体のギルド魔道士》	名詞
＠だんたいのぎ	《団体のギルド魔道士》	名詞
＠だんたいのぎる	《団体のギルド魔道士》	名詞
＠だんたいのぎるど	《団体のギルド魔道士》	名詞
＠だんたいのぎるどま	《団体のギルド魔道士》	名詞
＠だんたいのぎるどまど	《団体のギルド魔道士》	名詞
＠だんたいのぎるどまどう	《団体のギルド魔道士》	名詞
＠だんたいのぎるどまどうし	《団体のギルド魔道士》	名詞
＠ち	《地底王国のリッチ》	名詞
＠ちて	《地底王国のリッチ》	名詞
＠ちてい	《地底王国のリッチ》	名詞
＠ちていお	《地底王国のリッチ》	名詞
＠ちていおう	《地底王国のリッチ》	名詞
＠ちていおうこ	《地底王国のリッチ》	名詞
＠ちていおうこく	《地底王国のリッチ》	名詞
＠ちていおうこくの	《地底王国のリッチ》	名詞
＠ちていおうこくのり	《地底王国のリッチ》	名詞
＠ちていおうこくのりっ	《地底王国のリッチ》	名詞
＠ちていおうこくのりっち	《地底王国のリッチ》	名詞
＠ち	《地底街のネクロリスク》	名詞
＠ちて	《地底街のネクロリスク》	名詞
＠ちてい	《地底街のネクロリスク》	名詞
＠ちていま	《地底街のネクロリスク》	名詞
＠ちていまち	《地底街のネクロリスク》	名詞
＠ちていまちの	《地底街のネクロリスク》	名詞
＠ちていまちのね	《地底街のネクロリスク》	名詞
＠ちていまちのねく	《地底街のネクロリスク》	名詞
＠ちていまちのねくろ	《地底街のネクロリスク》	名詞
＠ちていまちのねくろり	《地底街のネクロリスク》	名詞
＠ちていまちのねくろりす	《地底街のネクロリスク》	名詞
＠ちていまちのねくろりすく	《地底街のネクロリスク》	名詞
＠ち	《地底街の反乱》	名詞
＠ちて	《地底街の反乱》	名詞
＠ちてい	《地底街の反乱》	名詞
＠ちていま	《地底街の反乱》	名詞
＠ちていまち	《地底街の反乱》	名詞
＠ちていまちの	《地底街の反乱》	名詞
＠ちていまちのは	《地底街の反乱》	名詞
＠ちていまちのはん	《地底街の反乱》	名詞
＠ちていまちのはんら	《地底街の反乱》	名詞
＠ちていまちのはんらん	《地底街の反乱》	名詞
＠ほ	《報奨密偵》	名詞
＠ほう	《報奨密偵》	名詞
＠ほうし	《報奨密偵》	名詞
＠ほうしょ	《報奨密偵》	名詞
＠ほうしょう	《報奨密偵》	名詞
＠ほうしょうみ	《報奨密偵》	名詞
＠ほうしょうみっ	《報奨密偵》	名詞
＠ほうしょうみって	《報奨密偵》	名詞
＠ほうしょうみってい	《報奨密偵》	名詞
＠か	《壁過の達人》	名詞
＠かべ	《壁過の達人》	名詞
＠かべす	《壁過の達人》	名詞
＠かべすぎ	《壁過の達人》	名詞
＠かべすぎの	《壁過の達人》	名詞
＠かべすぎのた	《壁過の達人》	名詞
＠かべすぎのたつ	《壁過の達人》	名詞
＠かべすぎのたつじ	《壁過の達人》	名詞
＠かべすぎのたつじん	《壁過の達人》	名詞
＠え	《壊死性の傷》	名詞
＠えし	《壊死性の傷》	名詞
＠えしせ	《壊死性の傷》	名詞
＠えしせい	《壊死性の傷》	名詞
＠えしせいの	《壊死性の傷》	名詞
＠えしせいのき	《壊死性の傷》	名詞
＠えしせいのきず	《壊死性の傷》	名詞
＠よ	《夜の子》	名詞
＠よる	《夜の子》	名詞
＠よるの	《夜の子》	名詞
＠よるのこ	《夜の子》	名詞
＠よ	《夜帷のスプライト》	名詞
＠よる	《夜帷のスプライト》	名詞
＠よると	《夜帷のスプライト》	名詞
＠よるとば	《夜帷のスプライト》	名詞
＠よるとばり	《夜帷のスプライト》	名詞
＠よるとばりの	《夜帷のスプライト》	名詞
＠よるとばりのす	《夜帷のスプライト》	名詞
＠よるとばりのすぷ	《夜帷のスプライト》	名詞
＠よるとばりのすぷら	《夜帷のスプライト》	名詞
＠よるとばりのすぷらい	《夜帷のスプライト》	名詞
＠よるとばりのすぷらいと	《夜帷のスプライト》	名詞
＠よ	《夜帷の捕食者》	名詞
＠よる	《夜帷の捕食者》	名詞
＠よると	《夜帷の捕食者》	名詞
＠よるとば	《夜帷の捕食者》	名詞
＠よるとばり	《夜帷の捕食者》	名詞
＠よるとばりの	《夜帷の捕食者》	名詞
＠よるとばりのほ	《夜帷の捕食者》	名詞
＠よるとばりのほし	《夜帷の捕食者》	名詞
＠よるとばりのほしょ	《夜帷の捕食者》	名詞
＠よるとばりのほしょく	《夜帷の捕食者》	名詞
＠よるとばりのほしょくし	《夜帷の捕食者》	名詞
＠よるとばりのほしょくしゃ	《夜帷の捕食者》	名詞
＠ゆ	《夢喰い》	名詞
＠ゆめ	《夢喰い》	名詞
＠ゆめく	《夢喰い》	名詞
＠ゆめくい	《夢喰い》	名詞
＠た	《大群の力》	名詞
＠たい	《大群の力》	名詞
＠たいぐ	《大群の力》	名詞
＠たいぐん	《大群の力》	名詞
＠たいぐんの	《大群の力》	名詞
＠たいぐんのち	《大群の力》	名詞
＠たいぐんのちか	《大群の力》	名詞
＠たいぐんのちから	《大群の力》	名詞
＠だ	《大集団の行進》	名詞
＠だい	《大集団の行進》	名詞
＠だいし	《大集団の行進》	名詞
＠だいしゅ	《大集団の行進》	名詞
＠だいしゅう	《大集団の行進》	名詞
＠だいしゅうだ	《大集団の行進》	名詞
＠だいしゅうだん	《大集団の行進》	名詞
＠だいしゅうだんの	《大集団の行進》	名詞
＠だいしゅうだんのこ	《大集団の行進》	名詞
＠だいしゅうだんのこう	《大集団の行進》	名詞
＠だいしゅうだんのこうし	《大集団の行進》	名詞
＠だいしゅうだんのこうしん	《大集団の行進》	名詞
＠て	《天空の斥候》	名詞
＠てん	《天空の斥候》	名詞
＠てんく	《天空の斥候》	名詞
＠てんくう	《天空の斥候》	名詞
＠てんくうの	《天空の斥候》	名詞
＠てんくうのせ	《天空の斥候》	名詞
＠てんくうのせっ	《天空の斥候》	名詞
＠てんくうのせっこ	《天空の斥候》	名詞
＠てんくうのせっこう	《天空の斥候》	名詞
＠き	《奇矯なサイクロプス》	名詞
＠きき	《奇矯なサイクロプス》	名詞
＠ききょ	《奇矯なサイクロプス》	名詞
＠ききょう	《奇矯なサイクロプス》	名詞
＠ききょうな	《奇矯なサイクロプス》	名詞
＠ききょうなさ	《奇矯なサイクロプス》	名詞
＠ききょうなさい	《奇矯なサイクロプス》	名詞
＠ききょうなさいく	《奇矯なサイクロプス》	名詞
＠ききょうなさいくろ	《奇矯なサイクロプス》	名詞
＠ききょうなさいくろぷ	《奇矯なサイクロプス》	名詞
＠ききょうなさいくろぷす	《奇矯なサイクロプス》	名詞
＠き	《奇策》	名詞
＠きさ	《奇策》	名詞
＠きさく	《奇策》	名詞
＠し	《奨励》	名詞
＠しょ	《奨励》	名詞
＠しょう	《奨励》	名詞
＠しょうれ	《奨励》	名詞
＠しょうれい	《奨励》	名詞
＠い	《威厳あるゴルゴン、ヴラスカ》	名詞
＠いげ	《威厳あるゴルゴン、ヴラスカ》	名詞
＠いげん	《威厳あるゴルゴン、ヴラスカ》	名詞
＠いげんあ	《威厳あるゴルゴン、ヴラスカ》	名詞
＠いげんある	《威厳あるゴルゴン、ヴラスカ》	名詞
＠いげんあるご	《威厳あるゴルゴン、ヴラスカ》	名詞
＠いげんあるごる	《威厳あるゴルゴン、ヴラスカ》	名詞
＠いげんあるごるご	《威厳あるゴルゴン、ヴラスカ》	名詞
＠いげんあるごるごん	《威厳あるゴルゴン、ヴラスカ》	名詞
＠いげんあるごるごん、	《威厳あるゴルゴン、ヴラスカ》	名詞
＠いげんあるごるごん、ヴ	《威厳あるゴルゴン、ヴラスカ》	名詞
＠いげんあるごるごん、ヴら	《威厳あるゴルゴン、ヴラスカ》	名詞
＠いげんあるごるごん、ヴらす	《威厳あるゴルゴン、ヴラスカ》	名詞
＠いげんあるごるごん、ヴらすか	《威厳あるゴルゴン、ヴラスカ》	名詞
＠ふ	《孵卵場の蜘蛛》	名詞
＠ふら	《孵卵場の蜘蛛》	名詞
＠ふらん	《孵卵場の蜘蛛》	名詞
＠ふらんじ	《孵卵場の蜘蛛》	名詞
＠ふらんじょ	《孵卵場の蜘蛛》	名詞
＠ふらんじょう	《孵卵場の蜘蛛》	名詞
＠ふらんじょうの	《孵卵場の蜘蛛》	名詞
＠ふらんじょうのく	《孵卵場の蜘蛛》	名詞
＠ふらんじょうのくも	《孵卵場の蜘蛛》	名詞
＠う	《宇宙粒子波》	名詞
＠うち	《宇宙粒子波》	名詞
＠うちゅ	《宇宙粒子波》	名詞
＠うちゅう	《宇宙粒子波》	名詞
＠うちゅうり	《宇宙粒子波》	名詞
＠うちゅうりゅ	《宇宙粒子波》	名詞
＠うちゅうりゅう	《宇宙粒子波》	名詞
＠うちゅうりゅうし	《宇宙粒子波》	名詞
＠うちゅうりゅうしな	《宇宙粒子波》	名詞
＠うちゅうりゅうしなみ	《宇宙粒子波》	名詞
＠か	《完全》	名詞
＠かん	《完全》	名詞
＠かんぜ	《完全》	名詞
＠かんぜん	《完全》	名詞
＠か	《完全+間隙》	名詞
＠かん	《完全+間隙》	名詞
＠かんぜ	《完全+間隙》	名詞
＠かんぜん	《完全+間隙》	名詞
＠かんぜん+	《完全+間隙》	名詞
＠かんぜん+か	《完全+間隙》	名詞
＠かんぜん+かん	《完全+間隙》	名詞
＠かんぜん+かんげ	《完全+間隙》	名詞
＠かんぜん+かんげき	《完全+間隙》	名詞
＠じ	《実験の狂乱》	名詞
＠じっ	《実験の狂乱》	名詞
＠じっけ	《実験の狂乱》	名詞
＠じっけん	《実験の狂乱》	名詞
＠じっけんの	《実験の狂乱》	名詞
＠じっけんのき	《実験の狂乱》	名詞
＠じっけんのきょ	《実験の狂乱》	名詞
＠じっけんのきょう	《実験の狂乱》	名詞
＠じっけんのきょうら	《実験の狂乱》	名詞
＠じっけんのきょうらん	《実験の狂乱》	名詞
＠か	《家門のギルド魔道士》	名詞
＠かも	《家門のギルド魔道士》	名詞
＠かもん	《家門のギルド魔道士》	名詞
＠かもんの	《家門のギルド魔道士》	名詞
＠かもんのぎ	《家門のギルド魔道士》	名詞
＠かもんのぎる	《家門のギルド魔道士》	名詞
＠かもんのぎるど	《家門のギルド魔道士》	名詞
＠かもんのぎるどま	《家門のギルド魔道士》	名詞
＠かもんのぎるどまど	《家門のギルド魔道士》	名詞
＠かもんのぎるどまどう	《家門のギルド魔道士》	名詞
＠かもんのぎるどまどうし	《家門のギルド魔道士》	名詞
＠じ	《寺院の庭》	名詞
＠じい	《寺院の庭》	名詞
＠じいん	《寺院の庭》	名詞
＠じいんの	《寺院の庭》	名詞
＠じいんのに	《寺院の庭》	名詞
＠じいんのにわ	《寺院の庭》	名詞
＠こ	《小柄な竜装者》	名詞
＠こが	《小柄な竜装者》	名詞
＠こがら	《小柄な竜装者》	名詞
＠こがらな	《小柄な竜装者》	名詞
＠こがらなり	《小柄な竜装者》	名詞
＠こがらなりゅ	《小柄な竜装者》	名詞
＠こがらなりゅう	《小柄な竜装者》	名詞
＠こがらなりゅうよ	《小柄な竜装者》	名詞
＠こがらなりゅうよそ	《小柄な竜装者》	名詞
＠こがらなりゅうよそい	《小柄な竜装者》	名詞
＠こがらなりゅうよそいし	《小柄な竜装者》	名詞
＠こがらなりゅうよそいしゃ	《小柄な竜装者》	名詞
＠や	《山》	名詞
＠やま	《山》	名詞
＠じ	《島》	名詞
＠じま	《島》	名詞
＠あ	《嵐の行使》	名詞
＠あら	《嵐の行使》	名詞
＠あらし	《嵐の行使》	名詞
＠あらしの	《嵐の行使》	名詞
＠あらしのこ	《嵐の行使》	名詞
＠あらしのこう	《嵐の行使》	名詞
＠あらしのこうし	《嵐の行使》	名詞
＠あ	《嵐を呼ぶ者、ラル》	名詞
＠あら	《嵐を呼ぶ者、ラル》	名詞
＠あらし	《嵐を呼ぶ者、ラル》	名詞
＠あらしを	《嵐を呼ぶ者、ラル》	名詞
＠あらしをよ	《嵐を呼ぶ者、ラル》	名詞
＠あらしをよぶ	《嵐を呼ぶ者、ラル》	名詞
＠あらしをよぶも	《嵐を呼ぶ者、ラル》	名詞
＠あらしをよぶもの	《嵐を呼ぶ者、ラル》	名詞
＠あらしをよぶもの、	《嵐を呼ぶ者、ラル》	名詞
＠あらしをよぶもの、ら	《嵐を呼ぶ者、ラル》	名詞
＠あらしをよぶもの、らる	《嵐を呼ぶ者、ラル》	名詞
＠た	《巧みな叩き伏せ》	名詞
＠たく	《巧みな叩き伏せ》	名詞
＠たくみ	《巧みな叩き伏せ》	名詞
＠たくみな	《巧みな叩き伏せ》	名詞
＠たくみなた	《巧みな叩き伏せ》	名詞
＠たくみなたた	《巧みな叩き伏せ》	名詞
＠たくみなたたき	《巧みな叩き伏せ》	名詞
＠たくみなたたきふ	《巧みな叩き伏せ》	名詞
＠たくみなたたきふせ	《巧みな叩き伏せ》	名詞
＠き	《希望の夜明け》	名詞
＠きぼ	《希望の夜明け》	名詞
＠きぼう	《希望の夜明け》	名詞
＠きぼうの	《希望の夜明け》	名詞
＠きぼうのよ	《希望の夜明け》	名詞
＠きぼうのよあ	《希望の夜明け》	名詞
＠きぼうのよあけ	《希望の夜明け》	名詞
＠せ	《席次》	名詞
＠せき	《席次》	名詞
＠せきじ	《席次》	名詞
＠せ	《席次+石像》	名詞
＠せき	《席次+石像》	名詞
＠せきじ	《席次+石像》	名詞
＠せきじ+	《席次+石像》	名詞
＠せきじ+せ	《席次+石像》	名詞
＠せきじ+せき	《席次+石像》	名詞
＠せきじ+せきぞ	《席次+石像》	名詞
＠せきじ+せきぞう	《席次+石像》	名詞
＠へ	《平地》	名詞
＠へい	《平地》	名詞
＠へいち	《平地》	名詞
＠ち	《庁舎の歩哨》	名詞
＠ちょ	《庁舎の歩哨》	名詞
＠ちょう	《庁舎の歩哨》	名詞
＠ちょうし	《庁舎の歩哨》	名詞
＠ちょうしゃ	《庁舎の歩哨》	名詞
＠ちょうしゃの	《庁舎の歩哨》	名詞
＠ちょうしゃのほ	《庁舎の歩哨》	名詞
＠ちょうしゃのほし	《庁舎の歩哨》	名詞
＠ちょうしゃのほしょ	《庁舎の歩哨》	名詞
＠ちょうしゃのほしょう	《庁舎の歩哨》	名詞
＠こ	《弧光のフェニックス》	名詞
＠ここ	《弧光のフェニックス》	名詞
＠ここう	《弧光のフェニックス》	名詞
＠ここうの	《弧光のフェニックス》	名詞
＠ここうのふ	《弧光のフェニックス》	名詞
＠ここうのふぇ	《弧光のフェニックス》	名詞
＠ここうのふぇに	《弧光のフェニックス》	名詞
＠ここうのふぇにっ	《弧光のフェニックス》	名詞
＠ここうのふぇにっく	《弧光のフェニックス》	名詞
＠ここうのふぇにっくす	《弧光のフェニックス》	名詞
＠は	《張り出し櫓のコウモリ》	名詞
＠はり	《張り出し櫓のコウモリ》	名詞
＠はりだ	《張り出し櫓のコウモリ》	名詞
＠はりだし	《張り出し櫓のコウモリ》	名詞
＠はりだしや	《張り出し櫓のコウモリ》	名詞
＠はりだしやぐ	《張り出し櫓のコウモリ》	名詞
＠はりだしやぐら	《張り出し櫓のコウモリ》	名詞
＠はりだしやぐらの	《張り出し櫓のコウモリ》	名詞
＠はりだしやぐらのこ	《張り出し櫓のコウモリ》	名詞
＠はりだしやぐらのこう	《張り出し櫓のコウモリ》	名詞
＠はりだしやぐらのこうも	《張り出し櫓のコウモリ》	名詞
＠はりだしやぐらのこうもり	《張り出し櫓のコウモリ》	名詞
＠は	《弾けるドレイク》	名詞
＠はじ	《弾けるドレイク》	名詞
＠はじけ	《弾けるドレイク》	名詞
＠はじける	《弾けるドレイク》	名詞
＠はじけるど	《弾けるドレイク》	名詞
＠はじけるどれ	《弾けるドレイク》	名詞
＠はじけるどれい	《弾けるドレイク》	名詞
＠はじけるどれいく	《弾けるドレイク》	名詞
＠さ	《彩色の灯籠》	名詞
＠さい	《彩色の灯籠》	名詞
＠さいし	《彩色の灯籠》	名詞
＠さいしょ	《彩色の灯籠》	名詞
＠さいしょく	《彩色の灯籠》	名詞
＠さいしょくの	《彩色の灯籠》	名詞
＠さいしょくのと	《彩色の灯籠》	名詞
＠さいしょくのとう	《彩色の灯籠》	名詞
＠さいしょくのとうろ	《彩色の灯籠》	名詞
＠さいしょくのとうろう	《彩色の灯籠》	名詞
＠お	《往時軍の強兵》	名詞
＠おう	《往時軍の強兵》	名詞
＠おうじ	《往時軍の強兵》	名詞
＠おうじぐ	《往時軍の強兵》	名詞
＠おうじぐん	《往時軍の強兵》	名詞
＠おうじぐんの	《往時軍の強兵》	名詞
＠おうじぐんのき	《往時軍の強兵》	名詞
＠おうじぐんのきょ	《往時軍の強兵》	名詞
＠おうじぐんのきょう	《往時軍の強兵》	名詞
＠おうじぐんのきょうへ	《往時軍の強兵》	名詞
＠おうじぐんのきょうへい	《往時軍の強兵》	名詞
＠し	《思考消去》	名詞
＠しこ	《思考消去》	名詞
＠しこう	《思考消去》	名詞
＠しこうし	《思考消去》	名詞
＠しこうしょ	《思考消去》	名詞
＠しこうしょう	《思考消去》	名詞
＠しこうしょうき	《思考消去》	名詞
＠しこうしょうきょ	《思考消去》	名詞
＠し	《思考繋ぎの幻》	名詞
＠しこ	《思考繋ぎの幻》	名詞
＠しこう	《思考繋ぎの幻》	名詞
＠しこうつ	《思考繋ぎの幻》	名詞
＠しこうつな	《思考繋ぎの幻》	名詞
＠しこうつなぎ	《思考繋ぎの幻》	名詞
＠しこうつなぎの	《思考繋ぎの幻》	名詞
＠しこうつなぎのま	《思考繋ぎの幻》	名詞
＠しこうつなぎのまぼ	《思考繋ぎの幻》	名詞
＠しこうつなぎのまぼろ	《思考繋ぎの幻》	名詞
＠しこうつなぎのまぼろし	《思考繋ぎの幻》	名詞
＠き	《急進思想》	名詞
＠きゅ	《急進思想》	名詞
＠きゅう	《急進思想》	名詞
＠きゅうし	《急進思想》	名詞
＠きゅうしん	《急進思想》	名詞
＠きゅうしんし	《急進思想》	名詞
＠きゅうしんしそ	《急進思想》	名詞
＠きゅうしんしそう	《急進思想》	名詞
＠お	《恐れなき矛槍兵》	名詞
＠おそ	《恐れなき矛槍兵》	名詞
＠おそれ	《恐れなき矛槍兵》	名詞
＠おそれな	《恐れなき矛槍兵》	名詞
＠おそれなき	《恐れなき矛槍兵》	名詞
＠おそれなきほ	《恐れなき矛槍兵》	名詞
＠おそれなきほこ	《恐れなき矛槍兵》	名詞
＠おそれなきほこや	《恐れなき矛槍兵》	名詞
＠おそれなきほこやり	《恐れなき矛槍兵》	名詞
＠おそれなきほこやりへ	《恐れなき矛槍兵》	名詞
＠おそれなきほこやりへい	《恐れなき矛槍兵》	名詞
＠あ	《悪意ある噂》	名詞
＠あく	《悪意ある噂》	名詞
＠あくい	《悪意ある噂》	名詞
＠あくいあ	《悪意ある噂》	名詞
＠あくいある	《悪意ある噂》	名詞
＠あくいあるう	《悪意ある噂》	名詞
＠あくいあるうわ	《悪意ある噂》	名詞
＠あくいあるうわさ	《悪意ある噂》	名詞
＠あ	《悪意ある妨害》	名詞
＠あく	《悪意ある妨害》	名詞
＠あくい	《悪意ある妨害》	名詞
＠あくいあ	《悪意ある妨害》	名詞
＠あくいある	《悪意ある妨害》	名詞
＠あくいあるぼ	《悪意ある妨害》	名詞
＠あくいあるぼう	《悪意ある妨害》	名詞
＠あくいあるぼうが	《悪意ある妨害》	名詞
＠あくいあるぼうがい	《悪意ある妨害》	名詞
＠わ	《悪賢い隠蔽》	名詞
＠わる	《悪賢い隠蔽》	名詞
＠わるが	《悪賢い隠蔽》	名詞
＠わるがし	《悪賢い隠蔽》	名詞
＠わるがしこ	《悪賢い隠蔽》	名詞
＠わるがしこい	《悪賢い隠蔽》	名詞
＠わるがしこいい	《悪賢い隠蔽》	名詞
＠わるがしこいいん	《悪賢い隠蔽》	名詞
＠わるがしこいいんぺ	《悪賢い隠蔽》	名詞
＠わるがしこいいんぺい	《悪賢い隠蔽》	名詞
＠か	《感情化粧師》	名詞
＠かん	《感情化粧師》	名詞
＠かんじ	《感情化粧師》	名詞
＠かんじょ	《感情化粧師》	名詞
＠かんじょう	《感情化粧師》	名詞
＠かんじょうけ	《感情化粧師》	名詞
＠かんじょうけし	《感情化粧師》	名詞
＠かんじょうけしょ	《感情化粧師》	名詞
＠かんじょうけしょう	《感情化粧師》	名詞
＠かんじょうけしょうし	《感情化粧師》	名詞
＠た	《戦いの覚悟》	名詞
＠たた	《戦いの覚悟》	名詞
＠たたか	《戦いの覚悟》	名詞
＠たたかい	《戦いの覚悟》	名詞
＠たたかいの	《戦いの覚悟》	名詞
＠たたかいのか	《戦いの覚悟》	名詞
＠たたかいのかく	《戦いの覚悟》	名詞
＠たたかいのかくご	《戦いの覚悟》	名詞
＠お	《押し入る荷役獣》	名詞
＠おし	《押し入る荷役獣》	名詞
＠おしい	《押し入る荷役獣》	名詞
＠おしいる	《押し入る荷役獣》	名詞
＠おしいるに	《押し入る荷役獣》	名詞
＠おしいるにや	《押し入る荷役獣》	名詞
＠おしいるにやく	《押し入る荷役獣》	名詞
＠おしいるにやくけ	《押し入る荷役獣》	名詞
＠おしいるにやくけも	《押し入る荷役獣》	名詞
＠おしいるにやくけもの	《押し入る荷役獣》	名詞
＠お	《押し潰す梢》	名詞
＠おし	《押し潰す梢》	名詞
＠おしつ	《押し潰す梢》	名詞
＠おしつぶ	《押し潰す梢》	名詞
＠おしつぶす	《押し潰す梢》	名詞
＠おしつぶすこ	《押し潰す梢》	名詞
＠おしつぶすこず	《押し潰す梢》	名詞
＠おしつぶすこずえ	《押し潰す梢》	名詞
＠ほ	《捕獲球》	名詞
＠ほか	《捕獲球》	名詞
＠ほかく	《捕獲球》	名詞
＠ほかくた	《捕獲球》	名詞
＠ほかくたま	《捕獲球》	名詞
＠ほ	《捕食》	名詞
＠ほし	《捕食》	名詞
＠ほしょ	《捕食》	名詞
＠ほしょく	《捕食》	名詞
＠さ	《採取》	名詞
＠さい	《採取》	名詞
＠さいし	《採取》	名詞
＠さいしゅ	《採取》	名詞
＠さ	《採取+最終》	名詞
＠さい	《採取+最終》	名詞
＠さいし	《採取+最終》	名詞
＠さいしゅ	《採取+最終》	名詞
＠さいしゅ+	《採取+最終》	名詞
＠さいしゅ+さ	《採取+最終》	名詞
＠さいしゅ+さい	《採取+最終》	名詞
＠さいしゅ+さいし	《採取+最終》	名詞
＠さいしゅ+さいしゅ	《採取+最終》	名詞
＠さいしゅ+さいしゅう	《採取+最終》	名詞
＠け	《敬慕されるロクソドン》	名詞
＠けい	《敬慕されるロクソドン》	名詞
＠けいぼ	《敬慕されるロクソドン》	名詞
＠けいぼさ	《敬慕されるロクソドン》	名詞
＠けいぼされ	《敬慕されるロクソドン》	名詞
＠けいぼされる	《敬慕されるロクソドン》	名詞
＠けいぼされるろ	《敬慕されるロクソドン》	名詞
＠けいぼされるろく	《敬慕されるロクソドン》	名詞
＠けいぼされるろくそ	《敬慕されるロクソドン》	名詞
＠けいぼされるろくそど	《敬慕されるロクソドン》	名詞
＠けいぼされるろくそどん	《敬慕されるロクソドン》	名詞
＠あ	《暗殺者の戦利品》	名詞
＠あん	《暗殺者の戦利品》	名詞
＠あんさ	《暗殺者の戦利品》	名詞
＠あんさつ	《暗殺者の戦利品》	名詞
＠あんさつし	《暗殺者の戦利品》	名詞
＠あんさつしゃ	《暗殺者の戦利品》	名詞
＠あんさつしゃの	《暗殺者の戦利品》	名詞
＠あんさつしゃのせ	《暗殺者の戦利品》	名詞
＠あんさつしゃのせん	《暗殺者の戦利品》	名詞
＠あんさつしゃのせんり	《暗殺者の戦利品》	名詞
＠あんさつしゃのせんりひ	《暗殺者の戦利品》	名詞
＠あんさつしゃのせんりひん	《暗殺者の戦利品》	名詞
＠さ	《最大速度》	名詞
＠さい	《最大速度》	名詞
＠さいだ	《最大速度》	名詞
＠さいだい	《最大速度》	名詞
＠さいだいそ	《最大速度》	名詞
＠さいだいそく	《最大速度》	名詞
＠さいだいそくど	《最大速度》	名詞
＠さ	《最大高度》	名詞
＠さい	《最大高度》	名詞
＠さいだ	《最大高度》	名詞
＠さいだい	《最大高度》	名詞
＠さいだいこ	《最大高度》	名詞
＠さいだいこう	《最大高度》	名詞
＠さいだいこうど	《最大高度》	名詞
＠さ	《最終》	名詞
＠さい	《最終》	名詞
＠さいし	《最終》	名詞
＠さいしゅ	《最終》	名詞
＠さいしゅう	《最終》	名詞
＠ゆ	《有毒ガス》	名詞
＠ゆう	《有毒ガス》	名詞
＠ゆうど	《有毒ガス》	名詞
＠ゆうどく	《有毒ガス》	名詞
＠ゆうどくが	《有毒ガス》	名詞
＠ゆうどくがす	《有毒ガス》	名詞
＠ぼ	《本を貪るもの》	名詞
＠ぼん	《本を貪るもの》	名詞
＠ぼんを	《本を貪るもの》	名詞
＠ぼんをむ	《本を貪るもの》	名詞
＠ぼんをむさ	《本を貪るもの》	名詞
＠ぼんをむさぼ	《本を貪るもの》	名詞
＠ぼんをむさぼる	《本を貪るもの》	名詞
＠ぼんをむさぼるも	《本を貪るもの》	名詞
＠ぼんをむさぼるもの	《本を貪るもの》	名詞
＠た	《松明の急使》	名詞
＠たい	《松明の急使》	名詞
＠たいま	《松明の急使》	名詞
＠たいまつ	《松明の急使》	名詞
＠たいまつの	《松明の急使》	名詞
＠たいまつのき	《松明の急使》	名詞
＠たいまつのきゅ	《松明の急使》	名詞
＠たいまつのきゅう	《松明の急使》	名詞
＠たいまつのきゅうし	《松明の急使》	名詞
＠え	《栄光の好機》	名詞
＠えい	《栄光の好機》	名詞
＠えいこ	《栄光の好機》	名詞
＠えいこう	《栄光の好機》	名詞
＠えいこうの	《栄光の好機》	名詞
＠えいこうのこ	《栄光の好機》	名詞
＠えいこうのこう	《栄光の好機》	名詞
＠えいこうのこうき	《栄光の好機》	名詞
＠も	《森》	名詞
＠もり	《森》	名詞
＠が	《概念の雨》	名詞
＠がい	《概念の雨》	名詞
＠がいね	《概念の雨》	名詞
＠がいねん	《概念の雨》	名詞
＠がいねんの	《概念の雨》	名詞
＠がいねんのあ	《概念の雨》	名詞
＠がいねんのあめ	《概念の雨》	名詞
＠つ	《槌落とし》	名詞
＠つち	《槌落とし》	名詞
＠つちお	《槌落とし》	名詞
＠つちおと	《槌落とし》	名詞
＠つちおとし	《槌落とし》	名詞
＠し	《標の稲妻》	名詞
＠しめ	《標の稲妻》	名詞
＠しめの	《標の稲妻》	名詞
＠しめのい	《標の稲妻》	名詞
＠しめのいな	《標の稲妻》	名詞
＠しめのいなず	《標の稲妻》	名詞
＠しめのいなずま	《標の稲妻》	名詞
＠も	《模写》	名詞
＠もし	《模写》	名詞
＠もしゃ	《模写》	名詞
＠じ	《樹木園の精霊》	名詞
＠じゅ	《樹木園の精霊》	名詞
＠じゅも	《樹木園の精霊》	名詞
＠じゅもく	《樹木園の精霊》	名詞
＠じゅもくえ	《樹木園の精霊》	名詞
＠じゅもくえん	《樹木園の精霊》	名詞
＠じゅもくえんの	《樹木園の精霊》	名詞
＠じゅもくえんのし	《樹木園の精霊》	名詞
＠じゅもくえんのしょ	《樹木園の精霊》	名詞
＠じゅもくえんのしょう	《樹木園の精霊》	名詞
＠じゅもくえんのしょうり	《樹木園の精霊》	名詞
＠じゅもくえんのしょうりょ	《樹木園の精霊》	名詞
＠じゅもくえんのしょうりょう	《樹木園の精霊》	名詞
＠し	《正気泥棒》	名詞
＠しょ	《正気泥棒》	名詞
＠しょう	《正気泥棒》	名詞
＠しょうき	《正気泥棒》	名詞
＠しょうきど	《正気泥棒》	名詞
＠しょうきどろ	《正気泥棒》	名詞
＠しょうきどろぼ	《正気泥棒》	名詞
＠しょうきどろぼう	《正気泥棒》	名詞
＠せ	《正確な稲妻》	名詞
＠せい	《正確な稲妻》	名詞
＠せいか	《正確な稲妻》	名詞
＠せいかく	《正確な稲妻》	名詞
＠せいかくな	《正確な稲妻》	名詞
＠せいかくない	《正確な稲妻》	名詞
＠せいかくないな	《正確な稲妻》	名詞
＠せいかくないなず	《正確な稲妻》	名詞
＠せいかくないなずま	《正確な稲妻》	名詞
＠せ	《正義の一撃》	名詞
＠せい	《正義の一撃》	名詞
＠せいぎ	《正義の一撃》	名詞
＠せいぎの	《正義の一撃》	名詞
＠せいぎのい	《正義の一撃》	名詞
＠せいぎのいち	《正義の一撃》	名詞
＠せいぎのいちげ	《正義の一撃》	名詞
＠せいぎのいちげき	《正義の一撃》	名詞
＠せ	《正義の模範、オレリア》	名詞
＠せい	《正義の模範、オレリア》	名詞
＠せいぎ	《正義の模範、オレリア》	名詞
＠せいぎの	《正義の模範、オレリア》	名詞
＠せいぎのも	《正義の模範、オレリア》	名詞
＠せいぎのもは	《正義の模範、オレリア》	名詞
＠せいぎのもはん	《正義の模範、オレリア》	名詞
＠せいぎのもはん、	《正義の模範、オレリア》	名詞
＠せいぎのもはん、お	《正義の模範、オレリア》	名詞
＠せいぎのもはん、おれ	《正義の模範、オレリア》	名詞
＠せいぎのもはん、おれり	《正義の模範、オレリア》	名詞
＠せいぎのもはん、おれりあ	《正義の模範、オレリア》	名詞
＠し	《死の重み》	名詞
＠しの	《死の重み》	名詞
＠しのお	《死の重み》	名詞
＠しのおも	《死の重み》	名詞
＠しのおもみ	《死の重み》	名詞
＠き	《気前のいい野良猫》	名詞
＠きま	《気前のいい野良猫》	名詞
＠きまえ	《気前のいい野良猫》	名詞
＠きまえの	《気前のいい野良猫》	名詞
＠きまえのい	《気前のいい野良猫》	名詞
＠きまえのいい	《気前のいい野良猫》	名詞
＠きまえのいいの	《気前のいい野良猫》	名詞
＠きまえのいいのら	《気前のいい野良猫》	名詞
＠きまえのいいのらね	《気前のいい野良猫》	名詞
＠きまえのいいのらねこ	《気前のいい野良猫》	名詞
＠き	《気難しいゴブリン》	名詞
＠きむ	《気難しいゴブリン》	名詞
＠きむつ	《気難しいゴブリン》	名詞
＠きむつか	《気難しいゴブリン》	名詞
＠きむつかし	《気難しいゴブリン》	名詞
＠きむつかしい	《気難しいゴブリン》	名詞
＠きむつかしいご	《気難しいゴブリン》	名詞
＠きむつかしいごぶ	《気難しいゴブリン》	名詞
＠きむつかしいごぶり	《気難しいゴブリン》	名詞
＠きむつかしいごぶりん	《気難しいゴブリン》	名詞
＠す	《水没した秘密》	名詞
＠すい	《水没した秘密》	名詞
＠すいぼ	《水没した秘密》	名詞
＠すいぼつ	《水没した秘密》	名詞
＠すいぼつし	《水没した秘密》	名詞
＠すいぼつした	《水没した秘密》	名詞
＠すいぼつしたひ	《水没した秘密》	名詞
＠すいぼつしたひみ	《水没した秘密》	名詞
＠すいぼつしたひみつ	《水没した秘密》	名詞
＠ぬ	《沼》	名詞
＠ぬま	《沼》	名詞
＠ど	《泥棒ネズミ》	名詞
＠どろ	《泥棒ネズミ》	名詞
＠どろぼ	《泥棒ネズミ》	名詞
＠どろぼう	《泥棒ネズミ》	名詞
＠どろぼうね	《泥棒ネズミ》	名詞
＠どろぼうねず	《泥棒ネズミ》	名詞
＠どろぼうねずみ	《泥棒ネズミ》	名詞
＠か	《活胞子ワーム》	名詞
＠かつ	《活胞子ワーム》	名詞
＠かつほ	《活胞子ワーム》	名詞
＠かつほう	《活胞子ワーム》	名詞
＠かつほうし	《活胞子ワーム》	名詞
＠かつほうしわ	《活胞子ワーム》	名詞
＠かつほうしわー	《活胞子ワーム》	名詞
＠かつほうしわーむ	《活胞子ワーム》	名詞
＠し	《湿った墓》	名詞
＠しめ	《湿った墓》	名詞
＠しめっ	《湿った墓》	名詞
＠しめった	《湿った墓》	名詞
＠しめったは	《湿った墓》	名詞
＠しめったはか	《湿った墓》	名詞
＠よ	《溶岩コイル》	名詞
＠よう	《溶岩コイル》	名詞
＠ようが	《溶岩コイル》	名詞
＠ようがん	《溶岩コイル》	名詞
＠ようがんこ	《溶岩コイル》	名詞
＠ようがんこい	《溶岩コイル》	名詞
＠ようがんこいる	《溶岩コイル》	名詞
＠よ	《溶解区のミノタウルス》	名詞
＠よう	《溶解区のミノタウルス》	名詞
＠ようか	《溶解区のミノタウルス》	名詞
＠ようかい	《溶解区のミノタウルス》	名詞
＠ようかいく	《溶解区のミノタウルス》	名詞
＠ようかいくの	《溶解区のミノタウルス》	名詞
＠ようかいくのみ	《溶解区のミノタウルス》	名詞
＠ようかいくのみの	《溶解区のミノタウルス》	名詞
＠ようかいくのみのた	《溶解区のミノタウルス》	名詞
＠ようかいくのみのたう	《溶解区のミノタウルス》	名詞
＠ようかいくのみのたうる	《溶解区のミノタウルス》	名詞
＠ようかいくのみのたうるす	《溶解区のミノタウルス》	名詞
＠ひ	《漂流自我》	名詞
＠ひょ	《漂流自我》	名詞
＠ひょう	《漂流自我》	名詞
＠ひょうり	《漂流自我》	名詞
＠ひょうりゅ	《漂流自我》	名詞
＠ひょうりゅう	《漂流自我》	名詞
＠ひょうりゅうじ	《漂流自我》	名詞
＠ひょうりゅうじが	《漂流自我》	名詞
＠ひ	《火小僧》	名詞
＠ひこ	《火小僧》	名詞
＠ひこぞ	《火小僧》	名詞
＠ひこぞう	《火小僧》	名詞
＠ひ	《火想者の研究》	名詞
＠ひそ	《火想者の研究》	名詞
＠ひそう	《火想者の研究》	名詞
＠ひそうし	《火想者の研究》	名詞
＠ひそうしゃ	《火想者の研究》	名詞
＠ひそうしゃの	《火想者の研究》	名詞
＠ひそうしゃのけ	《火想者の研究》	名詞
＠ひそうしゃのけん	《火想者の研究》	名詞
＠ひそうしゃのけんき	《火想者の研究》	名詞
＠ひそうしゃのけんきゅ	《火想者の研究》	名詞
＠ひそうしゃのけんきゅう	《火想者の研究》	名詞
＠む	《無効皮のフェロックス》	名詞
＠むこ	《無効皮のフェロックス》	名詞
＠むこう	《無効皮のフェロックス》	名詞
＠むこうか	《無効皮のフェロックス》	名詞
＠むこうかわ	《無効皮のフェロックス》	名詞
＠むこうかわの	《無効皮のフェロックス》	名詞
＠むこうかわのふ	《無効皮のフェロックス》	名詞
＠むこうかわのふぇ	《無効皮のフェロックス》	名詞
＠むこうかわのふぇろ	《無効皮のフェロックス》	名詞
＠むこうかわのふぇろっ	《無効皮のフェロックス》	名詞
＠むこうかわのふぇろっく	《無効皮のフェロックス》	名詞
＠むこうかわのふぇろっくす	《無効皮のフェロックス》	名詞
＠す	《煤の儀式》	名詞
＠すす	《煤の儀式》	名詞
＠すすの	《煤の儀式》	名詞
＠すすのぎ	《煤の儀式》	名詞
＠すすのぎし	《煤の儀式》	名詞
＠すすのぎしき	《煤の儀式》	名詞
＠ぶ	《物盗りインプ》	名詞
＠ぶつ	《物盗りインプ》	名詞
＠ぶつと	《物盗りインプ》	名詞
＠ぶつとり	《物盗りインプ》	名詞
＠ぶつとりい	《物盗りインプ》	名詞
＠ぶつとりいん	《物盗りインプ》	名詞
＠ぶつとりいんぷ	《物盗りインプ》	名詞
＠く	《狂った怒り》	名詞
＠くる	《狂った怒り》	名詞
＠くるっ	《狂った怒り》	名詞
＠くるった	《狂った怒り》	名詞
＠くるったい	《狂った怒り》	名詞
＠くるったいか	《狂った怒り》	名詞
＠くるったいかり	《狂った怒り》	名詞
＠た	《猛り狂う聖像》	名詞
＠たけ	《猛り狂う聖像》	名詞
＠たけり	《猛り狂う聖像》	名詞
＠たけりく	《猛り狂う聖像》	名詞
＠たけりくる	《猛り狂う聖像》	名詞
＠たけりくるう	《猛り狂う聖像》	名詞
＠たけりくるうせ	《猛り狂う聖像》	名詞
＠たけりくるうせい	《猛り狂う聖像》	名詞
＠たけりくるうせいぞ	《猛り狂う聖像》	名詞
＠たけりくるうせいぞう	《猛り狂う聖像》	名詞
＠け	《獣に囁く者》	名詞
＠けも	《獣に囁く者》	名詞
＠けもの	《獣に囁く者》	名詞
＠けものに	《獣に囁く者》	名詞
＠けものにさ	《獣に囁く者》	名詞
＠けものにささ	《獣に囁く者》	名詞
＠けものにささや	《獣に囁く者》	名詞
＠けものにささやく	《獣に囁く者》	名詞
＠けものにささやくも	《獣に囁く者》	名詞
＠けものにささやくもの	《獣に囁く者》	名詞
＠が	《瓦礫帯の猪》	名詞
＠がれ	《瓦礫帯の猪》	名詞
＠がれき	《瓦礫帯の猪》	名詞
＠がれきお	《瓦礫帯の猪》	名詞
＠がれきおび	《瓦礫帯の猪》	名詞
＠がれきおびの	《瓦礫帯の猪》	名詞
＠がれきおびのい	《瓦礫帯の猪》	名詞
＠がれきおびのいの	《瓦礫帯の猪》	名詞
＠がれきおびのいのし	《瓦礫帯の猪》	名詞
＠がれきおびのいのしし	《瓦礫帯の猪》	名詞
＠な	《生皮収集家》	名詞
＠なま	《生皮収集家》	名詞
＠なまか	《生皮収集家》	名詞
＠なまかわ	《生皮収集家》	名詞
＠なまかわし	《生皮収集家》	名詞
＠なまかわしゅ	《生皮収集家》	名詞
＠なまかわしゅう	《生皮収集家》	名詞
＠なまかわしゅうし	《生皮収集家》	名詞
＠なまかわしゅうしゅ	《生皮収集家》	名詞
＠なまかわしゅうしゅう	《生皮収集家》	名詞
＠なまかわしゅうしゅうか	《生皮収集家》	名詞
＠よ	《用心深いオカピ》	名詞
＠よう	《用心深いオカピ》	名詞
＠ようじ	《用心深いオカピ》	名詞
＠ようじん	《用心深いオカピ》	名詞
＠ようじんぶ	《用心深いオカピ》	名詞
＠ようじんぶか	《用心深いオカピ》	名詞
＠ようじんぶかい	《用心深いオカピ》	名詞
＠ようじんぶかいお	《用心深いオカピ》	名詞
＠ようじんぶかいおか	《用心深いオカピ》	名詞
＠ようじんぶかいおかぴ	《用心深いオカピ》	名詞
＠え	《疫病造り師》	名詞
＠えき	《疫病造り師》	名詞
＠えきび	《疫病造り師》	名詞
＠えきびょ	《疫病造り師》	名詞
＠えきびょう	《疫病造り師》	名詞
＠えきびょうつ	《疫病造り師》	名詞
＠えきびょうつく	《疫病造り師》	名詞
＠えきびょうつくり	《疫病造り師》	名詞
＠えきびょうつくりし	《疫病造り師》	名詞
＠い	《癒し手の鷹》	名詞
＠いや	《癒し手の鷹》	名詞
＠いやし	《癒し手の鷹》	名詞
＠いやして	《癒し手の鷹》	名詞
＠いやしての	《癒し手の鷹》	名詞
＠いやしてのた	《癒し手の鷹》	名詞
＠いやしてのたか	《癒し手の鷹》	名詞
＠は	《発展》	名詞
＠はっ	《発展》	名詞
＠はって	《発展》	名詞
＠はってん	《発展》	名詞
＠は	《発展+発破》	名詞
＠はっ	《発展+発破》	名詞
＠はって	《発展+発破》	名詞
＠はってん	《発展+発破》	名詞
＠はってん+	《発展+発破》	名詞
＠はってん+は	《発展+発破》	名詞
＠はってん+はっ	《発展+発破》	名詞
＠はってん+はっぱ	《発展+発破》	名詞
＠は	《発散》	名詞
＠はっ	《発散》	名詞
＠はっさ	《発散》	名詞
＠はっさん	《発散》	名詞
＠は	《発破》	名詞
＠はっ	《発破》	名詞
＠はっぱ	《発破》	名詞
＠は	《発見》	名詞
＠はっ	《発見》	名詞
＠はっけ	《発見》	名詞
＠はっけん	《発見》	名詞
＠は	《発見+発散》	名詞
＠はっ	《発見+発散》	名詞
＠はっけ	《発見+発散》	名詞
＠はっけん	《発見+発散》	名詞
＠はっけん+	《発見+発散》	名詞
＠はっけん+は	《発見+発散》	名詞
＠はっけん+はっ	《発見+発散》	名詞
＠はっけん+はっさ	《発見+発散》	名詞
＠はっけん+はっさん	《発見+発散》	名詞
＠ち	《直流》	名詞
＠ちょ	《直流》	名詞
＠ちょく	《直流》	名詞
＠ちょくり	《直流》	名詞
＠ちょくりゅ	《直流》	名詞
＠ちょくりゅう	《直流》	名詞
＠だ	《盾連携》	名詞
＠だて	《盾連携》	名詞
＠だてれ	《盾連携》	名詞
＠だてれん	《盾連携》	名詞
＠だてれんけ	《盾連携》	名詞
＠だてれんけい	《盾連携》	名詞
＠ま	《真夜中の死神》	名詞
＠まよ	《真夜中の死神》	名詞
＠まよな	《真夜中の死神》	名詞
＠まよなか	《真夜中の死神》	名詞
＠まよなかの	《真夜中の死神》	名詞
＠まよなかのし	《真夜中の死神》	名詞
＠まよなかのしに	《真夜中の死神》	名詞
＠まよなかのしにが	《真夜中の死神》	名詞
＠まよなかのしにがみ	《真夜中の死神》	名詞
＠ま	《真火の隊長》	名詞
＠まひ	《真火の隊長》	名詞
＠まひの	《真火の隊長》	名詞
＠まひのた	《真火の隊長》	名詞
＠まひのたい	《真火の隊長》	名詞
＠まひのたいち	《真火の隊長》	名詞
＠まひのたいちょ	《真火の隊長》	名詞
＠まひのたいちょう	《真火の隊長》	名詞
＠げ	《眩惑の光》	名詞
＠げん	《眩惑の光》	名詞
＠げんわ	《眩惑の光》	名詞
＠げんわく	《眩惑の光》	名詞
＠げんわくの	《眩惑の光》	名詞
＠げんわくのひ	《眩惑の光》	名詞
＠げんわくのひか	《眩惑の光》	名詞
＠げんわくのひかり	《眩惑の光》	名詞
＠せ	《石像》	名詞
＠せき	《石像》	名詞
＠せきぞ	《石像》	名詞
＠せきぞう	《石像》	名詞
＠は	《破滅を囁くもの》	名詞
＠はめ	《破滅を囁くもの》	名詞
＠はめつ	《破滅を囁くもの》	名詞
＠はめつを	《破滅を囁くもの》	名詞
＠はめつをさ	《破滅を囁くもの》	名詞
＠はめつをささ	《破滅を囁くもの》	名詞
＠はめつをささや	《破滅を囁くもの》	名詞
＠はめつをささやく	《破滅を囁くもの》	名詞
＠はめつをささやくも	《破滅を囁くもの》	名詞
＠はめつをささやくもの	《破滅を囁くもの》	名詞
＠か	《確実な一撃》	名詞
＠かく	《確実な一撃》	名詞
＠かくじ	《確実な一撃》	名詞
＠かくじつ	《確実な一撃》	名詞
＠かくじつな	《確実な一撃》	名詞
＠かくじつない	《確実な一撃》	名詞
＠かくじつないち	《確実な一撃》	名詞
＠かくじつないちげ	《確実な一撃》	名詞
＠かくじつないちげき	《確実な一撃》	名詞
＠か	《確立》	名詞
＠かく	《確立》	名詞
＠かくり	《確立》	名詞
＠かくりつ	《確立》	名詞
＠か	《確証》	名詞
＠かく	《確証》	名詞
＠かくし	《確証》	名詞
＠かくしょ	《確証》	名詞
＠かくしょう	《確証》	名詞
＠か	《確証+確立》	名詞
＠かく	《確証+確立》	名詞
＠かくし	《確証+確立》	名詞
＠かくしょ	《確証+確立》	名詞
＠かくしょう	《確証+確立》	名詞
＠かくしょう+	《確証+確立》	名詞
＠かくしょう+か	《確証+確立》	名詞
＠かくしょう+かく	《確証+確立》	名詞
＠かくしょう+かくり	《確証+確立》	名詞
＠かくしょう+かくりつ	《確証+確立》	名詞
＠し	《神聖な訪問》	名詞
＠しん	《神聖な訪問》	名詞
＠しんせ	《神聖な訪問》	名詞
＠しんせい	《神聖な訪問》	名詞
＠しんせいな	《神聖な訪問》	名詞
＠しんせいなほ	《神聖な訪問》	名詞
＠しんせいなほう	《神聖な訪問》	名詞
＠しんせいなほうも	《神聖な訪問》	名詞
＠しんせいなほうもん	《神聖な訪問》	名詞
＠き	《禁制品潰し》	名詞
＠きん	《禁制品潰し》	名詞
＠きんせ	《禁制品潰し》	名詞
＠きんせい	《禁制品潰し》	名詞
＠きんせいひ	《禁制品潰し》	名詞
＠きんせいひん	《禁制品潰し》	名詞
＠きんせいひんつ	《禁制品潰し》	名詞
＠きんせいひんつぶ	《禁制品潰し》	名詞
＠きんせいひんつぶし	《禁制品潰し》	名詞
＠あ	《秋の騎士》	名詞
＠あき	《秋の騎士》	名詞
＠あきの	《秋の騎士》	名詞
＠あきのき	《秋の騎士》	名詞
＠あきのきし	《秋の騎士》	名詞
＠そ	《空騎士の軍団兵》	名詞
＠そら	《空騎士の軍団兵》	名詞
＠そらき	《空騎士の軍団兵》	名詞
＠そらきし	《空騎士の軍団兵》	名詞
＠そらきしの	《空騎士の軍団兵》	名詞
＠そらきしのぐ	《空騎士の軍団兵》	名詞
＠そらきしのぐん	《空騎士の軍団兵》	名詞
＠そらきしのぐんだ	《空騎士の軍団兵》	名詞
＠そらきしのぐんだん	《空騎士の軍団兵》	名詞
＠そらきしのぐんだんへ	《空騎士の軍団兵》	名詞
＠そらきしのぐんだんへい	《空騎士の軍団兵》	名詞
＠と	《突撃するロック鳥》	名詞
＠とつ	《突撃するロック鳥》	名詞
＠とつげ	《突撃するロック鳥》	名詞
＠とつげき	《突撃するロック鳥》	名詞
＠とつげきす	《突撃するロック鳥》	名詞
＠とつげきする	《突撃するロック鳥》	名詞
＠とつげきするろ	《突撃するロック鳥》	名詞
＠とつげきするろっ	《突撃するロック鳥》	名詞
＠とつげきするろっく	《突撃するロック鳥》	名詞
＠とつげきするろっくち	《突撃するロック鳥》	名詞
＠とつげきするろっくちょ	《突撃するロック鳥》	名詞
＠とつげきするろっくちょう	《突撃するロック鳥》	名詞
＠と	《突発的な兵長》	名詞
＠とっ	《突発的な兵長》	名詞
＠とっぱ	《突発的な兵長》	名詞
＠とっぱつ	《突発的な兵長》	名詞
＠とっぱつて	《突発的な兵長》	名詞
＠とっぱつてき	《突発的な兵長》	名詞
＠とっぱつてきな	《突発的な兵長》	名詞
＠とっぱつてきなへ	《突発的な兵長》	名詞
＠とっぱつてきなへい	《突発的な兵長》	名詞
＠とっぱつてきなへいち	《突発的な兵長》	名詞
＠とっぱつてきなへいちょ	《突発的な兵長》	名詞
＠とっぱつてきなへいちょう	《突発的な兵長》	名詞
＠だ	《第10管区の守備兵》	名詞
＠だい	《第10管区の守備兵》	名詞
＠だい1	《第10管区の守備兵》	名詞
＠だい10	《第10管区の守備兵》	名詞
＠だい10か	《第10管区の守備兵》	名詞
＠だい10かん	《第10管区の守備兵》	名詞
＠だい10かんく	《第10管区の守備兵》	名詞
＠だい10かんくの	《第10管区の守備兵》	名詞
＠だい10かんくのし	《第10管区の守備兵》	名詞
＠だい10かんくのしゅ	《第10管区の守備兵》	名詞
＠だい10かんくのしゅび	《第10管区の守備兵》	名詞
＠だい10かんくのしゅびへ	《第10管区の守備兵》	名詞
＠だい10かんくのしゅびへい	《第10管区の守備兵》	名詞
＠か	《管区の案内人》	名詞
＠かん	《管区の案内人》	名詞
＠かんく	《管区の案内人》	名詞
＠かんくの	《管区の案内人》	名詞
＠かんくのあ	《管区の案内人》	名詞
＠かんくのあん	《管区の案内人》	名詞
＠かんくのあんな	《管区の案内人》	名詞
＠かんくのあんない	《管区の案内人》	名詞
＠かんくのあんないに	《管区の案内人》	名詞
＠かんくのあんないにん	《管区の案内人》	名詞
＠の	《納骨堂のトロール》	名詞
＠のう	《納骨堂のトロール》	名詞
＠のうこ	《納骨堂のトロール》	名詞
＠のうこつ	《納骨堂のトロール》	名詞
＠のうこつど	《納骨堂のトロール》	名詞
＠のうこつどう	《納骨堂のトロール》	名詞
＠のうこつどうの	《納骨堂のトロール》	名詞
＠のうこつどうのと	《納骨堂のトロール》	名詞
＠のうこつどうのとろ	《納骨堂のトロール》	名詞
＠のうこつどうのとろー	《納骨堂のトロール》	名詞
＠のうこつどうのとろーる	《納骨堂のトロール》	名詞
＠か	《絡み合うモウセンゴケ》	名詞
＠から	《絡み合うモウセンゴケ》	名詞
＠からみ	《絡み合うモウセンゴケ》	名詞
＠からみあ	《絡み合うモウセンゴケ》	名詞
＠からみあう	《絡み合うモウセンゴケ》	名詞
＠からみあうも	《絡み合うモウセンゴケ》	名詞
＠からみあうもう	《絡み合うモウセンゴケ》	名詞
＠からみあうもうせ	《絡み合うモウセンゴケ》	名詞
＠からみあうもうせん	《絡み合うモウセンゴケ》	名詞
＠からみあうもうせんご	《絡み合うモウセンゴケ》	名詞
＠からみあうもうせんごけ	《絡み合うモウセンゴケ》	名詞
＠が	《絡み爪のイトグモ》	名詞
＠がら	《絡み爪のイトグモ》	名詞
＠がらみ	《絡み爪のイトグモ》	名詞
＠がらみづ	《絡み爪のイトグモ》	名詞
＠がらみづめ	《絡み爪のイトグモ》	名詞
＠がらみづめの	《絡み爪のイトグモ》	名詞
＠がらみづめのい	《絡み爪のイトグモ》	名詞
＠がらみづめのいと	《絡み爪のイトグモ》	名詞
＠がらみづめのいとぐ	《絡み爪のイトグモ》	名詞
＠がらみづめのいとぐも	《絡み爪のイトグモ》	名詞
＠ざ	《罪人逮捕》	名詞
＠ざい	《罪人逮捕》	名詞
＠ざいに	《罪人逮捕》	名詞
＠ざいにん	《罪人逮捕》	名詞
＠ざいにんた	《罪人逮捕》	名詞
＠ざいにんたい	《罪人逮捕》	名詞
＠ざいにんたいほ	《罪人逮捕》	名詞
＠む	《群れの好意》	名詞
＠むれ	《群れの好意》	名詞
＠むれの	《群れの好意》	名詞
＠むれのこ	《群れの好意》	名詞
＠むれのこう	《群れの好意》	名詞
＠むれのこうい	《群れの好意》	名詞
＠ぐ	《群集のギルド魔道士》	名詞
＠ぐん	《群集のギルド魔道士》	名詞
＠ぐんし	《群集のギルド魔道士》	名詞
＠ぐんしゅ	《群集のギルド魔道士》	名詞
＠ぐんしゅう	《群集のギルド魔道士》	名詞
＠ぐんしゅうの	《群集のギルド魔道士》	名詞
＠ぐんしゅうのぎ	《群集のギルド魔道士》	名詞
＠ぐんしゅうのぎる	《群集のギルド魔道士》	名詞
＠ぐんしゅうのぎるど	《群集のギルド魔道士》	名詞
＠ぐんしゅうのぎるどま	《群集のギルド魔道士》	名詞
＠ぐんしゅうのぎるどまど	《群集のギルド魔道士》	名詞
＠ぐんしゅうのぎるどまどう	《群集のギルド魔道士》	名詞
＠ぐんしゅうのぎるどまどうし	《群集のギルド魔道士》	名詞
＠せ	《聖なる鋳造所》	名詞
＠せい	《聖なる鋳造所》	名詞
＠せいな	《聖なる鋳造所》	名詞
＠せいなる	《聖なる鋳造所》	名詞
＠せいなるち	《聖なる鋳造所》	名詞
＠せいなるちゅ	《聖なる鋳造所》	名詞
＠せいなるちゅう	《聖なる鋳造所》	名詞
＠せいなるちゅうぞ	《聖なる鋳造所》	名詞
＠せいなるちゅうぞう	《聖なる鋳造所》	名詞
＠せいなるちゅうぞうじ	《聖なる鋳造所》	名詞
＠せいなるちゅうぞうじょ	《聖なる鋳造所》	名詞
＠せ	《背骨のワンド》	名詞
＠せぼ	《背骨のワンド》	名詞
＠せぼね	《背骨のワンド》	名詞
＠せぼねの	《背骨のワンド》	名詞
＠せぼねのわ	《背骨のワンド》	名詞
＠せぼねのわん	《背骨のワンド》	名詞
＠せぼねのわんど	《背骨のワンド》	名詞
＠せ	《背骨ムカデ》	名詞
＠せぼ	《背骨ムカデ》	名詞
＠せぼね	《背骨ムカデ》	名詞
＠せぼねむ	《背骨ムカデ》	名詞
＠せぼねむか	《背骨ムカデ》	名詞
＠せぼねむかで	《背骨ムカデ》	名詞
＠く	《腐れ巨人》	名詞
＠くさ	《腐れ巨人》	名詞
＠くされ	《腐れ巨人》	名詞
＠くされき	《腐れ巨人》	名詞
＠くされきょ	《腐れ巨人》	名詞
＠くされきょじ	《腐れ巨人》	名詞
＠くされきょじん	《腐れ巨人》	名詞
＠ち	《致命的な訪問》	名詞
＠ちめ	《致命的な訪問》	名詞
＠ちめい	《致命的な訪問》	名詞
＠ちめいて	《致命的な訪問》	名詞
＠ちめいてき	《致命的な訪問》	名詞
＠ちめいてきな	《致命的な訪問》	名詞
＠ちめいてきなほ	《致命的な訪問》	名詞
＠ちめいてきなほう	《致命的な訪問》	名詞
＠ちめいてきなほうも	《致命的な訪問》	名詞
＠ちめいてきなほうもん	《致命的な訪問》	名詞
＠め	《芽吹く更生》	名詞
＠めぶ	《芽吹く更生》	名詞
＠めぶく	《芽吹く更生》	名詞
＠めぶくこ	《芽吹く更生》	名詞
＠めぶくこう	《芽吹く更生》	名詞
＠めぶくこうせ	《芽吹く更生》	名詞
＠めぶくこうせい	《芽吹く更生》	名詞
＠く	《草むした墓》	名詞
＠くさ	《草むした墓》	名詞
＠くさむ	《草むした墓》	名詞
＠くさむし	《草むした墓》	名詞
＠くさむした	《草むした墓》	名詞
＠くさむしたは	《草むした墓》	名詞
＠くさむしたはか	《草むした墓》	名詞
＠か	《華麗》	名詞
＠かれ	《華麗》	名詞
＠かれい	《華麗》	名詞
＠お	《落とし格子の蔦》	名詞
＠おと	《落とし格子の蔦》	名詞
＠おとし	《落とし格子の蔦》	名詞
＠おとしご	《落とし格子の蔦》	名詞
＠おとしごう	《落とし格子の蔦》	名詞
＠おとしごうし	《落とし格子の蔦》	名詞
＠おとしごうしの	《落とし格子の蔦》	名詞
＠おとしごうしのつ	《落とし格子の蔦》	名詞
＠おとしごうしのつた	《落とし格子の蔦》	名詞
＠じ	《蒸気孔》	名詞
＠じょ	《蒸気孔》	名詞
＠じょう	《蒸気孔》	名詞
＠じょうき	《蒸気孔》	名詞
＠じょうきあ	《蒸気孔》	名詞
＠じょうきあな	《蒸気孔》	名詞
＠ば	《薔薇たてがみのケンタウルス》	名詞
＠ばら	《薔薇たてがみのケンタウルス》	名詞
＠ばらた	《薔薇たてがみのケンタウルス》	名詞
＠ばらたて	《薔薇たてがみのケンタウルス》	名詞
＠ばらたてが	《薔薇たてがみのケンタウルス》	名詞
＠ばらたてがみ	《薔薇たてがみのケンタウルス》	名詞
＠ばらたてがみの	《薔薇たてがみのケンタウルス》	名詞
＠ばらたてがみのけ	《薔薇たてがみのケンタウルス》	名詞
＠ばらたてがみのけん	《薔薇たてがみのケンタウルス》	名詞
＠ばらたてがみのけんた	《薔薇たてがみのケンタウルス》	名詞
＠ばらたてがみのけんたう	《薔薇たてがみのケンタウルス》	名詞
＠ばらたてがみのけんたうる	《薔薇たてがみのケンタウルス》	名詞
＠ばらたてがみのけんたうるす	《薔薇たてがみのケンタウルス》	名詞
＠な	《薙ぎ払いの巨人》	名詞
＠なぎ	《薙ぎ払いの巨人》	名詞
＠なぎは	《薙ぎ払いの巨人》	名詞
＠なぎはら	《薙ぎ払いの巨人》	名詞
＠なぎはらい	《薙ぎ払いの巨人》	名詞
＠なぎはらいの	《薙ぎ払いの巨人》	名詞
＠なぎはらいのき	《薙ぎ払いの巨人》	名詞
＠なぎはらいのきょ	《薙ぎ払いの巨人》	名詞
＠なぎはらいのきょじ	《薙ぎ払いの巨人》	名詞
＠なぎはらいのきょじん	《薙ぎ払いの巨人》	名詞
＠く	《薬術師の眼識》	名詞
＠くす	《薬術師の眼識》	名詞
＠くすし	《薬術師の眼識》	名詞
＠くすしや	《薬術師の眼識》	名詞
＠くすしやす	《薬術師の眼識》	名詞
＠くすしやすし	《薬術師の眼識》	名詞
＠くすしやすしし	《薬術師の眼識》	名詞
＠くすしやすししの	《薬術師の眼識》	名詞
＠くすしやすししのが	《薬術師の眼識》	名詞
＠くすしやすししのがん	《薬術師の眼識》	名詞
＠くすしやすししのがんし	《薬術師の眼識》	名詞
＠くすしやすししのがんしき	《薬術師の眼識》	名詞
＠き	《虚報活動》	名詞
＠きょ	《虚報活動》	名詞
＠きょほ	《虚報活動》	名詞
＠きょほう	《虚報活動》	名詞
＠きょほうか	《虚報活動》	名詞
＠きょほうかつ	《虚報活動》	名詞
＠きょほうかつど	《虚報活動》	名詞
＠きょほうかつどう	《虚報活動》	名詞
＠ろ	《蝋燭の夜警》	名詞
＠ろう	《蝋燭の夜警》	名詞
＠ろうそ	《蝋燭の夜警》	名詞
＠ろうそく	《蝋燭の夜警》	名詞
＠ろうそくの	《蝋燭の夜警》	名詞
＠ろうそくのや	《蝋燭の夜警》	名詞
＠ろうそくのやけ	《蝋燭の夜警》	名詞
＠ろうそくのやけい	《蝋燭の夜警》	名詞
＠ち	《血の刺客》	名詞
＠ちの	《血の刺客》	名詞
＠ちのし	《血の刺客》	名詞
＠ちのしか	《血の刺客》	名詞
＠ちのしかく	《血の刺客》	名詞
＠ま	《街見張りのスフィンクス》	名詞
＠まち	《街見張りのスフィンクス》	名詞
＠まちみ	《街見張りのスフィンクス》	名詞
＠まちみは	《街見張りのスフィンクス》	名詞
＠まちみはり	《街見張りのスフィンクス》	名詞
＠まちみはりの	《街見張りのスフィンクス》	名詞
＠まちみはりのす	《街見張りのスフィンクス》	名詞
＠まちみはりのすふ	《街見張りのスフィンクス》	名詞
＠まちみはりのすふぃ	《街見張りのスフィンクス》	名詞
＠まちみはりのすふぃん	《街見張りのスフィンクス》	名詞
＠まちみはりのすふぃんく	《街見張りのスフィンクス》	名詞
＠まちみはりのすふぃんくす	《街見張りのスフィンクス》	名詞
＠が	《街頭暴動》	名詞
＠がい	《街頭暴動》	名詞
＠がいと	《街頭暴動》	名詞
＠がいとう	《街頭暴動》	名詞
＠がいとうぼ	《街頭暴動》	名詞
＠がいとうぼう	《街頭暴動》	名詞
＠がいとうぼうど	《街頭暴動》	名詞
＠がいとうぼうどう	《街頭暴動》	名詞
＠さ	《裁きの一撃》	名詞
＠さば	《裁きの一撃》	名詞
＠さばき	《裁きの一撃》	名詞
＠さばきの	《裁きの一撃》	名詞
＠さばきのい	《裁きの一撃》	名詞
＠さばきのいち	《裁きの一撃》	名詞
＠さばきのいちげ	《裁きの一撃》	名詞
＠さばきのいちげき	《裁きの一撃》	名詞
＠か	《観点》	名詞
＠かん	《観点》	名詞
＠かんて	《観点》	名詞
＠かんてん	《観点》	名詞
＠き	《記憶の裏切り》	名詞
＠きお	《記憶の裏切り》	名詞
＠きおく	《記憶の裏切り》	名詞
＠きおくの	《記憶の裏切り》	名詞
＠きおくのう	《記憶の裏切り》	名詞
＠きおくのうら	《記憶の裏切り》	名詞
＠きおくのうらぎ	《記憶の裏切り》	名詞
＠きおくのうらぎり	《記憶の裏切り》	名詞
＠し	《詩神のドレイク》	名詞
＠しし	《詩神のドレイク》	名詞
＠ししん	《詩神のドレイク》	名詞
＠ししんの	《詩神のドレイク》	名詞
＠ししんのど	《詩神のドレイク》	名詞
＠ししんのどれ	《詩神のドレイク》	名詞
＠ししんのどれい	《詩神のドレイク》	名詞
＠ししんのどれいく	《詩神のドレイク》	名詞
＠き	《詭謀》	名詞
＠きは	《詭謀》	名詞
＠きはか	《詭謀》	名詞
＠きはかり	《詭謀》	名詞
＠きはかりご	《詭謀》	名詞
＠きはかりごと	《詭謀》	名詞
＠き	《詭謀+奇策》	名詞
＠きは	《詭謀+奇策》	名詞
＠きはか	《詭謀+奇策》	名詞
＠きはかり	《詭謀+奇策》	名詞
＠きはかりご	《詭謀+奇策》	名詞
＠きはかりごと	《詭謀+奇策》	名詞
＠きはかりごと+	《詭謀+奇策》	名詞
＠きはかりごと+き	《詭謀+奇策》	名詞
＠きはかりごと+きさ	《詭謀+奇策》	名詞
＠きはかりごと+きさく	《詭謀+奇策》	名詞
＠ち	《諜報強化》	名詞
＠ちょ	《諜報強化》	名詞
＠ちょう	《諜報強化》	名詞
＠ちょうほ	《諜報強化》	名詞
＠ちょうほう	《諜報強化》	名詞
＠ちょうほうき	《諜報強化》	名詞
＠ちょうほうきょ	《諜報強化》	名詞
＠ちょうほうきょう	《諜報強化》	名詞
＠ちょうほうきょうか	《諜報強化》	名詞
＠ぎ	《議事会のギルド魔道士》	名詞
＠ぎじ	《議事会のギルド魔道士》	名詞
＠ぎじか	《議事会のギルド魔道士》	名詞
＠ぎじかい	《議事会のギルド魔道士》	名詞
＠ぎじかいの	《議事会のギルド魔道士》	名詞
＠ぎじかいのぎ	《議事会のギルド魔道士》	名詞
＠ぎじかいのぎる	《議事会のギルド魔道士》	名詞
＠ぎじかいのぎるど	《議事会のギルド魔道士》	名詞
＠ぎじかいのぎるどま	《議事会のギルド魔道士》	名詞
＠ぎじかいのぎるどまど	《議事会のギルド魔道士》	名詞
＠ぎじかいのぎるどまどう	《議事会のギルド魔道士》	名詞
＠ぎじかいのぎるどまどうし	《議事会のギルド魔道士》	名詞
＠ぎ	《議事会の裁き》	名詞
＠ぎじ	《議事会の裁き》	名詞
＠ぎじか	《議事会の裁き》	名詞
＠ぎじかい	《議事会の裁き》	名詞
＠ぎじかいの	《議事会の裁き》	名詞
＠ぎじかいのさ	《議事会の裁き》	名詞
＠ぎじかいのさば	《議事会の裁き》	名詞
＠ぎじかいのさばき	《議事会の裁き》	名詞
＠ぎ	《議事会の騎兵》	名詞
＠ぎじ	《議事会の騎兵》	名詞
＠ぎじか	《議事会の騎兵》	名詞
＠ぎじかい	《議事会の騎兵》	名詞
＠ぎじかいの	《議事会の騎兵》	名詞
＠ぎじかいのき	《議事会の騎兵》	名詞
＠ぎじかいのきへ	《議事会の騎兵》	名詞
＠ぎじかいのきへい	《議事会の騎兵》	名詞
＠さ	《賽銭ガニ》	名詞
＠さい	《賽銭ガニ》	名詞
＠さいせ	《賽銭ガニ》	名詞
＠さいせん	《賽銭ガニ》	名詞
＠さいせんが	《賽銭ガニ》	名詞
＠さいせんがに	《賽銭ガニ》	名詞
＠と	《跳び蛙》	名詞
＠とび	《跳び蛙》	名詞
＠とびか	《跳び蛙》	名詞
＠とびかえ	《跳び蛙》	名詞
＠とびかえる	《跳び蛙》	名詞
＠ぐ	《軍勢のギルド魔道士》	名詞
＠ぐん	《軍勢のギルド魔道士》	名詞
＠ぐんぜ	《軍勢のギルド魔道士》	名詞
＠ぐんぜい	《軍勢のギルド魔道士》	名詞
＠ぐんぜいの	《軍勢のギルド魔道士》	名詞
＠ぐんぜいのぎ	《軍勢のギルド魔道士》	名詞
＠ぐんぜいのぎる	《軍勢のギルド魔道士》	名詞
＠ぐんぜいのぎるど	《軍勢のギルド魔道士》	名詞
＠ぐんぜいのぎるどま	《軍勢のギルド魔道士》	名詞
＠ぐんぜいのぎるどまど	《軍勢のギルド魔道士》	名詞
＠ぐんぜいのぎるどまどう	《軍勢のギルド魔道士》	名詞
＠ぐんぜいのぎるどまどうし	《軍勢のギルド魔道士》	名詞
＠ぐ	《軍勢の光》	名詞
＠ぐん	《軍勢の光》	名詞
＠ぐんぜ	《軍勢の光》	名詞
＠ぐんぜい	《軍勢の光》	名詞
＠ぐんぜいの	《軍勢の光》	名詞
＠ぐんぜいのひ	《軍勢の光》	名詞
＠ぐんぜいのひか	《軍勢の光》	名詞
＠ぐんぜいのひかり	《軍勢の光》	名詞
＠ぐ	《軍勢の切先、タージク》	名詞
＠ぐん	《軍勢の切先、タージク》	名詞
＠ぐんぜ	《軍勢の切先、タージク》	名詞
＠ぐんぜい	《軍勢の切先、タージク》	名詞
＠ぐんぜいの	《軍勢の切先、タージク》	名詞
＠ぐんぜいのき	《軍勢の切先、タージク》	名詞
＠ぐんぜいのきっ	《軍勢の切先、タージク》	名詞
＠ぐんぜいのきっさ	《軍勢の切先、タージク》	名詞
＠ぐんぜいのきっさき	《軍勢の切先、タージク》	名詞
＠ぐんぜいのきっさき、	《軍勢の切先、タージク》	名詞
＠ぐんぜいのきっさき、た	《軍勢の切先、タージク》	名詞
＠ぐんぜいのきっさき、たー	《軍勢の切先、タージク》	名詞
＠ぐんぜいのきっさき、たーじ	《軍勢の切先、タージク》	名詞
＠ぐんぜいのきっさき、たーじく	《軍勢の切先、タージク》	名詞
＠ぐ	《軍勢の戦親分》	名詞
＠ぐん	《軍勢の戦親分》	名詞
＠ぐんぜ	《軍勢の戦親分》	名詞
＠ぐんぜい	《軍勢の戦親分》	名詞
＠ぐんぜいの	《軍勢の戦親分》	名詞
＠ぐんぜいのい	《軍勢の戦親分》	名詞
＠ぐんぜいのいく	《軍勢の戦親分》	名詞
＠ぐんぜいのいくさ	《軍勢の戦親分》	名詞
＠ぐんぜいのいくさお	《軍勢の戦親分》	名詞
＠ぐんぜいのいくさおや	《軍勢の戦親分》	名詞
＠ぐんぜいのいくさおやぶ	《軍勢の戦親分》	名詞
＠ぐんぜいのいくさおやぶん	《軍勢の戦親分》	名詞
＠け	《軽蔑的な一撃》	名詞
＠けい	《軽蔑的な一撃》	名詞
＠けいべ	《軽蔑的な一撃》	名詞
＠けいべつ	《軽蔑的な一撃》	名詞
＠けいべつて	《軽蔑的な一撃》	名詞
＠けいべつてき	《軽蔑的な一撃》	名詞
＠けいべつてきな	《軽蔑的な一撃》	名詞
＠けいべつてきない	《軽蔑的な一撃》	名詞
＠けいべつてきないち	《軽蔑的な一撃》	名詞
＠けいべつてきないちげ	《軽蔑的な一撃》	名詞
＠けいべつてきないちげき	《軽蔑的な一撃》	名詞
＠ご	《轟音のクラリオン》	名詞
＠ごう	《轟音のクラリオン》	名詞
＠ごうお	《轟音のクラリオン》	名詞
＠ごうおん	《轟音のクラリオン》	名詞
＠ごうおんの	《轟音のクラリオン》	名詞
＠ごうおんのく	《轟音のクラリオン》	名詞
＠ごうおんのくら	《轟音のクラリオン》	名詞
＠ごうおんのくらり	《轟音のクラリオン》	名詞
＠ごうおんのくらりお	《轟音のクラリオン》	名詞
＠ごうおんのくらりおん	《轟音のクラリオン》	名詞
＠う	《迂回路》	名詞
＠うか	《迂回路》	名詞
＠うかい	《迂回路》	名詞
＠うかいろ	《迂回路》	名詞
＠お	《追われる証人》	名詞
＠おわ	《追われる証人》	名詞
＠おわれ	《追われる証人》	名詞
＠おわれる	《追われる証人》	名詞
＠おわれるし	《追われる証人》	名詞
＠おわれるしょ	《追われる証人》	名詞
＠おわれるしょう	《追われる証人》	名詞
＠おわれるしょうに	《追われる証人》	名詞
＠おわれるしょうにん	《追われる証人》	名詞
＠の	《逃れ得ぬ猛火》	名詞
＠のが	《逃れ得ぬ猛火》	名詞
＠のがれ	《逃れ得ぬ猛火》	名詞
＠のがれえ	《逃れ得ぬ猛火》	名詞
＠のがれえぬ	《逃れ得ぬ猛火》	名詞
＠のがれえぬも	《逃れ得ぬ猛火》	名詞
＠のがれえぬもう	《逃れ得ぬ猛火》	名詞
＠のがれえぬもうか	《逃れ得ぬ猛火》	名詞
＠は	《這い寄る恐怖》	名詞
＠はい	《這い寄る恐怖》	名詞
＠はいよ	《這い寄る恐怖》	名詞
＠はいよる	《這い寄る恐怖》	名詞
＠はいよるき	《這い寄る恐怖》	名詞
＠はいよるきょ	《這い寄る恐怖》	名詞
＠はいよるきょう	《這い寄る恐怖》	名詞
＠はいよるきょうふ	《這い寄る恐怖》	名詞
＠は	《速太刀の擁護者》	名詞
＠はや	《速太刀の擁護者》	名詞
＠はやさ	《速太刀の擁護者》	名詞
＠はやさた	《速太刀の擁護者》	名詞
＠はやさたち	《速太刀の擁護者》	名詞
＠はやさたちの	《速太刀の擁護者》	名詞
＠はやさたちのよ	《速太刀の擁護者》	名詞
＠はやさたちのよう	《速太刀の擁護者》	名詞
＠はやさたちのようご	《速太刀の擁護者》	名詞
＠はやさたちのようごし	《速太刀の擁護者》	名詞
＠はやさたちのようごしゃ	《速太刀の擁護者》	名詞
＠と	《遁走する蒸気族》	名詞
＠とん	《遁走する蒸気族》	名詞
＠とんそ	《遁走する蒸気族》	名詞
＠とんそう	《遁走する蒸気族》	名詞
＠とんそうす	《遁走する蒸気族》	名詞
＠とんそうする	《遁走する蒸気族》	名詞
＠とんそうするじ	《遁走する蒸気族》	名詞
＠とんそうするじょ	《遁走する蒸気族》	名詞
＠とんそうするじょう	《遁走する蒸気族》	名詞
＠とんそうするじょうき	《遁走する蒸気族》	名詞
＠とんそうするじょうきぞ	《遁走する蒸気族》	名詞
＠とんそうするじょうきぞく	《遁走する蒸気族》	名詞
＠せ	《選択的な罠》	名詞
＠せん	《選択的な罠》	名詞
＠せんた	《選択的な罠》	名詞
＠せんたく	《選択的な罠》	名詞
＠せんたくて	《選択的な罠》	名詞
＠せんたくてき	《選択的な罠》	名詞
＠せんたくてきな	《選択的な罠》	名詞
＠せんたくてきなわ	《選択的な罠》	名詞
＠せんたくてきなわな	《選択的な罠》	名詞
＠と	《都市の楽園》	名詞
＠とし	《都市の楽園》	名詞
＠としの	《都市の楽園》	名詞
＠としのら	《都市の楽園》	名詞
＠としのらく	《都市の楽園》	名詞
＠としのらくえ	《都市の楽園》	名詞
＠としのらくえん	《都市の楽園》	名詞
＠じ	《重力殴打》	名詞
＠じゅ	《重力殴打》	名詞
＠じゅう	《重力殴打》	名詞
＠じゅうり	《重力殴打》	名詞
＠じゅうりょ	《重力殴打》	名詞
＠じゅうりょく	《重力殴打》	名詞
＠じゅうりょくお	《重力殴打》	名詞
＠じゅうりょくおう	《重力殴打》	名詞
＠じゅうりょくおうだ	《重力殴打》	名詞
＠や	《野生の角獣》	名詞
＠やせ	《野生の角獣》	名詞
＠やせい	《野生の角獣》	名詞
＠やせいの	《野生の角獣》	名詞
＠やせいのか	《野生の角獣》	名詞
＠やせいのかく	《野生の角獣》	名詞
＠やせいのかくけ	《野生の角獣》	名詞
＠やせいのかくけも	《野生の角獣》	名詞
＠やせいのかくけもの	《野生の角獣》	名詞
＠は	《鋼胴の甲虫》	名詞
＠はが	《鋼胴の甲虫》	名詞
＠はがね	《鋼胴の甲虫》	名詞
＠はがねど	《鋼胴の甲虫》	名詞
＠はがねどう	《鋼胴の甲虫》	名詞
＠はがねどうの	《鋼胴の甲虫》	名詞
＠はがねどうのか	《鋼胴の甲虫》	名詞
＠はがねどうのかぶ	《鋼胴の甲虫》	名詞
＠はがねどうのかぶと	《鋼胴の甲虫》	名詞
＠はがねどうのかぶとむ	《鋼胴の甲虫》	名詞
＠はがねどうのかぶとむし	《鋼胴の甲虫》	名詞
＠も	《門番のガーゴイル》	名詞
＠もん	《門番のガーゴイル》	名詞
＠もんば	《門番のガーゴイル》	名詞
＠もんばん	《門番のガーゴイル》	名詞
＠もんばんの	《門番のガーゴイル》	名詞
＠もんばんのが	《門番のガーゴイル》	名詞
＠もんばんのがー	《門番のガーゴイル》	名詞
＠もんばんのがーご	《門番のガーゴイル》	名詞
＠もんばんのがーごい	《門番のガーゴイル》	名詞
＠もんばんのがーごいる	《門番のガーゴイル》	名詞
＠か	《開花》	名詞
＠かい	《開花》	名詞
＠かいか	《開花》	名詞
＠か	《開花+華麗》	名詞
＠かい	《開花+華麗》	名詞
＠かいか	《開花+華麗》	名詞
＠かいか+	《開花+華麗》	名詞
＠かいか+か	《開花+華麗》	名詞
＠かいか+かれ	《開花+華麗》	名詞
＠かいか+かれい	《開花+華麗》	名詞
＠か	《間隙》	名詞
＠かん	《間隙》	名詞
＠かんげ	《間隙》	名詞
＠かんげき	《間隙》	名詞
＠や	《闇刃の工作員》	名詞
＠やみ	《闇刃の工作員》	名詞
＠やみは	《闇刃の工作員》	名詞
＠やみはの	《闇刃の工作員》	名詞
＠やみはのこ	《闇刃の工作員》	名詞
＠やみはのこう	《闇刃の工作員》	名詞
＠やみはのこうさ	《闇刃の工作員》	名詞
＠やみはのこうさく	《闇刃の工作員》	名詞
＠やみはのこうさくい	《闇刃の工作員》	名詞
＠やみはのこうさくいん	《闇刃の工作員》	名詞
＠こ	《降格》	名詞
＠こう	《降格》	名詞
＠こうか	《降格》	名詞
＠こうかく	《降格》	名詞
＠い	《陰惨な生類》	名詞
＠いん	《陰惨な生類》	名詞
＠いんさ	《陰惨な生類》	名詞
＠いんさん	《陰惨な生類》	名詞
＠いんさんな	《陰惨な生類》	名詞
＠いんさんなし	《陰惨な生類》	名詞
＠いんさんなしょ	《陰惨な生類》	名詞
＠いんさんなしょう	《陰惨な生類》	名詞
＠いんさんなしょうる	《陰惨な生類》	名詞
＠いんさんなしょうるい	《陰惨な生類》	名詞
＠か	《隠された影》	名詞
＠かく	《隠された影》	名詞
＠かくさ	《隠された影》	名詞
＠かくされ	《隠された影》	名詞
＠かくされた	《隠された影》	名詞
＠かくされたか	《隠された影》	名詞
＠かくされたかげ	《隠された影》	名詞
＠や	《雇われた毒殺者》	名詞
＠やと	《雇われた毒殺者》	名詞
＠やとわ	《雇われた毒殺者》	名詞
＠やとわれ	《雇われた毒殺者》	名詞
＠やとわれた	《雇われた毒殺者》	名詞
＠やとわれたど	《雇われた毒殺者》	名詞
＠やとわれたどく	《雇われた毒殺者》	名詞
＠やとわれたどくさ	《雇われた毒殺者》	名詞
＠やとわれたどくさつ	《雇われた毒殺者》	名詞
＠やとわれたどくさつし	《雇われた毒殺者》	名詞
＠やとわれたどくさつしゃ	《雇われた毒殺者》	名詞
＠れ	《霊廟の秘密》	名詞
＠れい	《霊廟の秘密》	名詞
＠れいび	《霊廟の秘密》	名詞
＠れいびょ	《霊廟の秘密》	名詞
＠れいびょう	《霊廟の秘密》	名詞
＠れいびょうの	《霊廟の秘密》	名詞
＠れいびょうのひ	《霊廟の秘密》	名詞
＠れいびょうのひみ	《霊廟の秘密》	名詞
＠れいびょうのひみつ	《霊廟の秘密》	名詞
＠ぎ	《霧から見張るもの》	名詞
＠ぎり	《霧から見張るもの》	名詞
＠ぎりか	《霧から見張るもの》	名詞
＠ぎりから	《霧から見張るもの》	名詞
＠ぎりからみ	《霧から見張るもの》	名詞
＠ぎりからみは	《霧から見張るもの》	名詞
＠ぎりからみはる	《霧から見張るもの》	名詞
＠ぎりからみはるも	《霧から見張るもの》	名詞
＠ぎりからみはるもの	《霧から見張るもの》	名詞
＠ぎ	《霧の壁》	名詞
＠ぎり	《霧の壁》	名詞
＠ぎりの	《霧の壁》	名詞
＠ぎりのか	《霧の壁》	名詞
＠ぎりのかべ	《霧の壁》	名詞
＠し	《静かな隠し矢》	名詞
＠しず	《静かな隠し矢》	名詞
＠しずか	《静かな隠し矢》	名詞
＠しずかな	《静かな隠し矢》	名詞
＠しずかなか	《静かな隠し矢》	名詞
＠しずかなかく	《静かな隠し矢》	名詞
＠しずかなかくし	《静かな隠し矢》	名詞
＠しずかなかくしや	《静かな隠し矢》	名詞
＠し	《静める者、エトラータ》	名詞
＠しず	《静める者、エトラータ》	名詞
＠しずめ	《静める者、エトラータ》	名詞
＠しずめる	《静める者、エトラータ》	名詞
＠しずめるも	《静める者、エトラータ》	名詞
＠しずめるもの	《静める者、エトラータ》	名詞
＠しずめるもの、	《静める者、エトラータ》	名詞
＠しずめるもの、え	《静める者、エトラータ》	名詞
＠しずめるもの、えと	《静める者、エトラータ》	名詞
＠しずめるもの、えとら	《静める者、エトラータ》	名詞
＠しずめるもの、えとらー	《静める者、エトラータ》	名詞
＠しずめるもの、えとらーた	《静める者、エトラータ》	名詞
＠せ	《静電場》	名詞
＠せい	《静電場》	名詞
＠せいで	《静電場》	名詞
＠せいでん	《静電場》	名詞
＠せいでんじ	《静電場》	名詞
＠せいでんじょ	《静電場》	名詞
＠せいでんじょう	《静電場》	名詞
＠お	《音波攻撃》	名詞
＠おん	《音波攻撃》	名詞
＠おんぱ	《音波攻撃》	名詞
＠おんぱこ	《音波攻撃》	名詞
＠おんぱこう	《音波攻撃》	名詞
＠おんぱこうげ	《音波攻撃》	名詞
＠おんぱこうげき	《音波攻撃》	名詞
＠ち	《駐屯地の兵長》	名詞
＠ちゅ	《駐屯地の兵長》	名詞
＠ちゅう	《駐屯地の兵長》	名詞
＠ちゅうと	《駐屯地の兵長》	名詞
＠ちゅうとん	《駐屯地の兵長》	名詞
＠ちゅうとんち	《駐屯地の兵長》	名詞
＠ちゅうとんちの	《駐屯地の兵長》	名詞
＠ちゅうとんちのへ	《駐屯地の兵長》	名詞
＠ちゅうとんちのへい	《駐屯地の兵長》	名詞
＠ちゅうとんちのへいち	《駐屯地の兵長》	名詞
＠ちゅうとんちのへいちょ	《駐屯地の兵長》	名詞
＠ちゅうとんちのへいちょう	《駐屯地の兵長》	名詞
＠ほ	《骨の障壁》	名詞
＠ほね	《骨の障壁》	名詞
＠ほねの	《骨の障壁》	名詞
＠ほねのし	《骨の障壁》	名詞
＠ほねのしょ	《骨の障壁》	名詞
＠ほねのしょう	《骨の障壁》	名詞
＠ほねのしょうへ	《骨の障壁》	名詞
＠ほねのしょうへき	《骨の障壁》	名詞
＠こ	《高熱仮説》	名詞
＠こう	《高熱仮説》	名詞
＠こうね	《高熱仮説》	名詞
＠こうねつ	《高熱仮説》	名詞
＠こうねつか	《高熱仮説》	名詞
＠こうねつかせ	《高熱仮説》	名詞
＠こうねつかせつ	《高熱仮説》	名詞
＠せ	《鮮烈な蘇生》	名詞
＠せん	《鮮烈な蘇生》	名詞
＠せんれ	《鮮烈な蘇生》	名詞
＠せんれつ	《鮮烈な蘇生》	名詞
＠せんれつな	《鮮烈な蘇生》	名詞
＠せんれつなそ	《鮮烈な蘇生》	名詞
＠せんれつなそせ	《鮮烈な蘇生》	名詞
＠せんれつなそせい	《鮮烈な蘇生》	名詞
＠こ	《鼓舞する一角獣》	名詞
＠こぶ	《鼓舞する一角獣》	名詞
＠こぶす	《鼓舞する一角獣》	名詞
＠こぶする	《鼓舞する一角獣》	名詞
＠こぶするい	《鼓舞する一角獣》	名詞
＠こぶするいっ	《鼓舞する一角獣》	名詞
＠こぶするいっか	《鼓舞する一角獣》	名詞
＠こぶするいっかく	《鼓舞する一角獣》	名詞
＠こぶするいっかくじ	《鼓舞する一角獣》	名詞
＠こぶするいっかくじゅ	《鼓舞する一角獣》	名詞
＠こぶするいっかくじゅう	《鼓舞する一角獣》	名詞
