＠あ	《アーデンベイルの聖騎士》	名詞
＠あー	《アーデンベイルの聖騎士》	名詞
＠あーで	《アーデンベイルの聖騎士》	名詞
＠あーでん	《アーデンベイルの聖騎士》	名詞
＠あーでんべ	《アーデンベイルの聖騎士》	名詞
＠あーでんべい	《アーデンベイルの聖騎士》	名詞
＠あーでんべいる	《アーデンベイルの聖騎士》	名詞
＠あーでんべいるの	《アーデンベイルの聖騎士》	名詞
＠あーでんべいるのせ	《アーデンベイルの聖騎士》	名詞
＠あーでんべいるのせい	《アーデンベイルの聖騎士》	名詞
＠あーでんべいるのせいき	《アーデンベイルの聖騎士》	名詞
＠あーでんべいるのせいきし	《アーデンベイルの聖騎士》	名詞
＠あ	《アーデンベイルの戦術家》	名詞
＠あー	《アーデンベイルの戦術家》	名詞
＠あーで	《アーデンベイルの戦術家》	名詞
＠あーでん	《アーデンベイルの戦術家》	名詞
＠あーでんべ	《アーデンベイルの戦術家》	名詞
＠あーでんべい	《アーデンベイルの戦術家》	名詞
＠あーでんべいる	《アーデンベイルの戦術家》	名詞
＠あーでんべいるの	《アーデンベイルの戦術家》	名詞
＠あーでんべいるのせ	《アーデンベイルの戦術家》	名詞
＠あーでんべいるのせん	《アーデンベイルの戦術家》	名詞
＠あーでんべいるのせんじ	《アーデンベイルの戦術家》	名詞
＠あーでんべいるのせんじゅ	《アーデンベイルの戦術家》	名詞
＠あーでんべいるのせんじゅつ	《アーデンベイルの戦術家》	名詞
＠あーでんべいるのせんじゅつか	《アーデンベイルの戦術家》	名詞
＠か	《輝く鎧》	名詞
＠かが	《輝く鎧》	名詞
＠かがや	《輝く鎧》	名詞
＠かがやく	《輝く鎧》	名詞
＠かがやくよ	《輝く鎧》	名詞
＠かがやくよろ	《輝く鎧》	名詞
＠かがやくよろい	《輝く鎧》	名詞
＠ぎ	《銀炎の儀式》	名詞
＠ぎん	《銀炎の儀式》	名詞
＠ぎんえ	《銀炎の儀式》	名詞
＠ぎんえん	《銀炎の儀式》	名詞
＠ぎんえんの	《銀炎の儀式》	名詞
＠ぎんえんのぎ	《銀炎の儀式》	名詞
＠ぎんえんのぎし	《銀炎の儀式》	名詞
＠ぎんえんのぎしき	《銀炎の儀式》	名詞
＠ぎ	《銀炎の従者》	名詞
＠ぎん	《銀炎の従者》	名詞
＠ぎんえ	《銀炎の従者》	名詞
＠ぎんえん	《銀炎の従者》	名詞
＠ぎんえんの	《銀炎の従者》	名詞
＠ぎんえんのじ	《銀炎の従者》	名詞
＠ぎんえんのじゅ	《銀炎の従者》	名詞
＠ぎんえんのじゅう	《銀炎の従者》	名詞
＠ぎんえんのじゅうし	《銀炎の従者》	名詞
＠ぎんえんのじゅうしゃ	《銀炎の従者》	名詞
＠こ	《交換される牛》	名詞
＠こう	《交換される牛》	名詞
＠こうか	《交換される牛》	名詞
＠こうかん	《交換される牛》	名詞
＠こうかんさ	《交換される牛》	名詞
＠こうかんされ	《交換される牛》	名詞
＠こうかんされる	《交換される牛》	名詞
＠こうかんされるう	《交換される牛》	名詞
＠こうかんされるうし	《交換される牛》	名詞
＠じ	《若年の騎士》	名詞
＠じゃ	《若年の騎士》	名詞
＠じゃく	《若年の騎士》	名詞
＠じゃくね	《若年の騎士》	名詞
＠じゃくねん	《若年の騎士》	名詞
＠じゃくねんの	《若年の騎士》	名詞
＠じゃくねんのき	《若年の騎士》	名詞
＠じゃくねんのきし	《若年の騎士》	名詞
＠し	《真実の愛の口づけ》	名詞
＠しん	《真実の愛の口づけ》	名詞
＠しんじ	《真実の愛の口づけ》	名詞
＠しんじつ	《真実の愛の口づけ》	名詞
＠しんじつの	《真実の愛の口づけ》	名詞
＠しんじつのあ	《真実の愛の口づけ》	名詞
＠しんじつのあい	《真実の愛の口づけ》	名詞
＠しんじつのあいの	《真実の愛の口づけ》	名詞
＠しんじつのあいのく	《真実の愛の口づけ》	名詞
＠しんじつのあいのくち	《真実の愛の口づけ》	名詞
＠しんじつのあいのくちづ	《真実の愛の口づけ》	名詞
＠しんじつのあいのくちづけ	《真実の愛の口づけ》	名詞
＠け	《敬愛される王女》	名詞
＠けい	《敬愛される王女》	名詞
＠けいあ	《敬愛される王女》	名詞
＠けいあい	《敬愛される王女》	名詞
＠けいあいさ	《敬愛される王女》	名詞
＠けいあいされ	《敬愛される王女》	名詞
＠けいあいされる	《敬愛される王女》	名詞
＠けいあいされるお	《敬愛される王女》	名詞
＠けいあいされるおう	《敬愛される王女》	名詞
＠けいあいされるおうじ	《敬愛される王女》	名詞
＠けいあいされるおうじょ	《敬愛される王女》	名詞
＠だ	《出し抜き》	名詞
＠だし	《出し抜き》	名詞
＠だしぬ	《出し抜き》	名詞
＠だしぬき	《出し抜き》	名詞
＠と	《尊きグリフィン》	名詞
＠とう	《尊きグリフィン》	名詞
＠とうと	《尊きグリフィン》	名詞
＠とうとき	《尊きグリフィン》	名詞
＠とうときぐ	《尊きグリフィン》	名詞
＠とうときぐり	《尊きグリフィン》	名詞
＠とうときぐりふ	《尊きグリフィン》	名詞
＠とうときぐりふぃ	《尊きグリフィン》	名詞
＠とうときぐりふぃん	《尊きグリフィン》	名詞
＠と	《塔への閉じ込め》	名詞
＠とう	《塔への閉じ込め》	名詞
＠とうへ	《塔への閉じ込め》	名詞
＠とうへの	《塔への閉じ込め》	名詞
＠とうへのと	《塔への閉じ込め》	名詞
＠とうへのとじ	《塔への閉じ込め》	名詞
＠とうへのとじこ	《塔への閉じ込め》	名詞
＠とうへのとじこめ	《塔への閉じ込め》	名詞
＠と	《砦の騎士》	名詞
＠とり	《砦の騎士》	名詞
＠とりで	《砦の騎士》	名詞
＠とりでの	《砦の騎士》	名詞
＠とりでのき	《砦の騎士》	名詞
＠とりでのきし	《砦の騎士》	名詞
＠は	《羽ばたき狐》	名詞
＠はば	《羽ばたき狐》	名詞
＠はばた	《羽ばたき狐》	名詞
＠はばたき	《羽ばたき狐》	名詞
＠はばたきき	《羽ばたき狐》	名詞
＠はばたききつ	《羽ばたき狐》	名詞
＠はばたききつね	《羽ばたき狐》	名詞
＠ひ	《独りぼっちのユニコーン》	名詞
＠ひと	《独りぼっちのユニコーン》	名詞
＠ひとり	《独りぼっちのユニコーン》	名詞
＠ひとりぼ	《独りぼっちのユニコーン》	名詞
＠ひとりぼっ	《独りぼっちのユニコーン》	名詞
＠ひとりぼっち	《独りぼっちのユニコーン》	名詞
＠ひとりぼっちの	《独りぼっちのユニコーン》	名詞
＠ひとりぼっちのゆ	《独りぼっちのユニコーン》	名詞
＠ひとりぼっちのゆに	《独りぼっちのユニコーン》	名詞
＠ひとりぼっちのゆにこ	《独りぼっちのユニコーン》	名詞
＠ひとりぼっちのゆにこー	《独りぼっちのユニコーン》	名詞
＠ひとりぼっちのゆにこーん	《独りぼっちのユニコーン》	名詞
＠ふ	《フェアリーの導母》	名詞
＠ふぇ	《フェアリーの導母》	名詞
＠ふぇあ	《フェアリーの導母》	名詞
＠ふぇあり	《フェアリーの導母》	名詞
＠ふぇありー	《フェアリーの導母》	名詞
＠ふぇありーの	《フェアリーの導母》	名詞
＠ふぇありーのし	《フェアリーの導母》	名詞
＠ふぇありーのしる	《フェアリーの導母》	名詞
＠ふぇありーのしるべ	《フェアリーの導母》	名詞
＠ふぇありーのしるべは	《フェアリーの導母》	名詞
＠ふぇありーのしるべはは	《フェアリーの導母》	名詞
＠ろ	《籠城の準備》	名詞
＠ろう	《籠城の準備》	名詞
＠ろうじ	《籠城の準備》	名詞
＠ろうじょ	《籠城の準備》	名詞
＠ろうじょう	《籠城の準備》	名詞
＠ろうじょうの	《籠城の準備》	名詞
＠ろうじょうのじ	《籠城の準備》	名詞
＠ろうじょうのじゅ	《籠城の準備》	名詞
＠ろうじょうのじゅん	《籠城の準備》	名詞
＠ろうじょうのじゅんび	《籠城の準備》	名詞
＠お	《王権のための結集》	名詞
＠おう	《王権のための結集》	名詞
＠おうけ	《王権のための結集》	名詞
＠おうけん	《王権のための結集》	名詞
＠おうけんの	《王権のための結集》	名詞
＠おうけんのた	《王権のための結集》	名詞
＠おうけんのため	《王権のための結集》	名詞
＠おうけんのための	《王権のための結集》	名詞
＠おうけんのためのけ	《王権のための結集》	名詞
＠おうけんのためのけっ	《王権のための結集》	名詞
＠おうけんのためのけっし	《王権のための結集》	名詞
＠おうけんのためのけっしゅ	《王権のための結集》	名詞
＠おうけんのためのけっしゅう	《王権のための結集》	名詞
＠が	《ガラスの棺》	名詞
＠がら	《ガラスの棺》	名詞
＠がらす	《ガラスの棺》	名詞
＠がらすの	《ガラスの棺》	名詞
＠がらすのか	《ガラスの棺》	名詞
＠がらすのかん	《ガラスの棺》	名詞
＠こ	《高潔のあかし》	名詞
＠こう	《高潔のあかし》	名詞
＠こうけ	《高潔のあかし》	名詞
＠こうけつ	《高潔のあかし》	名詞
＠こうけつの	《高潔のあかし》	名詞
＠こうけつのあ	《高潔のあかし》	名詞
＠こうけつのあか	《高潔のあかし》	名詞
＠こうけつのあかし	《高潔のあかし》	名詞
＠き	《きらきらするすべて》	名詞
＠きら	《きらきらするすべて》	名詞
＠きらき	《きらきらするすべて》	名詞
＠きらきら	《きらきらするすべて》	名詞
＠きらきらす	《きらきらするすべて》	名詞
＠きらきらする	《きらきらするすべて》	名詞
＠きらきらするす	《きらきらするすべて》	名詞
＠きらきらするすべ	《きらきらするすべて》	名詞
＠きらきらするすべて	《きらきらするすべて》	名詞
＠し	《獅子の爪、エイリン卿》	名詞
＠しし	《獅子の爪、エイリン卿》	名詞
＠ししの	《獅子の爪、エイリン卿》	名詞
＠ししのつ	《獅子の爪、エイリン卿》	名詞
＠ししのつめ	《獅子の爪、エイリン卿》	名詞
＠ししのつめ、	《獅子の爪、エイリン卿》	名詞
＠ししのつめ、え	《獅子の爪、エイリン卿》	名詞
＠ししのつめ、えい	《獅子の爪、エイリン卿》	名詞
＠ししのつめ、えいり	《獅子の爪、エイリン卿》	名詞
＠ししのつめ、えいりん	《獅子の爪、エイリン卿》	名詞
＠ししのつめ、えいりんき	《獅子の爪、エイリン卿》	名詞
＠ししのつめ、えいりんきょ	《獅子の爪、エイリン卿》	名詞
＠ししのつめ、えいりんきょう	《獅子の爪、エイリン卿》	名詞
＠し	《赦免のアルコン》	名詞
＠しゃ	《赦免のアルコン》	名詞
＠しゃめ	《赦免のアルコン》	名詞
＠しゃめん	《赦免のアルコン》	名詞
＠しゃめんの	《赦免のアルコン》	名詞
＠しゃめんのあ	《赦免のアルコン》	名詞
＠しゃめんのある	《赦免のアルコン》	名詞
＠しゃめんのあるこ	《赦免のアルコン》	名詞
＠しゃめんのあるこん	《赦免のアルコン》	名詞
＠と	《尊い騎士》	名詞
＠とう	《尊い騎士》	名詞
＠とうと	《尊い騎士》	名詞
＠とうとい	《尊い騎士》	名詞
＠とうといき	《尊い騎士》	名詞
＠とうといきし	《尊い騎士》	名詞
＠ふ	《不思議な道照らし》	名詞
＠ふし	《不思議な道照らし》	名詞
＠ふしぎ	《不思議な道照らし》	名詞
＠ふしぎな	《不思議な道照らし》	名詞
＠ふしぎなみ	《不思議な道照らし》	名詞
＠ふしぎなみち	《不思議な道照らし》	名詞
＠ふしぎなみちて	《不思議な道照らし》	名詞
＠ふしぎなみちてら	《不思議な道照らし》	名詞
＠ふしぎなみちてらし	《不思議な道照らし》	名詞
＠み	《耳の痛い静寂》	名詞
＠みみ	《耳の痛い静寂》	名詞
＠みみの	《耳の痛い静寂》	名詞
＠みみのい	《耳の痛い静寂》	名詞
＠みみのいた	《耳の痛い静寂》	名詞
＠みみのいたい	《耳の痛い静寂》	名詞
＠みみのいたいせ	《耳の痛い静寂》	名詞
＠みみのいたいせい	《耳の痛い静寂》	名詞
＠みみのいたいせいじ	《耳の痛い静寂》	名詞
＠みみのいたいせいじゃ	《耳の痛い静寂》	名詞
＠みみのいたいせいじゃく	《耳の痛い静寂》	名詞
＠む	《群れの番人》	名詞
＠むれ	《群れの番人》	名詞
＠むれの	《群れの番人》	名詞
＠むれのば	《群れの番人》	名詞
＠むれのばん	《群れの番人》	名詞
＠むれのばんに	《群れの番人》	名詞
＠むれのばんにん	《群れの番人》	名詞
＠り	《立派な騎士》	名詞
＠りっ	《立派な騎士》	名詞
＠りっぱ	《立派な騎士》	名詞
＠りっぱな	《立派な騎士》	名詞
＠りっぱなき	《立派な騎士》	名詞
＠りっぱなきし	《立派な騎士》	名詞
＠き	《巨人落とし》	名詞
＠きょ	《巨人落とし》	名詞
＠きょじ	《巨人落とし》	名詞
＠きょじん	《巨人落とし》	名詞
＠きょじんお	《巨人落とし》	名詞
＠きょじんおと	《巨人落とし》	名詞
＠きょじんおとし	《巨人落とし》	名詞
＠せ	《静寂をもたらすもの》	名詞
＠せい	《静寂をもたらすもの》	名詞
＠せいじ	《静寂をもたらすもの》	名詞
＠せいじゃ	《静寂をもたらすもの》	名詞
＠せいじゃく	《静寂をもたらすもの》	名詞
＠せいじゃくを	《静寂をもたらすもの》	名詞
＠せいじゃくをも	《静寂をもたらすもの》	名詞
＠せいじゃくをもた	《静寂をもたらすもの》	名詞
＠せいじゃくをもたら	《静寂をもたらすもの》	名詞
＠せいじゃくをもたらす	《静寂をもたらすもの》	名詞
＠せいじゃくをもたらすも	《静寂をもたらすもの》	名詞
＠せいじゃくをもたらすもの	《静寂をもたらすもの》	名詞
＠ひ	《評判高い挑戦者》	名詞
＠ひょ	《評判高い挑戦者》	名詞
＠ひょう	《評判高い挑戦者》	名詞
＠ひょうば	《評判高い挑戦者》	名詞
＠ひょうばん	《評判高い挑戦者》	名詞
＠ひょうばんた	《評判高い挑戦者》	名詞
＠ひょうばんたか	《評判高い挑戦者》	名詞
＠ひょうばんたかい	《評判高い挑戦者》	名詞
＠ひょうばんたかいち	《評判高い挑戦者》	名詞
＠ひょうばんたかいちょ	《評判高い挑戦者》	名詞
＠ひょうばんたかいちょう	《評判高い挑戦者》	名詞
＠ひょうばんたかいちょうせ	《評判高い挑戦者》	名詞
＠ひょうばんたかいちょうせん	《評判高い挑戦者》	名詞
＠ひょうばんたかいちょうせんし	《評判高い挑戦者》	名詞
＠ひょうばんたかいちょうせんしゃ	《評判高い挑戦者》	名詞
＠ふ	《不動の女王、リンデン》	名詞
＠ふど	《不動の女王、リンデン》	名詞
＠ふどう	《不動の女王、リンデン》	名詞
＠ふどうの	《不動の女王、リンデン》	名詞
＠ふどうのじ	《不動の女王、リンデン》	名詞
＠ふどうのじょ	《不動の女王、リンデン》	名詞
＠ふどうのじょお	《不動の女王、リンデン》	名詞
＠ふどうのじょおう	《不動の女王、リンデン》	名詞
＠ふどうのじょおう、	《不動の女王、リンデン》	名詞
＠ふどうのじょおう、り	《不動の女王、リンデン》	名詞
＠ふどうのじょおう、りん	《不動の女王、リンデン》	名詞
＠ふどうのじょおう、りんで	《不動の女王、リンデン》	名詞
＠ふどうのじょおう、りんでん	《不動の女王、リンデン》	名詞
＠み	《魅力的な王子》	名詞
＠みり	《魅力的な王子》	名詞
＠みりょ	《魅力的な王子》	名詞
＠みりょく	《魅力的な王子》	名詞
＠みりょくて	《魅力的な王子》	名詞
＠みりょくてき	《魅力的な王子》	名詞
＠みりょくてきな	《魅力的な王子》	名詞
＠みりょくてきなお	《魅力的な王子》	名詞
＠みりょくてきなおう	《魅力的な王子》	名詞
＠みりょくてきなおうじ	《魅力的な王子》	名詞
＠め	《めでたしめでたし》	名詞
＠めで	《めでたしめでたし》	名詞
＠めでた	《めでたしめでたし》	名詞
＠めでたし	《めでたしめでたし》	名詞
＠めでたしめ	《めでたしめでたし》	名詞
＠めでたしめで	《めでたしめでたし》	名詞
＠めでたしめでた	《めでたしめでたし》	名詞
＠めでたしめでたし	《めでたしめでたし》	名詞
＠お	《王国まといの巨人》	名詞
＠おう	《王国まといの巨人》	名詞
＠おうこ	《王国まといの巨人》	名詞
＠おうこく	《王国まといの巨人》	名詞
＠おうこくま	《王国まといの巨人》	名詞
＠おうこくまと	《王国まといの巨人》	名詞
＠おうこくまとい	《王国まといの巨人》	名詞
＠おうこくまといの	《王国まといの巨人》	名詞
＠おうこくまといのき	《王国まといの巨人》	名詞
＠おうこくまといのきょ	《王国まといの巨人》	名詞
＠おうこくまといのきょじ	《王国まといの巨人》	名詞
＠おうこくまといのきょじん	《王国まといの巨人》	名詞
＠ち	《忠誠の円環》	名詞
＠ちゅ	《忠誠の円環》	名詞
＠ちゅう	《忠誠の円環》	名詞
＠ちゅうせ	《忠誠の円環》	名詞
＠ちゅうせい	《忠誠の円環》	名詞
＠ちゅうせいの	《忠誠の円環》	名詞
＠ちゅうせいのえ	《忠誠の円環》	名詞
＠ちゅうせいのえん	《忠誠の円環》	名詞
＠ちゅうせいのえんか	《忠誠の円環》	名詞
＠ちゅうせいのえんかん	《忠誠の円環》	名詞
＠ち	《調和のアルコン》	名詞
＠ちょ	《調和のアルコン》	名詞
＠ちょう	《調和のアルコン》	名詞
＠ちょうわ	《調和のアルコン》	名詞
＠ちょうわの	《調和のアルコン》	名詞
＠ちょうわのあ	《調和のアルコン》	名詞
＠ちょうわのある	《調和のアルコン》	名詞
＠ちょうわのあるこ	《調和のアルコン》	名詞
＠ちょうわのあるこん	《調和のアルコン》	名詞
＠ヴ	《ヴァントレスの聖騎士》	名詞
＠ヴぁ	《ヴァントレスの聖騎士》	名詞
＠ヴぁん	《ヴァントレスの聖騎士》	名詞
＠ヴぁんと	《ヴァントレスの聖騎士》	名詞
＠ヴぁんとれ	《ヴァントレスの聖騎士》	名詞
＠ヴぁんとれす	《ヴァントレスの聖騎士》	名詞
＠ヴぁんとれすの	《ヴァントレスの聖騎士》	名詞
＠ヴぁんとれすのせ	《ヴァントレスの聖騎士》	名詞
＠ヴぁんとれすのせい	《ヴァントレスの聖騎士》	名詞
＠ヴぁんとれすのせいき	《ヴァントレスの聖騎士》	名詞
＠ヴぁんとれすのせいきし	《ヴァントレスの聖騎士》	名詞
＠き	《極小》	名詞
＠きょ	《極小》	名詞
＠きょく	《極小》	名詞
＠きょくし	《極小》	名詞
＠きょくしょ	《極小》	名詞
＠きょくしょう	《極小》	名詞
＠こ	《氷の女王》	名詞
＠こお	《氷の女王》	名詞
＠こおり	《氷の女王》	名詞
＠こおりの	《氷の女王》	名詞
＠こおりのじ	《氷の女王》	名詞
＠こおりのじょ	《氷の女王》	名詞
＠こおりのじょお	《氷の女王》	名詞
＠こおりのじょおう	《氷の女王》	名詞
＠せ	《切望するマーフォーク》	名詞
＠せつ	《切望するマーフォーク》	名詞
＠せつぼ	《切望するマーフォーク》	名詞
＠せつぼう	《切望するマーフォーク》	名詞
＠せつぼうす	《切望するマーフォーク》	名詞
＠せつぼうする	《切望するマーフォーク》	名詞
＠せつぼうするま	《切望するマーフォーク》	名詞
＠せつぼうするまー	《切望するマーフォーク》	名詞
＠せつぼうするまーふ	《切望するマーフォーク》	名詞
＠せつぼうするまーふぉ	《切望するマーフォーク》	名詞
＠せつぼうするまーふぉー	《切望するマーフォーク》	名詞
＠せつぼうするまーふぉーく	《切望するマーフォーク》	名詞
＠せ	《選択》	名詞
＠せん	《選択》	名詞
＠せんた	《選択》	名詞
＠せんたく	《選択》	名詞
＠ち	《潮流のマントル》	名詞
＠ちょ	《潮流のマントル》	名詞
＠ちょう	《潮流のマントル》	名詞
＠ちょうり	《潮流のマントル》	名詞
＠ちょうりゅ	《潮流のマントル》	名詞
＠ちょうりゅう	《潮流のマントル》	名詞
＠ちょうりゅうの	《潮流のマントル》	名詞
＠ちょうりゅうのま	《潮流のマントル》	名詞
＠ちょうりゅうのまん	《潮流のマントル》	名詞
＠ちょうりゅうのまんと	《潮流のマントル》	名詞
＠ちょうりゅうのまんとる	《潮流のマントル》	名詞
＠つ	《通路の監視者》	名詞
＠つう	《通路の監視者》	名詞
＠つうろ	《通路の監視者》	名詞
＠つうろの	《通路の監視者》	名詞
＠つうろのか	《通路の監視者》	名詞
＠つうろのかん	《通路の監視者》	名詞
＠つうろのかんし	《通路の監視者》	名詞
＠つうろのかんしし	《通路の監視者》	名詞
＠つうろのかんししゃ	《通路の監視者》	名詞
＠つ	《月明かりの掃除屋》	名詞
＠つき	《月明かりの掃除屋》	名詞
＠つきあ	《月明かりの掃除屋》	名詞
＠つきあか	《月明かりの掃除屋》	名詞
＠つきあかり	《月明かりの掃除屋》	名詞
＠つきあかりの	《月明かりの掃除屋》	名詞
＠つきあかりのそ	《月明かりの掃除屋》	名詞
＠つきあかりのそう	《月明かりの掃除屋》	名詞
＠つきあかりのそうじ	《月明かりの掃除屋》	名詞
＠つきあかりのそうじや	《月明かりの掃除屋》	名詞
＠と	《共に逃走》	名詞
＠とも	《共に逃走》	名詞
＠ともに	《共に逃走》	名詞
＠ともにと	《共に逃走》	名詞
＠ともにとう	《共に逃走》	名詞
＠ともにとうそ	《共に逃走》	名詞
＠ともにとうそう	《共に逃走》	名詞
＠は	《鋼睨みのグリフィン》	名詞
＠はが	《鋼睨みのグリフィン》	名詞
＠はがね	《鋼睨みのグリフィン》	名詞
＠はがねに	《鋼睨みのグリフィン》	名詞
＠はがねにら	《鋼睨みのグリフィン》	名詞
＠はがねにらみ	《鋼睨みのグリフィン》	名詞
＠はがねにらみの	《鋼睨みのグリフィン》	名詞
＠はがねにらみのぐ	《鋼睨みのグリフィン》	名詞
＠はがねにらみのぐり	《鋼睨みのグリフィン》	名詞
＠はがねにらみのぐりふ	《鋼睨みのグリフィン》	名詞
＠はがねにらみのぐりふぃ	《鋼睨みのグリフィン》	名詞
＠はがねにらみのぐりふぃん	《鋼睨みのグリフィン》	名詞
＠ひ	《秘本の略奪者》	名詞
＠ひほ	《秘本の略奪者》	名詞
＠ひほん	《秘本の略奪者》	名詞
＠ひほんの	《秘本の略奪者》	名詞
＠ひほんのり	《秘本の略奪者》	名詞
＠ひほんのりゃ	《秘本の略奪者》	名詞
＠ひほんのりゃく	《秘本の略奪者》	名詞
＠ひほんのりゃくだ	《秘本の略奪者》	名詞
＠ひほんのりゃくだつ	《秘本の略奪者》	名詞
＠ひほんのりゃくだつし	《秘本の略奪者》	名詞
＠ひほんのりゃくだつしゃ	《秘本の略奪者》	名詞
＠ふ	《不可解な幻視》	名詞
＠ふか	《不可解な幻視》	名詞
＠ふかか	《不可解な幻視》	名詞
＠ふかかい	《不可解な幻視》	名詞
＠ふかかいな	《不可解な幻視》	名詞
＠ふかかいなげ	《不可解な幻視》	名詞
＠ふかかいなげん	《不可解な幻視》	名詞
＠ふかかいなげんし	《不可解な幻視》	名詞
＠ぶ	《無礼の罰》	名詞
＠ぶれ	《無礼の罰》	名詞
＠ぶれい	《無礼の罰》	名詞
＠ぶれいの	《無礼の罰》	名詞
＠ぶれいのば	《無礼の罰》	名詞
＠ぶれいのばつ	《無礼の罰》	名詞
＠ま	《マーフォークの秘守り》	名詞
＠まー	《マーフォークの秘守り》	名詞
＠まーふ	《マーフォークの秘守り》	名詞
＠まーふぉ	《マーフォークの秘守り》	名詞
＠まーふぉー	《マーフォークの秘守り》	名詞
＠まーふぉーく	《マーフォークの秘守り》	名詞
＠まーふぉーくの	《マーフォークの秘守り》	名詞
＠まーふぉーくのひ	《マーフォークの秘守り》	名詞
＠まーふぉーくのひま	《マーフォークの秘守り》	名詞
＠まーふぉーくのひまも	《マーフォークの秘守り》	名詞
＠まーふぉーくのひまもり	《マーフォークの秘守り》	名詞
＠ま	《魔法の井戸》	名詞
＠まほ	《魔法の井戸》	名詞
＠まほう	《魔法の井戸》	名詞
＠まほうの	《魔法の井戸》	名詞
＠まほうのい	《魔法の井戸》	名詞
＠まほうのいど	《魔法の井戸》	名詞
＠ま	《魔法の眠り》	名詞
＠まほ	《魔法の眠り》	名詞
＠まほう	《魔法の眠り》	名詞
＠まほうの	《魔法の眠り》	名詞
＠まほうのね	《魔法の眠り》	名詞
＠まほうのねむ	《魔法の眠り》	名詞
＠まほうのねむり	《魔法の眠り》	名詞
＠み	《ミストフォードの亀》	名詞
＠みす	《ミストフォードの亀》	名詞
＠みすと	《ミストフォードの亀》	名詞
＠みすとふ	《ミストフォードの亀》	名詞
＠みすとふぉ	《ミストフォードの亀》	名詞
＠みすとふぉー	《ミストフォードの亀》	名詞
＠みすとふぉーど	《ミストフォードの亀》	名詞
＠みすとふぉーどの	《ミストフォードの亀》	名詞
＠みすとふぉーどのか	《ミストフォードの亀》	名詞
＠みすとふぉーどのかめ	《ミストフォードの亀》	名詞
＠あ	《圧倒される弟子》	名詞
＠あっ	《圧倒される弟子》	名詞
＠あっと	《圧倒される弟子》	名詞
＠あっとう	《圧倒される弟子》	名詞
＠あっとうさ	《圧倒される弟子》	名詞
＠あっとうされ	《圧倒される弟子》	名詞
＠あっとうされる	《圧倒される弟子》	名詞
＠あっとうされるで	《圧倒される弟子》	名詞
＠あっとうされるでし	《圧倒される弟子》	名詞
＠う	《動かすフェアリー》	名詞
＠うご	《動かすフェアリー》	名詞
＠うごか	《動かすフェアリー》	名詞
＠うごかす	《動かすフェアリー》	名詞
＠うごかすふ	《動かすフェアリー》	名詞
＠うごかすふぇ	《動かすフェアリー》	名詞
＠うごかすふぇあ	《動かすフェアリー》	名詞
＠うごかすふぇあり	《動かすフェアリー》	名詞
＠うごかすふぇありー	《動かすフェアリー》	名詞
＠か	《蛙化》	名詞
＠かえ	《蛙化》	名詞
＠かえる	《蛙化》	名詞
＠かえるか	《蛙化》	名詞
＠か	《カボチャ変化》	名詞
＠かぼ	《カボチャ変化》	名詞
＠かぼち	《カボチャ変化》	名詞
＠かぼちゃ	《カボチャ変化》	名詞
＠かぼちゃへ	《カボチャ変化》	名詞
＠かぼちゃへん	《カボチャ変化》	名詞
＠かぼちゃへんか	《カボチャ変化》	名詞
＠ぐ	《具眼の主、エレノラ卿》	名詞
＠ぐが	《具眼の主、エレノラ卿》	名詞
＠ぐがん	《具眼の主、エレノラ卿》	名詞
＠ぐがんの	《具眼の主、エレノラ卿》	名詞
＠ぐがんのあ	《具眼の主、エレノラ卿》	名詞
＠ぐがんのある	《具眼の主、エレノラ卿》	名詞
＠ぐがんのあるじ	《具眼の主、エレノラ卿》	名詞
＠ぐがんのあるじ、	《具眼の主、エレノラ卿》	名詞
＠ぐがんのあるじ、え	《具眼の主、エレノラ卿》	名詞
＠ぐがんのあるじ、えれ	《具眼の主、エレノラ卿》	名詞
＠ぐがんのあるじ、えれの	《具眼の主、エレノラ卿》	名詞
＠ぐがんのあるじ、えれのら	《具眼の主、エレノラ卿》	名詞
＠ぐがんのあるじ、えれのらき	《具眼の主、エレノラ卿》	名詞
＠ぐがんのあるじ、えれのらきょ	《具眼の主、エレノラ卿》	名詞
＠ぐがんのあるじ、えれのらきょう	《具眼の主、エレノラ卿》	名詞
＠し	《神秘の論争》	名詞
＠しん	《神秘の論争》	名詞
＠しんぴ	《神秘の論争》	名詞
＠しんぴの	《神秘の論争》	名詞
＠しんぴのろ	《神秘の論争》	名詞
＠しんぴのろん	《神秘の論争》	名詞
＠しんぴのろんそ	《神秘の論争》	名詞
＠しんぴのろんそう	《神秘の論争》	名詞
＠た	《滝の賢者》	名詞
＠たき	《滝の賢者》	名詞
＠たきの	《滝の賢者》	名詞
＠たきのけ	《滝の賢者》	名詞
＠たきのけん	《滝の賢者》	名詞
＠たきのけんじ	《滝の賢者》	名詞
＠たきのけんじゃ	《滝の賢者》	名詞
＠も	《物語への没入》	名詞
＠もの	《物語への没入》	名詞
＠ものが	《物語への没入》	名詞
＠ものがた	《物語への没入》	名詞
＠ものがたり	《物語への没入》	名詞
＠ものがたりへ	《物語への没入》	名詞
＠ものがたりへの	《物語への没入》	名詞
＠ものがたりへのぼ	《物語への没入》	名詞
＠ものがたりへのぼつ	《物語への没入》	名詞
＠ものがたりへのぼつに	《物語への没入》	名詞
＠ものがたりへのぼつにゅ	《物語への没入》	名詞
＠ものがたりへのぼつにゅう	《物語への没入》	名詞
＠ふ	《フェアリーの荒らし屋》	名詞
＠ふぇ	《フェアリーの荒らし屋》	名詞
＠ふぇあ	《フェアリーの荒らし屋》	名詞
＠ふぇあり	《フェアリーの荒らし屋》	名詞
＠ふぇありー	《フェアリーの荒らし屋》	名詞
＠ふぇありーの	《フェアリーの荒らし屋》	名詞
＠ふぇありーのあ	《フェアリーの荒らし屋》	名詞
＠ふぇありーのあら	《フェアリーの荒らし屋》	名詞
＠ふぇありーのあらし	《フェアリーの荒らし屋》	名詞
＠ふぇありーのあらしや	《フェアリーの荒らし屋》	名詞
＠わ	《惑乱スプライト》	名詞
＠わく	《惑乱スプライト》	名詞
＠わくら	《惑乱スプライト》	名詞
＠わくらん	《惑乱スプライト》	名詞
＠わくらんす	《惑乱スプライト》	名詞
＠わくらんすぷ	《惑乱スプライト》	名詞
＠わくらんすぷら	《惑乱スプライト》	名詞
＠わくらんすぷらい	《惑乱スプライト》	名詞
＠わくらんすぷらいと	《惑乱スプライト》	名詞
＠ヴ	《ヴァントレスのガーゴイル》	名詞
＠ヴぁ	《ヴァントレスのガーゴイル》	名詞
＠ヴぁん	《ヴァントレスのガーゴイル》	名詞
＠ヴぁんと	《ヴァントレスのガーゴイル》	名詞
＠ヴぁんとれ	《ヴァントレスのガーゴイル》	名詞
＠ヴぁんとれす	《ヴァントレスのガーゴイル》	名詞
＠ヴぁんとれすの	《ヴァントレスのガーゴイル》	名詞
＠ヴぁんとれすのが	《ヴァントレスのガーゴイル》	名詞
＠ヴぁんとれすのがー	《ヴァントレスのガーゴイル》	名詞
＠ヴぁんとれすのがーご	《ヴァントレスのガーゴイル》	名詞
＠ヴぁんとれすのがーごい	《ヴァントレスのガーゴイル》	名詞
＠ヴぁんとれすのがーごいる	《ヴァントレスのガーゴイル》	名詞
＠お	《老いたる者、ガドウィック》	名詞
＠おい	《老いたる者、ガドウィック》	名詞
＠おいた	《老いたる者、ガドウィック》	名詞
＠おいたる	《老いたる者、ガドウィック》	名詞
＠おいたるも	《老いたる者、ガドウィック》	名詞
＠おいたるもの	《老いたる者、ガドウィック》	名詞
＠おいたるもの、	《老いたる者、ガドウィック》	名詞
＠おいたるもの、が	《老いたる者、ガドウィック》	名詞
＠おいたるもの、がど	《老いたる者、ガドウィック》	名詞
＠おいたるもの、がどう	《老いたる者、ガドウィック》	名詞
＠おいたるもの、がどうぃ	《老いたる者、ガドウィック》	名詞
＠おいたるもの、がどうぃっ	《老いたる者、ガドウィック》	名詞
＠おいたるもの、がどうぃっく	《老いたる者、ガドウィック》	名詞
＠か	《鏡細工》	名詞
＠かが	《鏡細工》	名詞
＠かがみ	《鏡細工》	名詞
＠かがみさ	《鏡細工》	名詞
＠かがみさい	《鏡細工》	名詞
＠かがみさいく	《鏡細工》	名詞
＠く	《空想の書物》	名詞
＠くう	《空想の書物》	名詞
＠くうそ	《空想の書物》	名詞
＠くうそう	《空想の書物》	名詞
＠くうそうの	《空想の書物》	名詞
＠くうそうのし	《空想の書物》	名詞
＠くうそうのしょ	《空想の書物》	名詞
＠くうそうのしょも	《空想の書物》	名詞
＠くうそうのしょもつ	《空想の書物》	名詞
＠ね	《願いのフェイ》	名詞
＠ねが	《願いのフェイ》	名詞
＠ねがい	《願いのフェイ》	名詞
＠ねがいの	《願いのフェイ》	名詞
＠ねがいのふ	《願いのフェイ》	名詞
＠ねがいのふぇ	《願いのフェイ》	名詞
＠ねがいのふぇい	《願いのフェイ》	名詞
＠ふ	《フェイ隠し》	名詞
＠ふぇ	《フェイ隠し》	名詞
＠ふぇい	《フェイ隠し》	名詞
＠ふぇいか	《フェイ隠し》	名詞
＠ふぇいかく	《フェイ隠し》	名詞
＠ふぇいかくし	《フェイ隠し》	名詞
＠ま	《真夜中の時計》	名詞
＠まよ	《真夜中の時計》	名詞
＠まよな	《真夜中の時計》	名詞
＠まよなか	《真夜中の時計》	名詞
＠まよなかの	《真夜中の時計》	名詞
＠まよなかのと	《真夜中の時計》	名詞
＠まよなかのとけ	《真夜中の時計》	名詞
＠まよなかのとけい	《真夜中の時計》	名詞
＠み	《湖に潜む者、エムリー》	名詞
＠みず	《湖に潜む者、エムリー》	名詞
＠みずう	《湖に潜む者、エムリー》	名詞
＠みずうみ	《湖に潜む者、エムリー》	名詞
＠みずうみに	《湖に潜む者、エムリー》	名詞
＠みずうみにひ	《湖に潜む者、エムリー》	名詞
＠みずうみにひそ	《湖に潜む者、エムリー》	名詞
＠みずうみにひそむ	《湖に潜む者、エムリー》	名詞
＠みずうみにひそむも	《湖に潜む者、エムリー》	名詞
＠みずうみにひそむもの	《湖に潜む者、エムリー》	名詞
＠みずうみにひそむもの、	《湖に潜む者、エムリー》	名詞
＠みずうみにひそむもの、え	《湖に潜む者、エムリー》	名詞
＠みずうみにひそむもの、えむ	《湖に潜む者、エムリー》	名詞
＠みずうみにひそむもの、えむり	《湖に潜む者、エムリー》	名詞
＠みずうみにひそむもの、えむりー	《湖に潜む者、エムリー》	名詞
＠あ	《厚かましい借り手》	名詞
＠あつ	《厚かましい借り手》	名詞
＠あつか	《厚かましい借り手》	名詞
＠あつかま	《厚かましい借り手》	名詞
＠あつかまし	《厚かましい借り手》	名詞
＠あつかましい	《厚かましい借り手》	名詞
＠あつかましいか	《厚かましい借り手》	名詞
＠あつかましいかり	《厚かましい借り手》	名詞
＠あつかましいかりて	《厚かましい借り手》	名詞
＠ま	《魔法の鏡》	名詞
＠まほ	《魔法の鏡》	名詞
＠まほう	《魔法の鏡》	名詞
＠まほうの	《魔法の鏡》	名詞
＠まほうのか	《魔法の鏡》	名詞
＠まほうのかが	《魔法の鏡》	名詞
＠まほうのかがみ	《魔法の鏡》	名詞
＠い	《意地悪な後見人》	名詞
＠いじ	《意地悪な後見人》	名詞
＠いじわ	《意地悪な後見人》	名詞
＠いじわる	《意地悪な後見人》	名詞
＠いじわるな	《意地悪な後見人》	名詞
＠いじわるなこ	《意地悪な後見人》	名詞
＠いじわるなこう	《意地悪な後見人》	名詞
＠いじわるなこうけ	《意地悪な後見人》	名詞
＠いじわるなこうけん	《意地悪な後見人》	名詞
＠いじわるなこうけんに	《意地悪な後見人》	名詞
＠いじわるなこうけんにん	《意地悪な後見人》	名詞
＠い	《茨の鞭撃ち》	名詞
＠いば	《茨の鞭撃ち》	名詞
＠いばら	《茨の鞭撃ち》	名詞
＠いばらの	《茨の鞭撃ち》	名詞
＠いばらのむ	《茨の鞭撃ち》	名詞
＠いばらのむち	《茨の鞭撃ち》	名詞
＠いばらのむちう	《茨の鞭撃ち》	名詞
＠いばらのむちうち	《茨の鞭撃ち》	名詞
＠う	《失われた軍団》	名詞
＠うし	《失われた軍団》	名詞
＠うしな	《失われた軍団》	名詞
＠うしなわ	《失われた軍団》	名詞
＠うしなわれ	《失われた軍団》	名詞
＠うしなわれた	《失われた軍団》	名詞
＠うしなわれたぐ	《失われた軍団》	名詞
＠うしなわれたぐん	《失われた軍団》	名詞
＠うしなわれたぐんだ	《失われた軍団》	名詞
＠うしなわれたぐんだん	《失われた軍団》	名詞
＠え	《永遠の若さ》	名詞
＠えい	《永遠の若さ》	名詞
＠えいえ	《永遠の若さ》	名詞
＠えいえん	《永遠の若さ》	名詞
＠えいえんの	《永遠の若さ》	名詞
＠えいえんのわ	《永遠の若さ》	名詞
＠えいえんのわか	《永遠の若さ》	名詞
＠えいえんのわかさ	《永遠の若さ》	名詞
＠き	《記憶盗み》	名詞
＠きお	《記憶盗み》	名詞
＠きおく	《記憶盗み》	名詞
＠きおくぬ	《記憶盗み》	名詞
＠きおくぬす	《記憶盗み》	名詞
＠きおくぬすみ	《記憶盗み》	名詞
＠き	《凶兆の果実》	名詞
＠きょ	《凶兆の果実》	名詞
＠きょう	《凶兆の果実》	名詞
＠きょうち	《凶兆の果実》	名詞
＠きょうちょ	《凶兆の果実》	名詞
＠きょうちょう	《凶兆の果実》	名詞
＠きょうちょうの	《凶兆の果実》	名詞
＠きょうちょうのか	《凶兆の果実》	名詞
＠きょうちょうのかじ	《凶兆の果実》	名詞
＠きょうちょうのかじつ	《凶兆の果実》	名詞
＠き	《巨人の串》	名詞
＠きょ	《巨人の串》	名詞
＠きょじ	《巨人の串》	名詞
＠きょじん	《巨人の串》	名詞
＠きょじんの	《巨人の串》	名詞
＠きょじんのく	《巨人の串》	名詞
＠きょじんのくし	《巨人の串》	名詞
＠こ	《恋に落ちた剣士》	名詞
＠こい	《恋に落ちた剣士》	名詞
＠こいに	《恋に落ちた剣士》	名詞
＠こいにお	《恋に落ちた剣士》	名詞
＠こいにおち	《恋に落ちた剣士》	名詞
＠こいにおちた	《恋に落ちた剣士》	名詞
＠こいにおちたけ	《恋に落ちた剣士》	名詞
＠こいにおちたけん	《恋に落ちた剣士》	名詞
＠こいにおちたけんし	《恋に落ちた剣士》	名詞
＠い	《誘いの魔女》	名詞
＠いざ	《誘いの魔女》	名詞
＠いざな	《誘いの魔女》	名詞
＠いざない	《誘いの魔女》	名詞
＠いざないの	《誘いの魔女》	名詞
＠いざないのま	《誘いの魔女》	名詞
＠いざないのまじ	《誘いの魔女》	名詞
＠いざないのまじょ	《誘いの魔女》	名詞
＠じ	《邪悪な貴族》	名詞
＠じゃ	《邪悪な貴族》	名詞
＠じゃあ	《邪悪な貴族》	名詞
＠じゃあく	《邪悪な貴族》	名詞
＠じゃあくな	《邪悪な貴族》	名詞
＠じゃあくなき	《邪悪な貴族》	名詞
＠じゃあくなきぞ	《邪悪な貴族》	名詞
＠じゃあくなきぞく	《邪悪な貴族》	名詞
＠た	《魂裂き》	名詞
＠たま	《魂裂き》	名詞
＠たまし	《魂裂き》	名詞
＠たましい	《魂裂き》	名詞
＠たましいさ	《魂裂き》	名詞
＠たましいさき	《魂裂き》	名詞
＠ぱ	《パイ包み》	名詞
＠ぱい	《パイ包み》	名詞
＠ぱいづ	《パイ包み》	名詞
＠ぱいづつ	《パイ包み》	名詞
＠ぱいづつみ	《パイ包み》	名詞
＠は	《華やかな葬送》	名詞
＠はな	《華やかな葬送》	名詞
＠はなや	《華やかな葬送》	名詞
＠はなやか	《華やかな葬送》	名詞
＠はなやかな	《華やかな葬送》	名詞
＠はなやかなそ	《華やかな葬送》	名詞
＠はなやかなそう	《華やかな葬送》	名詞
＠はなやかなそうそ	《華やかな葬送》	名詞
＠はなやかなそうそう	《華やかな葬送》	名詞
＠ふ	《墳丘の魔女》	名詞
＠ふん	《墳丘の魔女》	名詞
＠ふんき	《墳丘の魔女》	名詞
＠ふんきゅ	《墳丘の魔女》	名詞
＠ふんきゅう	《墳丘の魔女》	名詞
＠ふんきゅうの	《墳丘の魔女》	名詞
＠ふんきゅうのま	《墳丘の魔女》	名詞
＠ふんきゅうのまじ	《墳丘の魔女》	名詞
＠ふんきゅうのまじょ	《墳丘の魔女》	名詞
＠め	《目玉収集家》	名詞
＠めだ	《目玉収集家》	名詞
＠めだま	《目玉収集家》	名詞
＠めだまし	《目玉収集家》	名詞
＠めだましゅ	《目玉収集家》	名詞
＠めだましゅう	《目玉収集家》	名詞
＠めだましゅうし	《目玉収集家》	名詞
＠めだましゅうしゅ	《目玉収集家》	名詞
＠めだましゅうしゅう	《目玉収集家》	名詞
＠めだましゅうしゅうか	《目玉収集家》	名詞
＠よ	《夜の死神》	名詞
＠よる	《夜の死神》	名詞
＠よるの	《夜の死神》	名詞
＠よるのし	《夜の死神》	名詞
＠よるのしに	《夜の死神》	名詞
＠よるのしにが	《夜の死神》	名詞
＠よるのしにがみ	《夜の死神》	名詞
＠ろ	《ロークスワインの聖騎士》	名詞
＠ろー	《ロークスワインの聖騎士》	名詞
＠ろーく	《ロークスワインの聖騎士》	名詞
＠ろーくす	《ロークスワインの聖騎士》	名詞
＠ろーくすわ	《ロークスワインの聖騎士》	名詞
＠ろーくすわい	《ロークスワインの聖騎士》	名詞
＠ろーくすわいん	《ロークスワインの聖騎士》	名詞
＠ろーくすわいんの	《ロークスワインの聖騎士》	名詞
＠ろーくすわいんのせ	《ロークスワインの聖騎士》	名詞
＠ろーくすわいんのせい	《ロークスワインの聖騎士》	名詞
＠ろーくすわいんのせいき	《ロークスワインの聖騎士》	名詞
＠ろーくすわいんのせいきし	《ロークスワインの聖騎士》	名詞
＠お	《大釜の贈り物》	名詞
＠おお	《大釜の贈り物》	名詞
＠おおか	《大釜の贈り物》	名詞
＠おおかま	《大釜の贈り物》	名詞
＠おおかまの	《大釜の贈り物》	名詞
＠おおかまのお	《大釜の贈り物》	名詞
＠おおかまのおく	《大釜の贈り物》	名詞
＠おおかまのおくり	《大釜の贈り物》	名詞
＠おおかまのおくりも	《大釜の贈り物》	名詞
＠おおかまのおくりもの	《大釜の贈り物》	名詞
＠お	《大釜の使い魔》	名詞
＠おお	《大釜の使い魔》	名詞
＠おおか	《大釜の使い魔》	名詞
＠おおかま	《大釜の使い魔》	名詞
＠おおかまの	《大釜の使い魔》	名詞
＠おおかまのつ	《大釜の使い魔》	名詞
＠おおかまのつか	《大釜の使い魔》	名詞
＠おおかまのつかい	《大釜の使い魔》	名詞
＠おおかまのつかいま	《大釜の使い魔》	名詞
＠か	《カラスの仕返し》	名詞
＠から	《カラスの仕返し》	名詞
＠からす	《カラスの仕返し》	名詞
＠からすの	《カラスの仕返し》	名詞
＠からすのし	《カラスの仕返し》	名詞
＠からすのしか	《カラスの仕返し》	名詞
＠からすのしかえ	《カラスの仕返し》	名詞
＠からすのしかえし	《カラスの仕返し》	名詞
＠け	《穢れ沼の騎士》	名詞
＠けが	《穢れ沼の騎士》	名詞
＠けがれ	《穢れ沼の騎士》	名詞
＠けがれぬ	《穢れ沼の騎士》	名詞
＠けがれぬま	《穢れ沼の騎士》	名詞
＠けがれぬまの	《穢れ沼の騎士》	名詞
＠けがれぬまのき	《穢れ沼の騎士》	名詞
＠けがれぬまのきし	《穢れ沼の騎士》	名詞
＠げ	《厳格な者、コンラッド卿》	名詞
＠げん	《厳格な者、コンラッド卿》	名詞
＠げんか	《厳格な者、コンラッド卿》	名詞
＠げんかく	《厳格な者、コンラッド卿》	名詞
＠げんかくな	《厳格な者、コンラッド卿》	名詞
＠げんかくなも	《厳格な者、コンラッド卿》	名詞
＠げんかくなもの	《厳格な者、コンラッド卿》	名詞
＠げんかくなもの、	《厳格な者、コンラッド卿》	名詞
＠げんかくなもの、こ	《厳格な者、コンラッド卿》	名詞
＠げんかくなもの、こん	《厳格な者、コンラッド卿》	名詞
＠げんかくなもの、こんら	《厳格な者、コンラッド卿》	名詞
＠げんかくなもの、こんらっ	《厳格な者、コンラッド卿》	名詞
＠げんかくなもの、こんらっど	《厳格な者、コンラッド卿》	名詞
＠げんかくなもの、こんらっどき	《厳格な者、コンラッド卿》	名詞
＠げんかくなもの、こんらっどきょ	《厳格な者、コンラッド卿》	名詞
＠げんかくなもの、こんらっどきょう	《厳格な者、コンラッド卿》	名詞
＠し	《死霊の金切り声》	名詞
＠しり	《死霊の金切り声》	名詞
＠しりょ	《死霊の金切り声》	名詞
＠しりょう	《死霊の金切り声》	名詞
＠しりょうの	《死霊の金切り声》	名詞
＠しりょうのか	《死霊の金切り声》	名詞
＠しりょうのかな	《死霊の金切り声》	名詞
＠しりょうのかなき	《死霊の金切り声》	名詞
＠しりょうのかなきり	《死霊の金切り声》	名詞
＠しりょうのかなきりご	《死霊の金切り声》	名詞
＠しりょうのかなきりごえ	《死霊の金切り声》	名詞
＠そ	《壮大な破滅》	名詞
＠そう	《壮大な破滅》	名詞
＠そうだ	《壮大な破滅》	名詞
＠そうだい	《壮大な破滅》	名詞
＠そうだいな	《壮大な破滅》	名詞
＠そうだいなは	《壮大な破滅》	名詞
＠そうだいなはめ	《壮大な破滅》	名詞
＠そうだいなはめつ	《壮大な破滅》	名詞
＠ぬ	《沼のいたずら好き》	名詞
＠ぬま	《沼のいたずら好き》	名詞
＠ぬまの	《沼のいたずら好き》	名詞
＠ぬまのい	《沼のいたずら好き》	名詞
＠ぬまのいた	《沼のいたずら好き》	名詞
＠ぬまのいたず	《沼のいたずら好き》	名詞
＠ぬまのいたずら	《沼のいたずら好き》	名詞
＠ぬまのいたずらず	《沼のいたずら好き》	名詞
＠ぬまのいたずらずき	《沼のいたずら好き》	名詞
＠ま	《真夜中の騎士団》	名詞
＠まよ	《真夜中の騎士団》	名詞
＠まよな	《真夜中の騎士団》	名詞
＠まよなか	《真夜中の騎士団》	名詞
＠まよなかの	《真夜中の騎士団》	名詞
＠まよなかのき	《真夜中の騎士団》	名詞
＠まよなかのきし	《真夜中の騎士団》	名詞
＠まよなかのきしだ	《真夜中の騎士団》	名詞
＠まよなかのきしだん	《真夜中の騎士団》	名詞
＠ら	《乱闘の華》	名詞
＠らん	《乱闘の華》	名詞
＠らんと	《乱闘の華》	名詞
＠らんとう	《乱闘の華》	名詞
＠らんとうの	《乱闘の華》	名詞
＠らんとうのは	《乱闘の華》	名詞
＠らんとうのはな	《乱闘の華》	名詞
＠か	《カタカタ橋のトロール》	名詞
＠かた	《カタカタ橋のトロール》	名詞
＠かたか	《カタカタ橋のトロール》	名詞
＠かたかた	《カタカタ橋のトロール》	名詞
＠かたかたば	《カタカタ橋のトロール》	名詞
＠かたかたばし	《カタカタ橋のトロール》	名詞
＠かたかたばしの	《カタカタ橋のトロール》	名詞
＠かたかたばしのと	《カタカタ橋のトロール》	名詞
＠かたかたばしのとろ	《カタカタ橋のトロール》	名詞
＠かたかたばしのとろー	《カタカタ橋のトロール》	名詞
＠かたかたばしのとろーる	《カタカタ橋のトロール》	名詞
＠ぐ	《黒槍の模範》	名詞
＠ぐろ	《黒槍の模範》	名詞
＠ぐろや	《黒槍の模範》	名詞
＠ぐろやり	《黒槍の模範》	名詞
＠ぐろやりの	《黒槍の模範》	名詞
＠ぐろやりのも	《黒槍の模範》	名詞
＠ぐろやりのもは	《黒槍の模範》	名詞
＠ぐろやりのもはん	《黒槍の模範》	名詞
＠ざ	《残忍な騎士》	名詞
＠ざん	《残忍な騎士》	名詞
＠ざんに	《残忍な騎士》	名詞
＠ざんにん	《残忍な騎士》	名詞
＠ざんにんな	《残忍な騎士》	名詞
＠ざんにんなき	《残忍な騎士》	名詞
＠ざんにんなきし	《残忍な騎士》	名詞
＠ち	《誓いを立てた騎士》	名詞
＠ちか	《誓いを立てた騎士》	名詞
＠ちかい	《誓いを立てた騎士》	名詞
＠ちかいを	《誓いを立てた騎士》	名詞
＠ちかいをた	《誓いを立てた騎士》	名詞
＠ちかいをたて	《誓いを立てた騎士》	名詞
＠ちかいをたてた	《誓いを立てた騎士》	名詞
＠ちかいをたてたき	《誓いを立てた騎士》	名詞
＠ちかいをたてたきし	《誓いを立てた騎士》	名詞
＠ね	《願い爪のタリスマン》	名詞
＠ねが	《願い爪のタリスマン》	名詞
＠ねがい	《願い爪のタリスマン》	名詞
＠ねがいづ	《願い爪のタリスマン》	名詞
＠ねがいづめ	《願い爪のタリスマン》	名詞
＠ねがいづめの	《願い爪のタリスマン》	名詞
＠ねがいづめのた	《願い爪のタリスマン》	名詞
＠ねがいづめのたり	《願い爪のタリスマン》	名詞
＠ねがいづめのたりす	《願い爪のタリスマン》	名詞
＠ねがいづめのたりすま	《願い爪のタリスマン》	名詞
＠ねがいづめのたりすまん	《願い爪のタリスマン》	名詞
＠ま	《魔女の復讐》	名詞
＠まじ	《魔女の復讐》	名詞
＠まじょ	《魔女の復讐》	名詞
＠まじょの	《魔女の復讐》	名詞
＠まじょのふ	《魔女の復讐》	名詞
＠まじょのふく	《魔女の復讐》	名詞
＠まじょのふくし	《魔女の復讐》	名詞
＠まじょのふくしゅ	《魔女の復讐》	名詞
＠まじょのふくしゅう	《魔女の復讐》	名詞
＠む	《群れの笛吹き男》	名詞
＠むれ	《群れの笛吹き男》	名詞
＠むれの	《群れの笛吹き男》	名詞
＠むれのふ	《群れの笛吹き男》	名詞
＠むれのふえ	《群れの笛吹き男》	名詞
＠むれのふえふ	《群れの笛吹き男》	名詞
＠むれのふえふき	《群れの笛吹き男》	名詞
＠むれのふえふきお	《群れの笛吹き男》	名詞
＠むれのふえふきおと	《群れの笛吹き男》	名詞
＠むれのふえふきおとこ	《群れの笛吹き男》	名詞
＠ろ	《ロークスワインの元首、アヤーラ》	名詞
＠ろー	《ロークスワインの元首、アヤーラ》	名詞
＠ろーく	《ロークスワインの元首、アヤーラ》	名詞
＠ろーくす	《ロークスワインの元首、アヤーラ》	名詞
＠ろーくすわ	《ロークスワインの元首、アヤーラ》	名詞
＠ろーくすわい	《ロークスワインの元首、アヤーラ》	名詞
＠ろーくすわいん	《ロークスワインの元首、アヤーラ》	名詞
＠ろーくすわいんの	《ロークスワインの元首、アヤーラ》	名詞
＠ろーくすわいんのげ	《ロークスワインの元首、アヤーラ》	名詞
＠ろーくすわいんのげん	《ロークスワインの元首、アヤーラ》	名詞
＠ろーくすわいんのげんし	《ロークスワインの元首、アヤーラ》	名詞
＠ろーくすわいんのげんしゅ	《ロークスワインの元首、アヤーラ》	名詞
＠ろーくすわいんのげんしゅ、	《ロークスワインの元首、アヤーラ》	名詞
＠ろーくすわいんのげんしゅ、あ	《ロークスワインの元首、アヤーラ》	名詞
＠ろーくすわいんのげんしゅ、あや	《ロークスワインの元首、アヤーラ》	名詞
＠ろーくすわいんのげんしゅ、あやー	《ロークスワインの元首、アヤーラ》	名詞
＠ろーくすわいんのげんしゅ、あやーら	《ロークスワインの元首、アヤーラ》	名詞
＠え	《永遠の大釜》	名詞
＠えい	《永遠の大釜》	名詞
＠えいえ	《永遠の大釜》	名詞
＠えいえん	《永遠の大釜》	名詞
＠えいえんの	《永遠の大釜》	名詞
＠えいえんのお	《永遠の大釜》	名詞
＠えいえんのおお	《永遠の大釜》	名詞
＠えいえんのおおか	《永遠の大釜》	名詞
＠えいえんのおおかま	《永遠の大釜》	名詞
＠わ	《悪ふざけの名人、ランクル》	名詞
＠わる	《悪ふざけの名人、ランクル》	名詞
＠わるふ	《悪ふざけの名人、ランクル》	名詞
＠わるふざ	《悪ふざけの名人、ランクル》	名詞
＠わるふざけ	《悪ふざけの名人、ランクル》	名詞
＠わるふざけの	《悪ふざけの名人、ランクル》	名詞
＠わるふざけのめ	《悪ふざけの名人、ランクル》	名詞
＠わるふざけのめい	《悪ふざけの名人、ランクル》	名詞
＠わるふざけのめいじ	《悪ふざけの名人、ランクル》	名詞
＠わるふざけのめいじん	《悪ふざけの名人、ランクル》	名詞
＠わるふざけのめいじん、	《悪ふざけの名人、ランクル》	名詞
＠わるふざけのめいじん、ら	《悪ふざけの名人、ランクル》	名詞
＠わるふざけのめいじん、らん	《悪ふざけの名人、ランクル》	名詞
＠わるふざけのめいじん、らんく	《悪ふざけの名人、ランクル》	名詞
＠わるふざけのめいじん、らんくる	《悪ふざけの名人、ランクル》	名詞
＠い	《家の吹き飛ばし》	名詞
＠いえ	《家の吹き飛ばし》	名詞
＠いえの	《家の吹き飛ばし》	名詞
＠いえのふ	《家の吹き飛ばし》	名詞
＠いえのふき	《家の吹き飛ばし》	名詞
＠いえのふきと	《家の吹き飛ばし》	名詞
＠いえのふきとば	《家の吹き飛ばし》	名詞
＠いえのふきとばし	《家の吹き飛ばし》	名詞
＠い	《硫黄投石器》	名詞
＠いお	《硫黄投石器》	名詞
＠いおう	《硫黄投石器》	名詞
＠いおうと	《硫黄投石器》	名詞
＠いおうとう	《硫黄投石器》	名詞
＠いおうとうせ	《硫黄投石器》	名詞
＠いおうとうせっ	《硫黄投石器》	名詞
＠いおうとうせっき	《硫黄投石器》	名詞
＠い	《怒り狂うレッドキャップ》	名詞
＠いか	《怒り狂うレッドキャップ》	名詞
＠いかり	《怒り狂うレッドキャップ》	名詞
＠いかりく	《怒り狂うレッドキャップ》	名詞
＠いかりくる	《怒り狂うレッドキャップ》	名詞
＠いかりくるう	《怒り狂うレッドキャップ》	名詞
＠いかりくるうれ	《怒り狂うレッドキャップ》	名詞
＠いかりくるうれっ	《怒り狂うレッドキャップ》	名詞
＠いかりくるうれっど	《怒り狂うレッドキャップ》	名詞
＠いかりくるうれっどき	《怒り狂うレッドキャップ》	名詞
＠いかりくるうれっどきゃ	《怒り狂うレッドキャップ》	名詞
＠いかりくるうれっどきゃっ	《怒り狂うレッドキャップ》	名詞
＠いかりくるうれっどきゃっぷ	《怒り狂うレッドキャップ》	名詞
＠い	《イタチ乗りのレッドキャップ》	名詞
＠いた	《イタチ乗りのレッドキャップ》	名詞
＠いたち	《イタチ乗りのレッドキャップ》	名詞
＠いたちの	《イタチ乗りのレッドキャップ》	名詞
＠いたちのり	《イタチ乗りのレッドキャップ》	名詞
＠いたちのりの	《イタチ乗りのレッドキャップ》	名詞
＠いたちのりのれ	《イタチ乗りのレッドキャップ》	名詞
＠いたちのりのれっ	《イタチ乗りのレッドキャップ》	名詞
＠いたちのりのれっど	《イタチ乗りのレッドキャップ》	名詞
＠いたちのりのれっどき	《イタチ乗りのレッドキャップ》	名詞
＠いたちのりのれっどきゃ	《イタチ乗りのレッドキャップ》	名詞
＠いたちのりのれっどきゃっ	《イタチ乗りのレッドキャップ》	名詞
＠いたちのりのれっどきゃっぷ	《イタチ乗りのレッドキャップ》	名詞
＠え	《エンバレスの聖騎士》	名詞
＠えん	《エンバレスの聖騎士》	名詞
＠えんば	《エンバレスの聖騎士》	名詞
＠えんばれ	《エンバレスの聖騎士》	名詞
＠えんばれす	《エンバレスの聖騎士》	名詞
＠えんばれすの	《エンバレスの聖騎士》	名詞
＠えんばれすのせ	《エンバレスの聖騎士》	名詞
＠えんばれすのせい	《エンバレスの聖騎士》	名詞
＠えんばれすのせいき	《エンバレスの聖騎士》	名詞
＠えんばれすのせいきし	《エンバレスの聖騎士》	名詞
＠お	《オーガの放浪騎士》	名詞
＠おー	《オーガの放浪騎士》	名詞
＠おーが	《オーガの放浪騎士》	名詞
＠おーがの	《オーガの放浪騎士》	名詞
＠おーがのほ	《オーガの放浪騎士》	名詞
＠おーがのほう	《オーガの放浪騎士》	名詞
＠おーがのほうろ	《オーガの放浪騎士》	名詞
＠おーがのほうろう	《オーガの放浪騎士》	名詞
＠おーがのほうろうき	《オーガの放浪騎士》	名詞
＠おーがのほうろうきし	《オーガの放浪騎士》	名詞
＠し	《焼尽の連射》	名詞
＠しょ	《焼尽の連射》	名詞
＠しょう	《焼尽の連射》	名詞
＠しょうじ	《焼尽の連射》	名詞
＠しょうじん	《焼尽の連射》	名詞
＠しょうじんの	《焼尽の連射》	名詞
＠しょうじんのれ	《焼尽の連射》	名詞
＠しょうじんのれん	《焼尽の連射》	名詞
＠しょうじんのれんし	《焼尽の連射》	名詞
＠しょうじんのれんしゃ	《焼尽の連射》	名詞
＠す	《水晶の靴》	名詞
＠すい	《水晶の靴》	名詞
＠すいし	《水晶の靴》	名詞
＠すいしょ	《水晶の靴》	名詞
＠すいしょう	《水晶の靴》	名詞
＠すいしょうの	《水晶の靴》	名詞
＠すいしょうのく	《水晶の靴》	名詞
＠すいしょうのくつ	《水晶の靴》	名詞
＠し	《焦熱の竜火》	名詞
＠しょ	《焦熱の竜火》	名詞
＠しょう	《焦熱の竜火》	名詞
＠しょうね	《焦熱の竜火》	名詞
＠しょうねつ	《焦熱の竜火》	名詞
＠しょうねつの	《焦熱の竜火》	名詞
＠しょうねつのり	《焦熱の竜火》	名詞
＠しょうねつのりゅ	《焦熱の竜火》	名詞
＠しょうねつのりゅう	《焦熱の竜火》	名詞
＠しょうねつのりゅうひ	《焦熱の竜火》	名詞
＠ち	《血霞のクズリ》	名詞
＠ちが	《血霞のクズリ》	名詞
＠ちがす	《血霞のクズリ》	名詞
＠ちがすみ	《血霞のクズリ》	名詞
＠ちがすみの	《血霞のクズリ》	名詞
＠ちがすみのく	《血霞のクズリ》	名詞
＠ちがすみのくず	《血霞のクズリ》	名詞
＠ちがすみのくずり	《血霞のクズリ》	名詞
＠つ	《突き破り》	名詞
＠つき	《突き破り》	名詞
＠つきや	《突き破り》	名詞
＠つきやぶ	《突き破り》	名詞
＠つきやぶり	《突き破り》	名詞
＠だ	《谷の商人》	名詞
＠だに	《谷の商人》	名詞
＠だにの	《谷の商人》	名詞
＠だにのし	《谷の商人》	名詞
＠だにのしょ	《谷の商人》	名詞
＠だにのしょう	《谷の商人》	名詞
＠だにのしょうに	《谷の商人》	名詞
＠だにのしょうにん	《谷の商人》	名詞
＠な	《投げ飛ばし》	名詞
＠なげ	《投げ飛ばし》	名詞
＠なげと	《投げ飛ばし》	名詞
＠なげとば	《投げ飛ばし》	名詞
＠なげとばし	《投げ飛ばし》	名詞
＠に	《七人の小人》	名詞
＠にん	《七人の小人》	名詞
＠にんの	《七人の小人》	名詞
＠にんのし	《七人の小人》	名詞
＠にんのしょ	《七人の小人》	名詞
＠にんのしょう	《七人の小人》	名詞
＠にんのしょうに	《七人の小人》	名詞
＠にんのしょうにん	《七人の小人》	名詞
＠む	《胸躍る可能性》	名詞
＠むね	《胸躍る可能性》	名詞
＠むねお	《胸躍る可能性》	名詞
＠むねおど	《胸躍る可能性》	名詞
＠むねおどる	《胸躍る可能性》	名詞
＠むねおどるか	《胸躍る可能性》	名詞
＠むねおどるかの	《胸躍る可能性》	名詞
＠むねおどるかのう	《胸躍る可能性》	名詞
＠むねおどるかのうせ	《胸躍る可能性》	名詞
＠むねおどるかのうせい	《胸躍る可能性》	名詞
＠り	《リムロックの騎士》	名詞
＠りむ	《リムロックの騎士》	名詞
＠りむろ	《リムロックの騎士》	名詞
＠りむろっ	《リムロックの騎士》	名詞
＠りむろっく	《リムロックの騎士》	名詞
＠りむろっくの	《リムロックの騎士》	名詞
＠りむろっくのき	《リムロックの騎士》	名詞
＠りむろっくのきし	《リムロックの騎士》	名詞
＠れ	《レッドキャップの略奪者》	名詞
＠れっ	《レッドキャップの略奪者》	名詞
＠れっど	《レッドキャップの略奪者》	名詞
＠れっどき	《レッドキャップの略奪者》	名詞
＠れっどきゃ	《レッドキャップの略奪者》	名詞
＠れっどきゃっ	《レッドキャップの略奪者》	名詞
＠れっどきゃっぷ	《レッドキャップの略奪者》	名詞
＠れっどきゃっぷの	《レッドキャップの略奪者》	名詞
＠れっどきゃっぷのり	《レッドキャップの略奪者》	名詞
＠れっどきゃっぷのりゃ	《レッドキャップの略奪者》	名詞
＠れっどきゃっぷのりゃく	《レッドキャップの略奪者》	名詞
＠れっどきゃっぷのりゃくだ	《レッドキャップの略奪者》	名詞
＠れっどきゃっぷのりゃくだつ	《レッドキャップの略奪者》	名詞
＠れっどきゃっぷのりゃくだつし	《レッドキャップの略奪者》	名詞
＠れっどきゃっぷのりゃくだつしゃ	《レッドキャップの略奪者》	名詞
＠う	《初子さらい》	名詞
＠うい	《初子さらい》	名詞
＠ういご	《初子さらい》	名詞
＠ういごさ	《初子さらい》	名詞
＠ういごさら	《初子さらい》	名詞
＠ういごさらい	《初子さらい》	名詞
＠え	《エンバレスの盾割り》	名詞
＠えん	《エンバレスの盾割り》	名詞
＠えんば	《エンバレスの盾割り》	名詞
＠えんばれ	《エンバレスの盾割り》	名詞
＠えんばれす	《エンバレスの盾割り》	名詞
＠えんばれすの	《エンバレスの盾割り》	名詞
＠えんばれすのた	《エンバレスの盾割り》	名詞
＠えんばれすのたて	《エンバレスの盾割り》	名詞
＠えんばれすのたてわ	《エンバレスの盾割り》	名詞
＠えんばれすのたてわり	《エンバレスの盾割り》	名詞
＠く	《狂ったネズミ飼い》	名詞
＠くる	《狂ったネズミ飼い》	名詞
＠くるっ	《狂ったネズミ飼い》	名詞
＠くるった	《狂ったネズミ飼い》	名詞
＠くるったね	《狂ったネズミ飼い》	名詞
＠くるったねず	《狂ったネズミ飼い》	名詞
＠くるったねずみ	《狂ったネズミ飼い》	名詞
＠くるったねずみか	《狂ったネズミ飼い》	名詞
＠くるったねずみかい	《狂ったネズミ飼い》	名詞
＠さ	《殺戮の火》	名詞
＠さつ	《殺戮の火》	名詞
＠さつり	《殺戮の火》	名詞
＠さつりく	《殺戮の火》	名詞
＠さつりくの	《殺戮の火》	名詞
＠さつりくのひ	《殺戮の火》	名詞
＠ず	《頭蓋叩きのオーガ》	名詞
＠ずが	《頭蓋叩きのオーガ》	名詞
＠ずがい	《頭蓋叩きのオーガ》	名詞
＠ずがいだ	《頭蓋叩きのオーガ》	名詞
＠ずがいだた	《頭蓋叩きのオーガ》	名詞
＠ずがいだたき	《頭蓋叩きのオーガ》	名詞
＠ずがいだたきの	《頭蓋叩きのオーガ》	名詞
＠ずがいだたきのお	《頭蓋叩きのオーガ》	名詞
＠ずがいだたきのおー	《頭蓋叩きのオーガ》	名詞
＠ずがいだたきのおーが	《頭蓋叩きのオーガ》	名詞
＠も	《燃焦苑の教練者》	名詞
＠もえ	《燃焦苑の教練者》	名詞
＠もえあ	《燃焦苑の教練者》	名詞
＠もえあせ	《燃焦苑の教練者》	名詞
＠もえあせり	《燃焦苑の教練者》	名詞
＠もえあせりそ	《燃焦苑の教練者》	名詞
＠もえあせりその	《燃焦苑の教練者》	名詞
＠もえあせりそのの	《燃焦苑の教練者》	名詞
＠もえあせりそののき	《燃焦苑の教練者》	名詞
＠もえあせりそののきょ	《燃焦苑の教練者》	名詞
＠もえあせりそののきょう	《燃焦苑の教練者》	名詞
＠もえあせりそののきょうれ	《燃焦苑の教練者》	名詞
＠もえあせりそののきょうれん	《燃焦苑の教練者》	名詞
＠もえあせりそののきょうれんし	《燃焦苑の教練者》	名詞
＠もえあせりそののきょうれんしゃ	《燃焦苑の教練者》	名詞
＠ば	《馬上槍試合》	名詞
＠ばじ	《馬上槍試合》	名詞
＠ばじょ	《馬上槍試合》	名詞
＠ばじょう	《馬上槍試合》	名詞
＠ばじょうや	《馬上槍試合》	名詞
＠ばじょうやり	《馬上槍試合》	名詞
＠ばじょうやりし	《馬上槍試合》	名詞
＠ばじょうやりしあ	《馬上槍試合》	名詞
＠ばじょうやりしあい	《馬上槍試合》	名詞
＠ひ	《僻境の暴虐》	名詞
＠ひが	《僻境の暴虐》	名詞
＠ひがみ	《僻境の暴虐》	名詞
＠ひがみざ	《僻境の暴虐》	名詞
＠ひがみざか	《僻境の暴虐》	名詞
＠ひがみざかい	《僻境の暴虐》	名詞
＠ひがみざかいの	《僻境の暴虐》	名詞
＠ひがみざかいのぼ	《僻境の暴虐》	名詞
＠ひがみざかいのぼう	《僻境の暴虐》	名詞
＠ひがみざかいのぼうぎ	《僻境の暴虐》	名詞
＠ひがみざかいのぼうぎゃ	《僻境の暴虐》	名詞
＠ひがみざかいのぼうぎゃく	《僻境の暴虐》	名詞
＠ゆ	《勇敢な騎士、カラ卿》	名詞
＠ゆう	《勇敢な騎士、カラ卿》	名詞
＠ゆうか	《勇敢な騎士、カラ卿》	名詞
＠ゆうかん	《勇敢な騎士、カラ卿》	名詞
＠ゆうかんな	《勇敢な騎士、カラ卿》	名詞
＠ゆうかんなき	《勇敢な騎士、カラ卿》	名詞
＠ゆうかんなきし	《勇敢な騎士、カラ卿》	名詞
＠ゆうかんなきし、	《勇敢な騎士、カラ卿》	名詞
＠ゆうかんなきし、か	《勇敢な騎士、カラ卿》	名詞
＠ゆうかんなきし、から	《勇敢な騎士、カラ卿》	名詞
＠ゆうかんなきし、からき	《勇敢な騎士、カラ卿》	名詞
＠ゆうかんなきし、からきょ	《勇敢な騎士、カラ卿》	名詞
＠ゆうかんなきし、からきょう	《勇敢な騎士、カラ卿》	名詞
＠れ	《レッドキャップの乱闘》	名詞
＠れっ	《レッドキャップの乱闘》	名詞
＠れっど	《レッドキャップの乱闘》	名詞
＠れっどき	《レッドキャップの乱闘》	名詞
＠れっどきゃ	《レッドキャップの乱闘》	名詞
＠れっどきゃっ	《レッドキャップの乱闘》	名詞
＠れっどきゃっぷ	《レッドキャップの乱闘》	名詞
＠れっどきゃっぷの	《レッドキャップの乱闘》	名詞
＠れっどきゃっぷのら	《レッドキャップの乱闘》	名詞
＠れっどきゃっぷのらん	《レッドキャップの乱闘》	名詞
＠れっどきゃっぷのらんと	《レッドキャップの乱闘》	名詞
＠れっどきゃっぷのらんとう	《レッドキャップの乱闘》	名詞
＠あ	《アイレンクラッグの紅蓮術師》	名詞
＠あい	《アイレンクラッグの紅蓮術師》	名詞
＠あいれ	《アイレンクラッグの紅蓮術師》	名詞
＠あいれん	《アイレンクラッグの紅蓮術師》	名詞
＠あいれんく	《アイレンクラッグの紅蓮術師》	名詞
＠あいれんくら	《アイレンクラッグの紅蓮術師》	名詞
＠あいれんくらっ	《アイレンクラッグの紅蓮術師》	名詞
＠あいれんくらっぐ	《アイレンクラッグの紅蓮術師》	名詞
＠あいれんくらっぐの	《アイレンクラッグの紅蓮術師》	名詞
＠あいれんくらっぐのぐ	《アイレンクラッグの紅蓮術師》	名詞
＠あいれんくらっぐのぐれ	《アイレンクラッグの紅蓮術師》	名詞
＠あいれんくらっぐのぐれん	《アイレンクラッグの紅蓮術師》	名詞
＠あいれんくらっぐのぐれんじ	《アイレンクラッグの紅蓮術師》	名詞
＠あいれんくらっぐのぐれんじゅ	《アイレンクラッグの紅蓮術師》	名詞
＠あいれんくらっぐのぐれんじゅつ	《アイレンクラッグの紅蓮術師》	名詞
＠あいれんくらっぐのぐれんじゅつし	《アイレンクラッグの紅蓮術師》	名詞
＠あ	《アイレンクラッグの妙技》	名詞
＠あい	《アイレンクラッグの妙技》	名詞
＠あいれ	《アイレンクラッグの妙技》	名詞
＠あいれん	《アイレンクラッグの妙技》	名詞
＠あいれんく	《アイレンクラッグの妙技》	名詞
＠あいれんくら	《アイレンクラッグの妙技》	名詞
＠あいれんくらっ	《アイレンクラッグの妙技》	名詞
＠あいれんくらっぐ	《アイレンクラッグの妙技》	名詞
＠あいれんくらっぐの	《アイレンクラッグの妙技》	名詞
＠あいれんくらっぐのみ	《アイレンクラッグの妙技》	名詞
＠あいれんくらっぐのみょ	《アイレンクラッグの妙技》	名詞
＠あいれんくらっぐのみょう	《アイレンクラッグの妙技》	名詞
＠あいれんくらっぐのみょうぎ	《アイレンクラッグの妙技》	名詞
＠き	《切り離す一撃》	名詞
＠きり	《切り離す一撃》	名詞
＠きりは	《切り離す一撃》	名詞
＠きりはな	《切り離す一撃》	名詞
＠きりはなす	《切り離す一撃》	名詞
＠きりはなすい	《切り離す一撃》	名詞
＠きりはなすいち	《切り離す一撃》	名詞
＠きりはなすいちげ	《切り離す一撃》	名詞
＠きりはなすいちげき	《切り離す一撃》	名詞
＠そ	《創案の火》	名詞
＠そう	《創案の火》	名詞
＠そうあ	《創案の火》	名詞
＠そうあん	《創案の火》	名詞
＠そうあんの	《創案の火》	名詞
＠そうあんのひ	《創案の火》	名詞
＠し	《朱地洞の族長、トーブラン》	名詞
＠しゅ	《朱地洞の族長、トーブラン》	名詞
＠しゅち	《朱地洞の族長、トーブラン》	名詞
＠しゅちほ	《朱地洞の族長、トーブラン》	名詞
＠しゅちほら	《朱地洞の族長、トーブラン》	名詞
＠しゅちほらの	《朱地洞の族長、トーブラン》	名詞
＠しゅちほらのぞ	《朱地洞の族長、トーブラン》	名詞
＠しゅちほらのぞく	《朱地洞の族長、トーブラン》	名詞
＠しゅちほらのぞくち	《朱地洞の族長、トーブラン》	名詞
＠しゅちほらのぞくちょ	《朱地洞の族長、トーブラン》	名詞
＠しゅちほらのぞくちょう	《朱地洞の族長、トーブラン》	名詞
＠しゅちほらのぞくちょう、	《朱地洞の族長、トーブラン》	名詞
＠しゅちほらのぞくちょう、と	《朱地洞の族長、トーブラン》	名詞
＠しゅちほらのぞくちょう、とー	《朱地洞の族長、トーブラン》	名詞
＠しゅちほらのぞくちょう、とーぶ	《朱地洞の族長、トーブラン》	名詞
＠しゅちほらのぞくちょう、とーぶら	《朱地洞の族長、トーブラン》	名詞
＠しゅちほらのぞくちょう、とーぶらん	《朱地洞の族長、トーブラン》	名詞
＠ね	《熱烈な勇者》	名詞
＠ねつ	《熱烈な勇者》	名詞
＠ねつれ	《熱烈な勇者》	名詞
＠ねつれつ	《熱烈な勇者》	名詞
＠ねつれつな	《熱烈な勇者》	名詞
＠ねつれつなゆ	《熱烈な勇者》	名詞
＠ねつれつなゆう	《熱烈な勇者》	名詞
＠ねつれつなゆうし	《熱烈な勇者》	名詞
＠ねつれつなゆうしゃ	《熱烈な勇者》	名詞
＠ひ	《日和見ドラゴン》	名詞
＠ひよ	《日和見ドラゴン》	名詞
＠ひより	《日和見ドラゴン》	名詞
＠ひよりみ	《日和見ドラゴン》	名詞
＠ひよりみど	《日和見ドラゴン》	名詞
＠ひよりみどら	《日和見ドラゴン》	名詞
＠ひよりみどらご	《日和見ドラゴン》	名詞
＠ひよりみどらごん	《日和見ドラゴン》	名詞
＠さ	《砕骨の巨人》	名詞
＠さい	《砕骨の巨人》	名詞
＠さいほ	《砕骨の巨人》	名詞
＠さいほね	《砕骨の巨人》	名詞
＠さいほねの	《砕骨の巨人》	名詞
＠さいほねのき	《砕骨の巨人》	名詞
＠さいほねのきょ	《砕骨の巨人》	名詞
＠さいほねのきょじ	《砕骨の巨人》	名詞
＠さいほねのきょじん	《砕骨の巨人》	名詞
＠え	《エンバレスの宝剣》	名詞
＠えん	《エンバレスの宝剣》	名詞
＠えんば	《エンバレスの宝剣》	名詞
＠えんばれ	《エンバレスの宝剣》	名詞
＠えんばれす	《エンバレスの宝剣》	名詞
＠えんばれすの	《エンバレスの宝剣》	名詞
＠えんばれすのほ	《エンバレスの宝剣》	名詞
＠えんばれすのほう	《エンバレスの宝剣》	名詞
＠えんばれすのほうけ	《エンバレスの宝剣》	名詞
＠えんばれすのほうけん	《エンバレスの宝剣》	名詞
＠ぎ	《義賊》	名詞
＠ぎぞ	《義賊》	名詞
＠ぎぞく	《義賊》	名詞
＠お	《狼の獲物》	名詞
＠おお	《狼の獲物》	名詞
＠おおか	《狼の獲物》	名詞
＠おおかみ	《狼の獲物》	名詞
＠おおかみの	《狼の獲物》	名詞
＠おおかみのえ	《狼の獲物》	名詞
＠おおかみのえも	《狼の獲物》	名詞
＠おおかみのえもの	《狼の獲物》	名詞
＠か	《限りない食欲》	名詞
＠かぎ	《限りない食欲》	名詞
＠かぎり	《限りない食欲》	名詞
＠かぎりな	《限りない食欲》	名詞
＠かぎりない	《限りない食欲》	名詞
＠かぎりないし	《限りない食欲》	名詞
＠かぎりないしょ	《限りない食欲》	名詞
＠かぎりないしょく	《限りない食欲》	名詞
＠かぎりないしょくよ	《限りない食欲》	名詞
＠かぎりないしょくよく	《限りない食欲》	名詞
＠き	《雉狩り》	名詞
＠きじ	《雉狩り》	名詞
＠きじか	《雉狩り》	名詞
＠きじかり	《雉狩り》	名詞
＠し	《自然への回帰》	名詞
＠しぜ	《自然への回帰》	名詞
＠しぜん	《自然への回帰》	名詞
＠しぜんへ	《自然への回帰》	名詞
＠しぜんへの	《自然への回帰》	名詞
＠しぜんへのか	《自然への回帰》	名詞
＠しぜんへのかい	《自然への回帰》	名詞
＠しぜんへのかいき	《自然への回帰》	名詞
＠し	《知りたがりの二人》	名詞
＠しり	《知りたがりの二人》	名詞
＠しりた	《知りたがりの二人》	名詞
＠しりたが	《知りたがりの二人》	名詞
＠しりたがり	《知りたがりの二人》	名詞
＠しりたがりの	《知りたがりの二人》	名詞
＠しりたがりのふ	《知りたがりの二人》	名詞
＠しりたがりのふた	《知りたがりの二人》	名詞
＠しりたがりのふたり	《知りたがりの二人》	名詞
＠ぎ	《ギャレンブリグの従者》	名詞
＠ぎゃ	《ギャレンブリグの従者》	名詞
＠ぎゃれ	《ギャレンブリグの従者》	名詞
＠ぎゃれん	《ギャレンブリグの従者》	名詞
＠ぎゃれんぶ	《ギャレンブリグの従者》	名詞
＠ぎゃれんぶり	《ギャレンブリグの従者》	名詞
＠ぎゃれんぶりぐ	《ギャレンブリグの従者》	名詞
＠ぎゃれんぶりぐの	《ギャレンブリグの従者》	名詞
＠ぎゃれんぶりぐのじ	《ギャレンブリグの従者》	名詞
＠ぎゃれんぶりぐのじゅ	《ギャレンブリグの従者》	名詞
＠ぎゃれんぶりぐのじゅう	《ギャレンブリグの従者》	名詞
＠ぎゃれんぶりぐのじゅうし	《ギャレンブリグの従者》	名詞
＠ぎゃれんぶりぐのじゅうしゃ	《ギャレンブリグの従者》	名詞
＠ぎ	《ギャレンブリグの聖騎士》	名詞
＠ぎゃ	《ギャレンブリグの聖騎士》	名詞
＠ぎゃれ	《ギャレンブリグの聖騎士》	名詞
＠ぎゃれん	《ギャレンブリグの聖騎士》	名詞
＠ぎゃれんぶ	《ギャレンブリグの聖騎士》	名詞
＠ぎゃれんぶり	《ギャレンブリグの聖騎士》	名詞
＠ぎゃれんぶりぐ	《ギャレンブリグの聖騎士》	名詞
＠ぎゃれんぶりぐの	《ギャレンブリグの聖騎士》	名詞
＠ぎゃれんぶりぐのせ	《ギャレンブリグの聖騎士》	名詞
＠ぎゃれんぶりぐのせい	《ギャレンブリグの聖騎士》	名詞
＠ぎゃれんぶりぐのせいき	《ギャレンブリグの聖騎士》	名詞
＠ぎゃれんぶりぐのせいきし	《ギャレンブリグの聖騎士》	名詞
＠ぎ	《ギャレンブリグの木工師》	名詞
＠ぎゃ	《ギャレンブリグの木工師》	名詞
＠ぎゃれ	《ギャレンブリグの木工師》	名詞
＠ぎゃれん	《ギャレンブリグの木工師》	名詞
＠ぎゃれんぶ	《ギャレンブリグの木工師》	名詞
＠ぎゃれんぶり	《ギャレンブリグの木工師》	名詞
＠ぎゃれんぶりぐ	《ギャレンブリグの木工師》	名詞
＠ぎゃれんぶりぐの	《ギャレンブリグの木工師》	名詞
＠ぎゃれんぶりぐのき	《ギャレンブリグの木工師》	名詞
＠ぎゃれんぶりぐのきこ	《ギャレンブリグの木工師》	名詞
＠ぎゃれんぶりぐのきこう	《ギャレンブリグの木工師》	名詞
＠ぎゃれんぶりぐのきこうし	《ギャレンブリグの木工師》	名詞
＠き	《筋骨隆々》	名詞
＠きん	《筋骨隆々》	名詞
＠きんこ	《筋骨隆々》	名詞
＠きんこつ	《筋骨隆々》	名詞
＠きんこつり	《筋骨隆々》	名詞
＠きんこつりゅ	《筋骨隆々》	名詞
＠きんこつりゅう	《筋骨隆々》	名詞
＠きんこつりゅうり	《筋骨隆々》	名詞
＠きんこつりゅうりゅ	《筋骨隆々》	名詞
＠きんこつりゅうりゅう	《筋骨隆々》	名詞
＠ち	《チューインベイルのツリーフォーク》	名詞
＠ちゅ	《チューインベイルのツリーフォーク》	名詞
＠ちゅー	《チューインベイルのツリーフォーク》	名詞
＠ちゅーい	《チューインベイルのツリーフォーク》	名詞
＠ちゅーいん	《チューインベイルのツリーフォーク》	名詞
＠ちゅーいんべ	《チューインベイルのツリーフォーク》	名詞
＠ちゅーいんべい	《チューインベイルのツリーフォーク》	名詞
＠ちゅーいんべいる	《チューインベイルのツリーフォーク》	名詞
＠ちゅーいんべいるの	《チューインベイルのツリーフォーク》	名詞
＠ちゅーいんべいるのつ	《チューインベイルのツリーフォーク》	名詞
＠ちゅーいんべいるのつり	《チューインベイルのツリーフォーク》	名詞
＠ちゅーいんべいるのつりー	《チューインベイルのツリーフォーク》	名詞
＠ちゅーいんべいるのつりーふ	《チューインベイルのツリーフォーク》	名詞
＠ちゅーいんべいるのつりーふぉ	《チューインベイルのツリーフォーク》	名詞
＠ちゅーいんべいるのつりーふぉー	《チューインベイルのツリーフォーク》	名詞
＠ちゅーいんべいるのつりーふぉーく	《チューインベイルのツリーフォーク》	名詞
＠ど	《獰猛な魔女跡追い》	名詞
＠どう	《獰猛な魔女跡追い》	名詞
＠どうも	《獰猛な魔女跡追い》	名詞
＠どうもう	《獰猛な魔女跡追い》	名詞
＠どうもうな	《獰猛な魔女跡追い》	名詞
＠どうもうなま	《獰猛な魔女跡追い》	名詞
＠どうもうなまじ	《獰猛な魔女跡追い》	名詞
＠どうもうなまじょ	《獰猛な魔女跡追い》	名詞
＠どうもうなまじょあ	《獰猛な魔女跡追い》	名詞
＠どうもうなまじょあと	《獰猛な魔女跡追い》	名詞
＠どうもうなまじょあとお	《獰猛な魔女跡追い》	名詞
＠どうもうなまじょあとおい	《獰猛な魔女跡追い》	名詞
＠の	《伸びゆく豆の木》	名詞
＠のび	《伸びゆく豆の木》	名詞
＠のびゆ	《伸びゆく豆の木》	名詞
＠のびゆく	《伸びゆく豆の木》	名詞
＠のびゆくま	《伸びゆく豆の木》	名詞
＠のびゆくまめ	《伸びゆく豆の木》	名詞
＠のびゆくまめの	《伸びゆく豆の木》	名詞
＠のびゆくまめのき	《伸びゆく豆の木》	名詞
＠ば	《薔薇棘の矛槍》	名詞
＠ばら	《薔薇棘の矛槍》	名詞
＠ばらお	《薔薇棘の矛槍》	名詞
＠ばらおど	《薔薇棘の矛槍》	名詞
＠ばらおどろ	《薔薇棘の矛槍》	名詞
＠ばらおどろの	《薔薇棘の矛槍》	名詞
＠ばらおどろのほ	《薔薇棘の矛槍》	名詞
＠ばらおどろのほこ	《薔薇棘の矛槍》	名詞
＠ばらおどろのほこや	《薔薇棘の矛槍》	名詞
＠ばらおどろのほこやり	《薔薇棘の矛槍》	名詞
＠ば	《薔薇棘の見習い》	名詞
＠ばら	《薔薇棘の見習い》	名詞
＠ばらお	《薔薇棘の見習い》	名詞
＠ばらおど	《薔薇棘の見習い》	名詞
＠ばらおどろ	《薔薇棘の見習い》	名詞
＠ばらおどろの	《薔薇棘の見習い》	名詞
＠ばらおどろのみ	《薔薇棘の見習い》	名詞
＠ばらおどろのみな	《薔薇棘の見習い》	名詞
＠ばらおどろのみなら	《薔薇棘の見習い》	名詞
＠ばらおどろのみならい	《薔薇棘の見習い》	名詞
＠ひ	《僻森の追跡者》	名詞
＠ひが	《僻森の追跡者》	名詞
＠ひがみ	《僻森の追跡者》	名詞
＠ひがみも	《僻森の追跡者》	名詞
＠ひがみもり	《僻森の追跡者》	名詞
＠ひがみもりの	《僻森の追跡者》	名詞
＠ひがみもりのつ	《僻森の追跡者》	名詞
＠ひがみもりのつい	《僻森の追跡者》	名詞
＠ひがみもりのついせ	《僻森の追跡者》	名詞
＠ひがみもりのついせき	《僻森の追跡者》	名詞
＠ひがみもりのついせきし	《僻森の追跡者》	名詞
＠ひがみもりのついせきしゃ	《僻森の追跡者》	名詞
＠ほ	《胞子頭の蜘蛛》	名詞
＠ほう	《胞子頭の蜘蛛》	名詞
＠ほうし	《胞子頭の蜘蛛》	名詞
＠ほうしあ	《胞子頭の蜘蛛》	名詞
＠ほうしあた	《胞子頭の蜘蛛》	名詞
＠ほうしあたま	《胞子頭の蜘蛛》	名詞
＠ほうしあたまの	《胞子頭の蜘蛛》	名詞
＠ほうしあたまのく	《胞子頭の蜘蛛》	名詞
＠ほうしあたまのくも	《胞子頭の蜘蛛》	名詞
＠ま	《マラリーフの乗り手》	名詞
＠まら	《マラリーフの乗り手》	名詞
＠まらり	《マラリーフの乗り手》	名詞
＠まらりー	《マラリーフの乗り手》	名詞
＠まらりーふ	《マラリーフの乗り手》	名詞
＠まらりーふの	《マラリーフの乗り手》	名詞
＠まらりーふのの	《マラリーフの乗り手》	名詞
＠まらりーふののり	《マラリーフの乗り手》	名詞
＠まらりーふののりて	《マラリーフの乗り手》	名詞
＠あ	《亜麻色の侵入者》	名詞
＠あま	《亜麻色の侵入者》	名詞
＠あまい	《亜麻色の侵入者》	名詞
＠あまいろ	《亜麻色の侵入者》	名詞
＠あまいろの	《亜麻色の侵入者》	名詞
＠あまいろのし	《亜麻色の侵入者》	名詞
＠あまいろのしん	《亜麻色の侵入者》	名詞
＠あまいろのしんに	《亜麻色の侵入者》	名詞
＠あまいろのしんにゅ	《亜麻色の侵入者》	名詞
＠あまいろのしんにゅう	《亜麻色の侵入者》	名詞
＠あまいろのしんにゅうし	《亜麻色の侵入者》	名詞
＠あまいろのしんにゅうしゃ	《亜麻色の侵入者》	名詞
＠え	《エッジウォールの亭主》	名詞
＠えっ	《エッジウォールの亭主》	名詞
＠えっじ	《エッジウォールの亭主》	名詞
＠えっじう	《エッジウォールの亭主》	名詞
＠えっじうぉ	《エッジウォールの亭主》	名詞
＠えっじうぉー	《エッジウォールの亭主》	名詞
＠えっじうぉーる	《エッジウォールの亭主》	名詞
＠えっじうぉーるの	《エッジウォールの亭主》	名詞
＠えっじうぉーるのて	《エッジウォールの亭主》	名詞
＠えっじうぉーるのてい	《エッジウォールの亭主》	名詞
＠えっじうぉーるのていし	《エッジウォールの亭主》	名詞
＠えっじうぉーるのていしゅ	《エッジウォールの亭主》	名詞
＠お	《オークヘイムの敵対者》	名詞
＠おー	《オークヘイムの敵対者》	名詞
＠おーく	《オークヘイムの敵対者》	名詞
＠おーくへ	《オークヘイムの敵対者》	名詞
＠おーくへい	《オークヘイムの敵対者》	名詞
＠おーくへいむ	《オークヘイムの敵対者》	名詞
＠おーくへいむの	《オークヘイムの敵対者》	名詞
＠おーくへいむのて	《オークヘイムの敵対者》	名詞
＠おーくへいむのてき	《オークヘイムの敵対者》	名詞
＠おーくへいむのてきた	《オークヘイムの敵対者》	名詞
＠おーくへいむのてきたい	《オークヘイムの敵対者》	名詞
＠おーくへいむのてきたいし	《オークヘイムの敵対者》	名詞
＠おーくへいむのてきたいしゃ	《オークヘイムの敵対者》	名詞
＠か	《過去と未来》	名詞
＠かこ	《過去と未来》	名詞
＠かこと	《過去と未来》	名詞
＠かことみ	《過去と未来》	名詞
＠かことみら	《過去と未来》	名詞
＠かことみらい	《過去と未来》	名詞
＠き	《巨大な好機》	名詞
＠きょ	《巨大な好機》	名詞
＠きょだ	《巨大な好機》	名詞
＠きょだい	《巨大な好機》	名詞
＠きょだいな	《巨大な好機》	名詞
＠きょだいなこ	《巨大な好機》	名詞
＠きょだいなこう	《巨大な好機》	名詞
＠きょだいなこうき	《巨大な好機》	名詞
＠け	《ケンリスの変身》	名詞
＠けん	《ケンリスの変身》	名詞
＠けんり	《ケンリスの変身》	名詞
＠けんりす	《ケンリスの変身》	名詞
＠けんりすの	《ケンリスの変身》	名詞
＠けんりすのへ	《ケンリスの変身》	名詞
＠けんりすのへん	《ケンリスの変身》	名詞
＠けんりすのへんし	《ケンリスの変身》	名詞
＠けんりすのへんしん	《ケンリスの変身》	名詞
＠ぐ	《寓話の守り手》	名詞
＠ぐう	《寓話の守り手》	名詞
＠ぐうわ	《寓話の守り手》	名詞
＠ぐうわの	《寓話の守り手》	名詞
＠ぐうわのま	《寓話の守り手》	名詞
＠ぐうわのまも	《寓話の守り手》	名詞
＠ぐうわのまもり	《寓話の守り手》	名詞
＠ぐうわのまもりて	《寓話の守り手》	名詞
＠ぱ	《パンくずの道標》	名詞
＠ぱん	《パンくずの道標》	名詞
＠ぱんく	《パンくずの道標》	名詞
＠ぱんくず	《パンくずの道標》	名詞
＠ぱんくずの	《パンくずの道標》	名詞
＠ぱんくずのみ	《パンくずの道標》	名詞
＠ぱんくずのみち	《パンくずの道標》	名詞
＠ぱんくずのみちし	《パンくずの道標》	名詞
＠ぱんくずのみちしる	《パンくずの道標》	名詞
＠ぱんくずのみちしるべ	《パンくずの道標》	名詞
＠へ	《ヘンジの槌、ファレン卿》	名詞
＠へん	《ヘンジの槌、ファレン卿》	名詞
＠へんじ	《ヘンジの槌、ファレン卿》	名詞
＠へんじの	《ヘンジの槌、ファレン卿》	名詞
＠へんじのつ	《ヘンジの槌、ファレン卿》	名詞
＠へんじのつち	《ヘンジの槌、ファレン卿》	名詞
＠へんじのつち、	《ヘンジの槌、ファレン卿》	名詞
＠へんじのつち、ふ	《ヘンジの槌、ファレン卿》	名詞
＠へんじのつち、ふぁ	《ヘンジの槌、ファレン卿》	名詞
＠へんじのつち、ふぁれ	《ヘンジの槌、ファレン卿》	名詞
＠へんじのつち、ふぁれん	《ヘンジの槌、ファレン卿》	名詞
＠へんじのつち、ふぁれんき	《ヘンジの槌、ファレン卿》	名詞
＠へんじのつち、ふぁれんきょ	《ヘンジの槌、ファレン卿》	名詞
＠へんじのつち、ふぁれんきょう	《ヘンジの槌、ファレン卿》	名詞
＠ま	《豆の木の巨人》	名詞
＠まめ	《豆の木の巨人》	名詞
＠まめの	《豆の木の巨人》	名詞
＠まめのき	《豆の木の巨人》	名詞
＠まめのきの	《豆の木の巨人》	名詞
＠まめのきのき	《豆の木の巨人》	名詞
＠まめのきのきょ	《豆の木の巨人》	名詞
＠まめのきのきょじ	《豆の木の巨人》	名詞
＠まめのきのきょじん	《豆の木の巨人》	名詞
＠い	《意地悪な狼》	名詞
＠いじ	《意地悪な狼》	名詞
＠いじわ	《意地悪な狼》	名詞
＠いじわる	《意地悪な狼》	名詞
＠いじわるな	《意地悪な狼》	名詞
＠いじわるなお	《意地悪な狼》	名詞
＠いじわるなおお	《意地悪な狼》	名詞
＠いじわるなおおか	《意地悪な狼》	名詞
＠いじわるなおおかみ	《意地悪な狼》	名詞
＠ぎ	《ギャレンブリグの領主、ヨルヴォ》	名詞
＠ぎゃ	《ギャレンブリグの領主、ヨルヴォ》	名詞
＠ぎゃれ	《ギャレンブリグの領主、ヨルヴォ》	名詞
＠ぎゃれん	《ギャレンブリグの領主、ヨルヴォ》	名詞
＠ぎゃれんぶ	《ギャレンブリグの領主、ヨルヴォ》	名詞
＠ぎゃれんぶり	《ギャレンブリグの領主、ヨルヴォ》	名詞
＠ぎゃれんぶりぐ	《ギャレンブリグの領主、ヨルヴォ》	名詞
＠ぎゃれんぶりぐの	《ギャレンブリグの領主、ヨルヴォ》	名詞
＠ぎゃれんぶりぐのり	《ギャレンブリグの領主、ヨルヴォ》	名詞
＠ぎゃれんぶりぐのりょ	《ギャレンブリグの領主、ヨルヴォ》	名詞
＠ぎゃれんぶりぐのりょう	《ギャレンブリグの領主、ヨルヴォ》	名詞
＠ぎゃれんぶりぐのりょうし	《ギャレンブリグの領主、ヨルヴォ》	名詞
＠ぎゃれんぶりぐのりょうしゅ	《ギャレンブリグの領主、ヨルヴォ》	名詞
＠ぎゃれんぶりぐのりょうしゅ、	《ギャレンブリグの領主、ヨルヴォ》	名詞
＠ぎゃれんぶりぐのりょうしゅ、よ	《ギャレンブリグの領主、ヨルヴォ》	名詞
＠ぎゃれんぶりぐのりょうしゅ、よる	《ギャレンブリグの領主、ヨルヴォ》	名詞
＠ぎゃれんぶりぐのりょうしゅ、よるヴ	《ギャレンブリグの領主、ヨルヴォ》	名詞
＠ぎゃれんぶりぐのりょうしゅ、よるヴぉ	《ギャレンブリグの領主、ヨルヴォ》	名詞
＠き	《金のガチョウ》	名詞
＠きん	《金のガチョウ》	名詞
＠きんの	《金のガチョウ》	名詞
＠きんのが	《金のガチョウ》	名詞
＠きんのがち	《金のガチョウ》	名詞
＠きんのがちょ	《金のガチョウ》	名詞
＠きんのがちょう	《金のガチョウ》	名詞
＠こ	《恋煩いの野獣》	名詞
＠こい	《恋煩いの野獣》	名詞
＠こいわ	《恋煩いの野獣》	名詞
＠こいわず	《恋煩いの野獣》	名詞
＠こいわずら	《恋煩いの野獣》	名詞
＠こいわずらい	《恋煩いの野獣》	名詞
＠こいわずらいの	《恋煩いの野獣》	名詞
＠こいわずらいのや	《恋煩いの野獣》	名詞
＠こいわずらいのやじ	《恋煩いの野獣》	名詞
＠こいわずらいのやじゅ	《恋煩いの野獣》	名詞
＠こいわずらいのやじゅう	《恋煩いの野獣》	名詞
＠ひ	《僻境生まれの保護者》	名詞
＠ひが	《僻境生まれの保護者》	名詞
＠ひがみ	《僻境生まれの保護者》	名詞
＠ひがみざ	《僻境生まれの保護者》	名詞
＠ひがみざか	《僻境生まれの保護者》	名詞
＠ひがみざかい	《僻境生まれの保護者》	名詞
＠ひがみざかいう	《僻境生まれの保護者》	名詞
＠ひがみざかいうま	《僻境生まれの保護者》	名詞
＠ひがみざかいうまれ	《僻境生まれの保護者》	名詞
＠ひがみざかいうまれの	《僻境生まれの保護者》	名詞
＠ひがみざかいうまれのほ	《僻境生まれの保護者》	名詞
＠ひがみざかいうまれのほご	《僻境生まれの保護者》	名詞
＠ひがみざかいうまれのほごし	《僻境生まれの保護者》	名詞
＠ひがみざかいうまれのほごしゃ	《僻境生まれの保護者》	名詞
＠む	《むかしむかし》	名詞
＠むか	《むかしむかし》	名詞
＠むかし	《むかしむかし》	名詞
＠むかしむ	《むかしむかし》	名詞
＠むかしむか	《むかしむかし》	名詞
＠むかしむかし	《むかしむかし》	名詞
＠む	《貪るトロールの王》	名詞
＠むさ	《貪るトロールの王》	名詞
＠むさぼ	《貪るトロールの王》	名詞
＠むさぼる	《貪るトロールの王》	名詞
＠むさぼると	《貪るトロールの王》	名詞
＠むさぼるとろ	《貪るトロールの王》	名詞
＠むさぼるとろー	《貪るトロールの王》	名詞
＠むさぼるとろーる	《貪るトロールの王》	名詞
＠むさぼるとろーるの	《貪るトロールの王》	名詞
＠むさぼるとろーるのお	《貪るトロールの王》	名詞
＠むさぼるとろーるのおう	《貪るトロールの王》	名詞
＠や	《野生語りの帰還》	名詞
＠やせ	《野生語りの帰還》	名詞
＠やせい	《野生語りの帰還》	名詞
＠やせいが	《野生語りの帰還》	名詞
＠やせいがた	《野生語りの帰還》	名詞
＠やせいがたり	《野生語りの帰還》	名詞
＠やせいがたりの	《野生語りの帰還》	名詞
＠やせいがたりのき	《野生語りの帰還》	名詞
＠やせいがたりのきか	《野生語りの帰還》	名詞
＠やせいがたりのきかん	《野生語りの帰還》	名詞
＠ぐ	《グレートヘンジ》	名詞
＠ぐれ	《グレートヘンジ》	名詞
＠ぐれー	《グレートヘンジ》	名詞
＠ぐれーと	《グレートヘンジ》	名詞
＠ぐれーとへ	《グレートヘンジ》	名詞
＠ぐれーとへん	《グレートヘンジ》	名詞
＠ぐれーとへんじ	《グレートヘンジ》	名詞
＠た	《探索する獣》	名詞
＠たん	《探索する獣》	名詞
＠たんさ	《探索する獣》	名詞
＠たんさく	《探索する獣》	名詞
＠たんさくす	《探索する獣》	名詞
＠たんさくする	《探索する獣》	名詞
＠たんさくするけ	《探索する獣》	名詞
＠たんさくするけも	《探索する獣》	名詞
＠たんさくするけもの	《探索する獣》	名詞
＠か	《輝き追い》	名詞
＠かが	《輝き追い》	名詞
＠かがや	《輝き追い》	名詞
＠かがやき	《輝き追い》	名詞
＠かがやきお	《輝き追い》	名詞
＠かがやきおい	《輝き追い》	名詞
＠や	《屋敷の踊り》	名詞
＠やし	《屋敷の踊り》	名詞
＠やしき	《屋敷の踊り》	名詞
＠やしきの	《屋敷の踊り》	名詞
＠やしきのお	《屋敷の踊り》	名詞
＠やしきのおど	《屋敷の踊り》	名詞
＠やしきのおどり	《屋敷の踊り》	名詞
＠ふ	《冬荒野の指揮官》	名詞
＠ふゆ	《冬荒野の指揮官》	名詞
＠ふゆこ	《冬荒野の指揮官》	名詞
＠ふゆこう	《冬荒野の指揮官》	名詞
＠ふゆこうや	《冬荒野の指揮官》	名詞
＠ふゆこうやの	《冬荒野の指揮官》	名詞
＠ふゆこうやのし	《冬荒野の指揮官》	名詞
＠ふゆこうやのしき	《冬荒野の指揮官》	名詞
＠ふゆこうやのしきか	《冬荒野の指揮官》	名詞
＠ふゆこうやのしきかん	《冬荒野の指揮官》	名詞
＠よ	《予言された壊滅》	名詞
＠よげ	《予言された壊滅》	名詞
＠よげん	《予言された壊滅》	名詞
＠よげんさ	《予言された壊滅》	名詞
＠よげんされ	《予言された壊滅》	名詞
＠よげんされた	《予言された壊滅》	名詞
＠よげんされたか	《予言された壊滅》	名詞
＠よげんされたかい	《予言された壊滅》	名詞
＠よげんされたかいめ	《予言された壊滅》	名詞
＠よげんされたかいめつ	《予言された壊滅》	名詞
＠み	《湖での水難》	名詞
＠みず	《湖での水難》	名詞
＠みずう	《湖での水難》	名詞
＠みずうみ	《湖での水難》	名詞
＠みずうみで	《湖での水難》	名詞
＠みずうみでの	《湖での水難》	名詞
＠みずうみでのす	《湖での水難》	名詞
＠みずうみでのすい	《湖での水難》	名詞
＠みずうみでのすいな	《湖での水難》	名詞
＠みずうみでのすいなん	《湖での水難》	名詞
＠め	《メア湖の海蛇》	名詞
＠めあ	《メア湖の海蛇》	名詞
＠めあみ	《メア湖の海蛇》	名詞
＠めあみず	《メア湖の海蛇》	名詞
＠めあみずう	《メア湖の海蛇》	名詞
＠めあみずうみ	《メア湖の海蛇》	名詞
＠めあみずうみの	《メア湖の海蛇》	名詞
＠めあみずうみのう	《メア湖の海蛇》	名詞
＠めあみずうみのうみ	《メア湖の海蛇》	名詞
＠めあみずうみのうみへ	《メア湖の海蛇》	名詞
＠めあみずうみのうみへび	《メア湖の海蛇》	名詞
＠か	《型破りな協力》	名詞
＠かた	《型破りな協力》	名詞
＠かたや	《型破りな協力》	名詞
＠かたやぶ	《型破りな協力》	名詞
＠かたやぶり	《型破りな協力》	名詞
＠かたやぶりな	《型破りな協力》	名詞
＠かたやぶりなき	《型破りな協力》	名詞
＠かたやぶりなきょ	《型破りな協力》	名詞
＠かたやぶりなきょう	《型破りな協力》	名詞
＠かたやぶりなきょうり	《型破りな協力》	名詞
＠かたやぶりなきょうりょ	《型破りな協力》	名詞
＠かたやぶりなきょうりょく	《型破りな協力》	名詞
＠お	《王家の跡継ぎ》	名詞
＠おう	《王家の跡継ぎ》	名詞
＠おうけ	《王家の跡継ぎ》	名詞
＠おうけの	《王家の跡継ぎ》	名詞
＠おうけのあ	《王家の跡継ぎ》	名詞
＠おうけのあと	《王家の跡継ぎ》	名詞
＠おうけのあとつ	《王家の跡継ぎ》	名詞
＠おうけのあとつぎ	《王家の跡継ぎ》	名詞
＠は	《鋼爪の槍》	名詞
＠はが	《鋼爪の槍》	名詞
＠はがね	《鋼爪の槍》	名詞
＠はがねづ	《鋼爪の槍》	名詞
＠はがねづめ	《鋼爪の槍》	名詞
＠はがねづめの	《鋼爪の槍》	名詞
＠はがねづめのや	《鋼爪の槍》	名詞
＠はがねづめのやり	《鋼爪の槍》	名詞
＠あ	《嵐拳の聖戦士》	名詞
＠あら	《嵐拳の聖戦士》	名詞
＠あらし	《嵐拳の聖戦士》	名詞
＠あらしこ	《嵐拳の聖戦士》	名詞
＠あらしこぶ	《嵐拳の聖戦士》	名詞
＠あらしこぶし	《嵐拳の聖戦士》	名詞
＠あらしこぶしの	《嵐拳の聖戦士》	名詞
＠あらしこぶしのせ	《嵐拳の聖戦士》	名詞
＠あらしこぶしのせい	《嵐拳の聖戦士》	名詞
＠あらしこぶしのせいん	《嵐拳の聖戦士》	名詞
＠あらしこぶしのせいんと	《嵐拳の聖戦士》	名詞
＠ぬ	《抜け目ない狩人》	名詞
＠ぬけ	《抜け目ない狩人》	名詞
＠ぬけめ	《抜け目ない狩人》	名詞
＠ぬけめな	《抜け目ない狩人》	名詞
＠ぬけめない	《抜け目ない狩人》	名詞
＠ぬけめないか	《抜け目ない狩人》	名詞
＠ぬけめないかり	《抜け目ない狩人》	名詞
＠ぬけめないかりう	《抜け目ない狩人》	名詞
＠ぬけめないかりうど	《抜け目ない狩人》	名詞
＠の	《呪われた狩人、ガラク》	名詞
＠のろ	《呪われた狩人、ガラク》	名詞
＠のろわ	《呪われた狩人、ガラク》	名詞
＠のろわれ	《呪われた狩人、ガラク》	名詞
＠のろわれた	《呪われた狩人、ガラク》	名詞
＠のろわれたか	《呪われた狩人、ガラク》	名詞
＠のろわれたかり	《呪われた狩人、ガラク》	名詞
＠のろわれたかりう	《呪われた狩人、ガラク》	名詞
＠のろわれたかりうど	《呪われた狩人、ガラク》	名詞
＠のろわれたかりうど、	《呪われた狩人、ガラク》	名詞
＠のろわれたかりうど、が	《呪われた狩人、ガラク》	名詞
＠のろわれたかりうど、がら	《呪われた狩人、ガラク》	名詞
＠のろわれたかりうど、がらく	《呪われた狩人、ガラク》	名詞
＠ふ	《太っ腹、グラングリー》	名詞
＠ふと	《太っ腹、グラングリー》	名詞
＠ふとっ	《太っ腹、グラングリー》	名詞
＠ふとっぱ	《太っ腹、グラングリー》	名詞
＠ふとっぱら	《太っ腹、グラングリー》	名詞
＠ふとっぱら、	《太っ腹、グラングリー》	名詞
＠ふとっぱら、ぐ	《太っ腹、グラングリー》	名詞
＠ふとっぱら、ぐら	《太っ腹、グラングリー》	名詞
＠ふとっぱら、ぐらん	《太っ腹、グラングリー》	名詞
＠ふとっぱら、ぐらんぐ	《太っ腹、グラングリー》	名詞
＠ふとっぱら、ぐらんぐり	《太っ腹、グラングリー》	名詞
＠ふとっぱら、ぐらんぐりー	《太っ腹、グラングリー》	名詞
＠ひ	《僻境への脱出》	名詞
＠ひが	《僻境への脱出》	名詞
＠ひがみ	《僻境への脱出》	名詞
＠ひがみざ	《僻境への脱出》	名詞
＠ひがみざか	《僻境への脱出》	名詞
＠ひがみざかい	《僻境への脱出》	名詞
＠ひがみざかいへ	《僻境への脱出》	名詞
＠ひがみざかいへの	《僻境への脱出》	名詞
＠ひがみざかいへのだ	《僻境への脱出》	名詞
＠ひがみざかいへのだっ	《僻境への脱出》	名詞
＠ひがみざかいへのだっし	《僻境への脱出》	名詞
＠ひがみざかいへのだっしゅ	《僻境への脱出》	名詞
＠ひがみざかいへのだっしゅつ	《僻境への脱出》	名詞
＠こ	《鼓舞する古参》	名詞
＠こぶ	《鼓舞する古参》	名詞
＠こぶす	《鼓舞する古参》	名詞
＠こぶする	《鼓舞する古参》	名詞
＠こぶするこ	《鼓舞する古参》	名詞
＠こぶするこさ	《鼓舞する古参》	名詞
＠こぶするこさん	《鼓舞する古参》	名詞
＠あ	《荒くれたちの笑い声》	名詞
＠あら	《荒くれたちの笑い声》	名詞
＠あらく	《荒くれたちの笑い声》	名詞
＠あらくれ	《荒くれたちの笑い声》	名詞
＠あらくれた	《荒くれたちの笑い声》	名詞
＠あらくれたち	《荒くれたちの笑い声》	名詞
＠あらくれたちの	《荒くれたちの笑い声》	名詞
＠あらくれたちのわ	《荒くれたちの笑い声》	名詞
＠あらくれたちのわら	《荒くれたちの笑い声》	名詞
＠あらくれたちのわらい	《荒くれたちの笑い声》	名詞
＠あらくれたちのわらいご	《荒くれたちの笑い声》	名詞
＠あらくれたちのわらいごえ	《荒くれたちの笑い声》	名詞
＠ほ	《放浪馬》	名詞
＠ほう	《放浪馬》	名詞
＠ほうろ	《放浪馬》	名詞
＠ほうろう	《放浪馬》	名詞
＠ほうろうば	《放浪馬》	名詞
＠ふ	《フェイ庄の古老》	名詞
＠ふぇ	《フェイ庄の古老》	名詞
＠ふぇい	《フェイ庄の古老》	名詞
＠ふぇいし	《フェイ庄の古老》	名詞
＠ふぇいしょ	《フェイ庄の古老》	名詞
＠ふぇいしょう	《フェイ庄の古老》	名詞
＠ふぇいしょうの	《フェイ庄の古老》	名詞
＠ふぇいしょうのこ	《フェイ庄の古老》	名詞
＠ふぇいしょうのころ	《フェイ庄の古老》	名詞
＠ふぇいしょうのころう	《フェイ庄の古老》	名詞
＠ま	《マラリーフのピクシー》	名詞
＠まら	《マラリーフのピクシー》	名詞
＠まらり	《マラリーフのピクシー》	名詞
＠まらりー	《マラリーフのピクシー》	名詞
＠まらりーふ	《マラリーフのピクシー》	名詞
＠まらりーふの	《マラリーフのピクシー》	名詞
＠まらりーふのぴ	《マラリーフのピクシー》	名詞
＠まらりーふのぴく	《マラリーフのピクシー》	名詞
＠まらりーふのぴくし	《マラリーフのピクシー》	名詞
＠まらりーふのぴくしー	《マラリーフのピクシー》	名詞
＠お	《王冠泥棒、オーコ》	名詞
＠おう	《王冠泥棒、オーコ》	名詞
＠おうか	《王冠泥棒、オーコ》	名詞
＠おうかん	《王冠泥棒、オーコ》	名詞
＠おうかんど	《王冠泥棒、オーコ》	名詞
＠おうかんどろ	《王冠泥棒、オーコ》	名詞
＠おうかんどろぼ	《王冠泥棒、オーコ》	名詞
＠おうかんどろぼう	《王冠泥棒、オーコ》	名詞
＠おうかんどろぼう、	《王冠泥棒、オーコ》	名詞
＠おうかんどろぼう、お	《王冠泥棒、オーコ》	名詞
＠おうかんどろぼう、おー	《王冠泥棒、オーコ》	名詞
＠おうかんどろぼう、おーこ	《王冠泥棒、オーコ》	名詞
＠ひ	《秘儀術師のフクロウ》	名詞
＠ひぎ	《秘儀術師のフクロウ》	名詞
＠ひぎじ	《秘儀術師のフクロウ》	名詞
＠ひぎじゅ	《秘儀術師のフクロウ》	名詞
＠ひぎじゅつ	《秘儀術師のフクロウ》	名詞
＠ひぎじゅつし	《秘儀術師のフクロウ》	名詞
＠ひぎじゅつしの	《秘儀術師のフクロウ》	名詞
＠ひぎじゅつしのふ	《秘儀術師のフクロウ》	名詞
＠ひぎじゅつしのふく	《秘儀術師のフクロウ》	名詞
＠ひぎじゅつしのふくろ	《秘儀術師のフクロウ》	名詞
＠ひぎじゅつしのふくろう	《秘儀術師のフクロウ》	名詞
＠ゆ	《揺るぎない騎士》	名詞
＠ゆる	《揺るぎない騎士》	名詞
＠ゆるぎ	《揺るぎない騎士》	名詞
＠ゆるぎな	《揺るぎない騎士》	名詞
＠ゆるぎない	《揺るぎない騎士》	名詞
＠ゆるぎないき	《揺るぎない騎士》	名詞
＠ゆるぎないきし	《揺るぎない騎士》	名詞
＠よ	《欲深い衝動》	名詞
＠よく	《欲深い衝動》	名詞
＠よくふ	《欲深い衝動》	名詞
＠よくふか	《欲深い衝動》	名詞
＠よくふかい	《欲深い衝動》	名詞
＠よくふかいし	《欲深い衝動》	名詞
＠よくふかいしょ	《欲深い衝動》	名詞
＠よくふかいしょう	《欲深い衝動》	名詞
＠よくふかいしょうど	《欲深い衝動》	名詞
＠よくふかいしょうどう	《欲深い衝動》	名詞
＠ふ	《不死の騎士》	名詞
＠ふし	《不死の騎士》	名詞
＠ふしの	《不死の騎士》	名詞
＠ふしのき	《不死の騎士》	名詞
＠ふしのきし	《不死の騎士》	名詞
＠み	《湖のドラゴン》	名詞
＠みず	《湖のドラゴン》	名詞
＠みずう	《湖のドラゴン》	名詞
＠みずうみ	《湖のドラゴン》	名詞
＠みずうみの	《湖のドラゴン》	名詞
＠みずうみのど	《湖のドラゴン》	名詞
＠みずうみのどら	《湖のドラゴン》	名詞
＠みずうみのどらご	《湖のドラゴン》	名詞
＠みずうみのどらごん	《湖のドラゴン》	名詞
＠く	《首狩りの精鋭》	名詞
＠くび	《首狩りの精鋭》	名詞
＠くびが	《首狩りの精鋭》	名詞
＠くびがり	《首狩りの精鋭》	名詞
＠くびがりの	《首狩りの精鋭》	名詞
＠くびがりのせ	《首狩りの精鋭》	名詞
＠くびがりのせい	《首狩りの精鋭》	名詞
＠くびがりのせいえ	《首狩りの精鋭》	名詞
＠くびがりのせいえい	《首狩りの精鋭》	名詞
＠ひ	《火生まれの騎士》	名詞
＠ひう	《火生まれの騎士》	名詞
＠ひうま	《火生まれの騎士》	名詞
＠ひうまれ	《火生まれの騎士》	名詞
＠ひうまれの	《火生まれの騎士》	名詞
＠ひうまれのき	《火生まれの騎士》	名詞
＠ひうまれのきし	《火生まれの騎士》	名詞
＠る	《塁壁潰し》	名詞
＠るい	《塁壁潰し》	名詞
＠るいへ	《塁壁潰し》	名詞
＠るいへき	《塁壁潰し》	名詞
＠るいへきつ	《塁壁潰し》	名詞
＠るいへきつぶ	《塁壁潰し》	名詞
＠るいへきつぶし	《塁壁潰し》	名詞
＠お	《オークヘイムのレインジャー》	名詞
＠おー	《オークヘイムのレインジャー》	名詞
＠おーく	《オークヘイムのレインジャー》	名詞
＠おーくへ	《オークヘイムのレインジャー》	名詞
＠おーくへい	《オークヘイムのレインジャー》	名詞
＠おーくへいむ	《オークヘイムのレインジャー》	名詞
＠おーくへいむの	《オークヘイムのレインジャー》	名詞
＠おーくへいむのれ	《オークヘイムのレインジャー》	名詞
＠おーくへいむのれい	《オークヘイムのレインジャー》	名詞
＠おーくへいむのれいん	《オークヘイムのレインジャー》	名詞
＠おーくへいむのれいんじ	《オークヘイムのレインジャー》	名詞
＠おーくへいむのれいんじゃ	《オークヘイムのレインジャー》	名詞
＠おーくへいむのれいんじゃー	《オークヘイムのレインジャー》	名詞
＠か	《雷声のカミツキガメ》	名詞
＠かみ	《雷声のカミツキガメ》	名詞
＠かみな	《雷声のカミツキガメ》	名詞
＠かみなり	《雷声のカミツキガメ》	名詞
＠かみなりご	《雷声のカミツキガメ》	名詞
＠かみなりごえ	《雷声のカミツキガメ》	名詞
＠かみなりごえの	《雷声のカミツキガメ》	名詞
＠かみなりごえのか	《雷声のカミツキガメ》	名詞
＠かみなりごえのかみ	《雷声のカミツキガメ》	名詞
＠かみなりごえのかみつ	《雷声のカミツキガメ》	名詞
＠かみなりごえのかみつき	《雷声のカミツキガメ》	名詞
＠かみなりごえのかみつきが	《雷声のカミツキガメ》	名詞
＠かみなりごえのかみつきがめ	《雷声のカミツキガメ》	名詞
＠い	《頂の預言者》	名詞
＠いた	《頂の預言者》	名詞
＠いただ	《頂の預言者》	名詞
＠いただき	《頂の預言者》	名詞
＠いただきの	《頂の預言者》	名詞
＠いただきのよ	《頂の預言者》	名詞
＠いただきのよげ	《頂の預言者》	名詞
＠いただきのよげん	《頂の預言者》	名詞
＠いただきのよげんし	《頂の預言者》	名詞
＠いただきのよげんしゃ	《頂の預言者》	名詞
＠き	《黄金の卵》	名詞
＠きき	《黄金の卵》	名詞
＠ききん	《黄金の卵》	名詞
＠ききんの	《黄金の卵》	名詞
＠ききんのた	《黄金の卵》	名詞
＠ききんのたま	《黄金の卵》	名詞
＠ききんのたまご	《黄金の卵》	名詞
＠さ	《さまよう砦》	名詞
＠さま	《さまよう砦》	名詞
＠さまよ	《さまよう砦》	名詞
＠さまよう	《さまよう砦》	名詞
＠さまようと	《さまよう砦》	名詞
＠さまようとり	《さまよう砦》	名詞
＠さまようとりで	《さまよう砦》	名詞
＠じ	《ジンジャーブルート》	名詞
＠じん	《ジンジャーブルート》	名詞
＠じんじ	《ジンジャーブルート》	名詞
＠じんじゃ	《ジンジャーブルート》	名詞
＠じんじゃー	《ジンジャーブルート》	名詞
＠じんじゃーぶ	《ジンジャーブルート》	名詞
＠じんじゃーぶる	《ジンジャーブルート》	名詞
＠じんじゃーぶるー	《ジンジャーブルート》	名詞
＠じんじゃーぶるーと	《ジンジャーブルート》	名詞
＠に	《煮えたぎる大釜》	名詞
＠にえ	《煮えたぎる大釜》	名詞
＠にえた	《煮えたぎる大釜》	名詞
＠にえたぎ	《煮えたぎる大釜》	名詞
＠にえたぎる	《煮えたぎる大釜》	名詞
＠にえたぎるお	《煮えたぎる大釜》	名詞
＠にえたぎるおお	《煮えたぎる大釜》	名詞
＠にえたぎるおおか	《煮えたぎる大釜》	名詞
＠にえたぎるおおかま	《煮えたぎる大釜》	名詞
＠ば	《馬上槍の練習台》	名詞
＠ばじ	《馬上槍の練習台》	名詞
＠ばじょ	《馬上槍の練習台》	名詞
＠ばじょう	《馬上槍の練習台》	名詞
＠ばじょうや	《馬上槍の練習台》	名詞
＠ばじょうやり	《馬上槍の練習台》	名詞
＠ばじょうやりの	《馬上槍の練習台》	名詞
＠ばじょうやりのれ	《馬上槍の練習台》	名詞
＠ばじょうやりのれん	《馬上槍の練習台》	名詞
＠ばじょうやりのれんし	《馬上槍の練習台》	名詞
＠ばじょうやりのれんしゅ	《馬上槍の練習台》	名詞
＠ばじょうやりのれんしゅう	《馬上槍の練習台》	名詞
＠ばじょうやりのれんしゅうだ	《馬上槍の練習台》	名詞
＠ばじょうやりのれんしゅうだい	《馬上槍の練習台》	名詞
＠は	《跳ね橋》	名詞
＠はね	《跳ね橋》	名詞
＠はねば	《跳ね橋》	名詞
＠はねばし	《跳ね橋》	名詞
＠ぶ	《武器置き台》	名詞
＠ぶき	《武器置き台》	名詞
＠ぶきお	《武器置き台》	名詞
＠ぶきおき	《武器置き台》	名詞
＠ぶきおきだ	《武器置き台》	名詞
＠ぶきおきだい	《武器置き台》	名詞
＠へ	《ヘンジを歩く者》	名詞
＠へん	《ヘンジを歩く者》	名詞
＠へんじ	《ヘンジを歩く者》	名詞
＠へんじを	《ヘンジを歩く者》	名詞
＠へんじをあ	《ヘンジを歩く者》	名詞
＠へんじをある	《ヘンジを歩く者》	名詞
＠へんじをあるく	《ヘンジを歩く者》	名詞
＠へんじをあるくも	《ヘンジを歩く者》	名詞
＠へんじをあるくもの	《ヘンジを歩く者》	名詞
＠み	《道標のカカシ》	名詞
＠みち	《道標のカカシ》	名詞
＠みちし	《道標のカカシ》	名詞
＠みちしる	《道標のカカシ》	名詞
＠みちしるべ	《道標のカカシ》	名詞
＠みちしるべの	《道標のカカシ》	名詞
＠みちしるべのか	《道標のカカシ》	名詞
＠みちしるべのかか	《道標のカカシ》	名詞
＠みちしるべのかかし	《道標のカカシ》	名詞
＠ろ	《ロークスワインのガーゴイル》	名詞
＠ろー	《ロークスワインのガーゴイル》	名詞
＠ろーく	《ロークスワインのガーゴイル》	名詞
＠ろーくす	《ロークスワインのガーゴイル》	名詞
＠ろーくすわ	《ロークスワインのガーゴイル》	名詞
＠ろーくすわい	《ロークスワインのガーゴイル》	名詞
＠ろーくすわいん	《ロークスワインのガーゴイル》	名詞
＠ろーくすわいんの	《ロークスワインのガーゴイル》	名詞
＠ろーくすわいんのが	《ロークスワインのガーゴイル》	名詞
＠ろーくすわいんのがー	《ロークスワインのガーゴイル》	名詞
＠ろーくすわいんのがーご	《ロークスワインのガーゴイル》	名詞
＠ろーくすわいんのがーごい	《ロークスワインのガーゴイル》	名詞
＠ろーくすわいんのがーごいる	《ロークスワインのガーゴイル》	名詞
＠い	《糸車》	名詞
＠いと	《糸車》	名詞
＠いとぐ	《糸車》	名詞
＠いとぐる	《糸車》	名詞
＠いとぐるま	《糸車》	名詞
＠き	《機械仕掛けの召使い》	名詞
＠きか	《機械仕掛けの召使い》	名詞
＠きかい	《機械仕掛けの召使い》	名詞
＠きかいじ	《機械仕掛けの召使い》	名詞
＠きかいじか	《機械仕掛けの召使い》	名詞
＠きかいじかけ	《機械仕掛けの召使い》	名詞
＠きかいじかけの	《機械仕掛けの召使い》	名詞
＠きかいじかけのめ	《機械仕掛けの召使い》	名詞
＠きかいじかけのめし	《機械仕掛けの召使い》	名詞
＠きかいじかけのめしつ	《機械仕掛けの召使い》	名詞
＠きかいじかけのめしつか	《機械仕掛けの召使い》	名詞
＠きかいじかけのめしつかい	《機械仕掛けの召使い》	名詞
＠こ	《幸運のクローバー》	名詞
＠こう	《幸運のクローバー》	名詞
＠こうう	《幸運のクローバー》	名詞
＠こううん	《幸運のクローバー》	名詞
＠こううんの	《幸運のクローバー》	名詞
＠こううんのく	《幸運のクローバー》	名詞
＠こううんのくろ	《幸運のクローバー》	名詞
＠こううんのくろー	《幸運のクローバー》	名詞
＠こううんのくろーば	《幸運のクローバー》	名詞
＠こううんのくろーばー	《幸運のクローバー》	名詞
＠じ	《呪術師のほうき》	名詞
＠じゅ	《呪術師のほうき》	名詞
＠じゅじ	《呪術師のほうき》	名詞
＠じゅじゅ	《呪術師のほうき》	名詞
＠じゅじゅつ	《呪術師のほうき》	名詞
＠じゅじゅつし	《呪術師のほうき》	名詞
＠じゅじゅつしの	《呪術師のほうき》	名詞
＠じゅじゅつしのほ	《呪術師のほうき》	名詞
＠じゅじゅつしのほう	《呪術師のほうき》	名詞
＠じゅじゅつしのほうき	《呪術師のほうき》	名詞
＠し	《知りたがる人形》	名詞
＠しり	《知りたがる人形》	名詞
＠しりた	《知りたがる人形》	名詞
＠しりたが	《知りたがる人形》	名詞
＠しりたがる	《知りたがる人形》	名詞
＠しりたがるに	《知りたがる人形》	名詞
＠しりたがるにん	《知りたがる人形》	名詞
＠しりたがるにんぎ	《知りたがる人形》	名詞
＠しりたがるにんぎょ	《知りたがる人形》	名詞
＠しりたがるにんぎょう	《知りたがる人形》	名詞
＠ま	《魔法の馬車》	名詞
＠まほ	《魔法の馬車》	名詞
＠まほう	《魔法の馬車》	名詞
＠まほうの	《魔法の馬車》	名詞
＠まほうのば	《魔法の馬車》	名詞
＠まほうのばし	《魔法の馬車》	名詞
＠まほうのばしゃ	《魔法の馬車》	名詞
＠ま	《魔女のかまど》	名詞
＠まじ	《魔女のかまど》	名詞
＠まじょ	《魔女のかまど》	名詞
＠まじょの	《魔女のかまど》	名詞
＠まじょのか	《魔女のかまど》	名詞
＠まじょのかま	《魔女のかまど》	名詞
＠まじょのかまど	《魔女のかまど》	名詞
＠も	《紋章旗》	名詞
＠もん	《紋章旗》	名詞
＠もんし	《紋章旗》	名詞
＠もんしょ	《紋章旗》	名詞
＠もんしょう	《紋章旗》	名詞
＠もんしょうば	《紋章旗》	名詞
＠もんしょうばた	《紋章旗》	名詞
＠よ	《よろめく鎧》	名詞
＠よろ	《よろめく鎧》	名詞
＠よろめ	《よろめく鎧》	名詞
＠よろめく	《よろめく鎧》	名詞
＠よろめくよ	《よろめく鎧》	名詞
＠よろめくよろ	《よろめく鎧》	名詞
＠よろめくよろい	《よろめく鎧》	名詞
＠い	《石とぐろの海蛇》	名詞
＠いし	《石とぐろの海蛇》	名詞
＠いしと	《石とぐろの海蛇》	名詞
＠いしとぐ	《石とぐろの海蛇》	名詞
＠いしとぐろ	《石とぐろの海蛇》	名詞
＠いしとぐろの	《石とぐろの海蛇》	名詞
＠いしとぐろのう	《石とぐろの海蛇》	名詞
＠いしとぐろのうみ	《石とぐろの海蛇》	名詞
＠いしとぐろのうみへ	《石とぐろの海蛇》	名詞
＠いしとぐろのうみへび	《石とぐろの海蛇》	名詞
＠ま	《魔術遠眼鏡》	名詞
＠まじ	《魔術遠眼鏡》	名詞
＠まじゅ	《魔術遠眼鏡》	名詞
＠まじゅつ	《魔術遠眼鏡》	名詞
＠まじゅつえ	《魔術遠眼鏡》	名詞
＠まじゅつえん	《魔術遠眼鏡》	名詞
＠まじゅつえんが	《魔術遠眼鏡》	名詞
＠まじゅつえんがん	《魔術遠眼鏡》	名詞
＠まじゅつえんがんき	《魔術遠眼鏡》	名詞
＠まじゅつえんがんきょ	《魔術遠眼鏡》	名詞
＠まじゅつえんがんきょう	《魔術遠眼鏡》	名詞
＠お	《お菓子の小屋》	名詞
＠おか	《お菓子の小屋》	名詞
＠おかし	《お菓子の小屋》	名詞
＠おかしの	《お菓子の小屋》	名詞
＠おかしのこ	《お菓子の小屋》	名詞
＠おかしのこや	《お菓子の小屋》	名詞
＠し	《神秘の聖域》	名詞
＠しん	《神秘の聖域》	名詞
＠しんぴ	《神秘の聖域》	名詞
＠しんぴの	《神秘の聖域》	名詞
＠しんぴのせ	《神秘の聖域》	名詞
＠しんぴのせい	《神秘の聖域》	名詞
＠しんぴのせいい	《神秘の聖域》	名詞
＠しんぴのせいいき	《神秘の聖域》	名詞
＠ど	《ドワーフの鉱山》	名詞
＠どわ	《ドワーフの鉱山》	名詞
＠どわー	《ドワーフの鉱山》	名詞
＠どわーふ	《ドワーフの鉱山》	名詞
＠どわーふの	《ドワーフの鉱山》	名詞
＠どわーふのこ	《ドワーフの鉱山》	名詞
＠どわーふのこう	《ドワーフの鉱山》	名詞
＠どわーふのこうざ	《ドワーフの鉱山》	名詞
＠どわーふのこうざん	《ドワーフの鉱山》	名詞
＠の	《のどかな農場》	名詞
＠のど	《のどかな農場》	名詞
＠のどか	《のどかな農場》	名詞
＠のどかな	《のどかな農場》	名詞
＠のどかなの	《のどかな農場》	名詞
＠のどかなのう	《のどかな農場》	名詞
＠のどかなのうじ	《のどかな農場》	名詞
＠のどかなのうじょ	《のどかな農場》	名詞
＠のどかなのうじょう	《のどかな農場》	名詞
＠ま	《魔女の小屋》	名詞
＠まじ	《魔女の小屋》	名詞
＠まじょ	《魔女の小屋》	名詞
＠まじょの	《魔女の小屋》	名詞
＠まじょのこ	《魔女の小屋》	名詞
＠まじょのこや	《魔女の小屋》	名詞
＠し	《試合場》	名詞
＠しあ	《試合場》	名詞
＠しあい	《試合場》	名詞
＠しあいじ	《試合場》	名詞
＠しあいじょ	《試合場》	名詞
＠しあいじょう	《試合場》	名詞
＠あ	《アーデンベイル城》	名詞
＠あー	《アーデンベイル城》	名詞
＠あーで	《アーデンベイル城》	名詞
＠あーでん	《アーデンベイル城》	名詞
＠あーでんべ	《アーデンベイル城》	名詞
＠あーでんべい	《アーデンベイル城》	名詞
＠あーでんべいる	《アーデンベイル城》	名詞
＠あーでんべいるじ	《アーデンベイル城》	名詞
＠あーでんべいるじょ	《アーデンベイル城》	名詞
＠あーでんべいるじょう	《アーデンベイル城》	名詞
＠え	《エンバレス城》	名詞
＠えん	《エンバレス城》	名詞
＠えんば	《エンバレス城》	名詞
＠えんばれ	《エンバレス城》	名詞
＠えんばれす	《エンバレス城》	名詞
＠えんばれすじ	《エンバレス城》	名詞
＠えんばれすじょ	《エンバレス城》	名詞
＠えんばれすじょう	《エンバレス城》	名詞
＠ヴ	《ヴァントレス城》	名詞
＠ヴぁ	《ヴァントレス城》	名詞
＠ヴぁん	《ヴァントレス城》	名詞
＠ヴぁんと	《ヴァントレス城》	名詞
＠ヴぁんとれ	《ヴァントレス城》	名詞
＠ヴぁんとれす	《ヴァントレス城》	名詞
＠ヴぁんとれすし	《ヴァントレス城》	名詞
＠ヴぁんとれすしろ	《ヴァントレス城》	名詞
＠ぎ	《ギャレンブリグ城》	名詞
＠ぎゃ	《ギャレンブリグ城》	名詞
＠ぎゃれ	《ギャレンブリグ城》	名詞
＠ぎゃれん	《ギャレンブリグ城》	名詞
＠ぎゃれんぶ	《ギャレンブリグ城》	名詞
＠ぎゃれんぶり	《ギャレンブリグ城》	名詞
＠ぎゃれんぶりぐ	《ギャレンブリグ城》	名詞
＠ぎゃれんぶりぐじ	《ギャレンブリグ城》	名詞
＠ぎゃれんぶりぐじょ	《ギャレンブリグ城》	名詞
＠ぎゃれんぶりぐじょう	《ギャレンブリグ城》	名詞
＠ぐ	《寓話の小道》	名詞
＠ぐう	《寓話の小道》	名詞
＠ぐうわ	《寓話の小道》	名詞
＠ぐうわの	《寓話の小道》	名詞
＠ぐうわのこ	《寓話の小道》	名詞
＠ぐうわのこみ	《寓話の小道》	名詞
＠ぐうわのこみち	《寓話の小道》	名詞
＠ろ	《ロークスワイン城》	名詞
＠ろー	《ロークスワイン城》	名詞
＠ろーく	《ロークスワイン城》	名詞
＠ろーくす	《ロークスワイン城》	名詞
＠ろーくすわ	《ロークスワイン城》	名詞
＠ろーくすわい	《ロークスワイン城》	名詞
＠ろーくすわいん	《ロークスワイン城》	名詞
＠ろーくすわいんじ	《ロークスワイン城》	名詞
＠ろーくすわいんじょ	《ロークスワイン城》	名詞
＠ろーくすわいんじょう	《ロークスワイン城》	名詞
＠ふ	《フェイに呪われた王、コルヴォルド》	名詞
＠ふぇ	《フェイに呪われた王、コルヴォルド》	名詞
＠ふぇい	《フェイに呪われた王、コルヴォルド》	名詞
＠ふぇいに	《フェイに呪われた王、コルヴォルド》	名詞
＠ふぇいにの	《フェイに呪われた王、コルヴォルド》	名詞
＠ふぇいにのろ	《フェイに呪われた王、コルヴォルド》	名詞
＠ふぇいにのろわ	《フェイに呪われた王、コルヴォルド》	名詞
＠ふぇいにのろわれ	《フェイに呪われた王、コルヴォルド》	名詞
＠ふぇいにのろわれた	《フェイに呪われた王、コルヴォルド》	名詞
＠ふぇいにのろわれたお	《フェイに呪われた王、コルヴォルド》	名詞
＠ふぇいにのろわれたおう	《フェイに呪われた王、コルヴォルド》	名詞
＠ふぇいにのろわれたおう、	《フェイに呪われた王、コルヴォルド》	名詞
＠ふぇいにのろわれたおう、こ	《フェイに呪われた王、コルヴォルド》	名詞
＠ふぇいにのろわれたおう、こる	《フェイに呪われた王、コルヴォルド》	名詞
＠ふぇいにのろわれたおう、こるヴ	《フェイに呪われた王、コルヴォルド》	名詞
＠ふぇいにのろわれたおう、こるヴぉ	《フェイに呪われた王、コルヴォルド》	名詞
＠ふぇいにのろわれたおう、こるヴぉる	《フェイに呪われた王、コルヴォルド》	名詞
＠ふぇいにのろわれたおう、こるヴぉるど	《フェイに呪われた王、コルヴォルド》	名詞
＠こ	《フェイに呪われた王、コルヴォルド》	名詞
＠こる	《フェイに呪われた王、コルヴォルド》	名詞
＠こるヴ	《フェイに呪われた王、コルヴォルド》	名詞
＠こるヴぉ	《フェイに呪われた王、コルヴォルド》	名詞
＠こるヴぉる	《フェイに呪われた王、コルヴォルド》	名詞
＠こるヴぉるど	《フェイに呪われた王、コルヴォルド》	名詞
