＠さ	《さし迫った破滅》	名詞
＠さし	《さし迫った破滅》	名詞
＠さしせ	《さし迫った破滅》	名詞
＠さしせま	《さし迫った破滅》	名詞
＠さしせまっ	《さし迫った破滅》	名詞
＠さしせまった	《さし迫った破滅》	名詞
＠さしせまったは	《さし迫った破滅》	名詞
＠さしせまったはめ	《さし迫った破滅》	名詞
＠さしせまったはめつ	《さし迫った破滅》	名詞
＠ぬ	《ぬかるみのトリトン》	名詞
＠ぬか	《ぬかるみのトリトン》	名詞
＠ぬかる	《ぬかるみのトリトン》	名詞
＠ぬかるみ	《ぬかるみのトリトン》	名詞
＠ぬかるみの	《ぬかるみのトリトン》	名詞
＠ぬかるみのと	《ぬかるみのトリトン》	名詞
＠ぬかるみのとり	《ぬかるみのトリトン》	名詞
＠ぬかるみのとりと	《ぬかるみのトリトン》	名詞
＠ぬかるみのとりとん	《ぬかるみのトリトン》	名詞
＠ぬ	《ぬかるみの捕縛》	名詞
＠ぬか	《ぬかるみの捕縛》	名詞
＠ぬかる	《ぬかるみの捕縛》	名詞
＠ぬかるみ	《ぬかるみの捕縛》	名詞
＠ぬかるみの	《ぬかるみの捕縛》	名詞
＠ぬかるみのほ	《ぬかるみの捕縛》	名詞
＠ぬかるみのほば	《ぬかるみの捕縛》	名詞
＠ぬかるみのほばく	《ぬかるみの捕縛》	名詞
＠わ	《わしづかみの巨人》	名詞
＠わし	《わしづかみの巨人》	名詞
＠わしづ	《わしづかみの巨人》	名詞
＠わしづか	《わしづかみの巨人》	名詞
＠わしづかみ	《わしづかみの巨人》	名詞
＠わしづかみの	《わしづかみの巨人》	名詞
＠わしづかみのき	《わしづかみの巨人》	名詞
＠わしづかみのきょ	《わしづかみの巨人》	名詞
＠わしづかみのきょじ	《わしづかみの巨人》	名詞
＠わしづかみのきょじん	《わしづかみの巨人》	名詞
＠あ	《アクロスの古参兵、タラニカ》	名詞
＠あく	《アクロスの古参兵、タラニカ》	名詞
＠あくろ	《アクロスの古参兵、タラニカ》	名詞
＠あくろす	《アクロスの古参兵、タラニカ》	名詞
＠あくろすの	《アクロスの古参兵、タラニカ》	名詞
＠あくろすのこ	《アクロスの古参兵、タラニカ》	名詞
＠あくろすのこさ	《アクロスの古参兵、タラニカ》	名詞
＠あくろすのこさん	《アクロスの古参兵、タラニカ》	名詞
＠あくろすのこさんへ	《アクロスの古参兵、タラニカ》	名詞
＠あくろすのこさんへい	《アクロスの古参兵、タラニカ》	名詞
＠あくろすのこさんへい、	《アクロスの古参兵、タラニカ》	名詞
＠あくろすのこさんへい、た	《アクロスの古参兵、タラニカ》	名詞
＠あくろすのこさんへい、たら	《アクロスの古参兵、タラニカ》	名詞
＠あくろすのこさんへい、たらに	《アクロスの古参兵、タラニカ》	名詞
＠あくろすのこさんへい、たらにか	《アクロスの古参兵、タラニカ》	名詞
＠た	《アクロスの古参兵、タラニカ》	名詞
＠たら	《アクロスの古参兵、タラニカ》	名詞
＠たらに	《アクロスの古参兵、タラニカ》	名詞
＠たらにか	《アクロスの古参兵、タラニカ》	名詞
＠あ	《アクロス戦争》	名詞
＠あく	《アクロス戦争》	名詞
＠あくろ	《アクロス戦争》	名詞
＠あくろす	《アクロス戦争》	名詞
＠あくろすせ	《アクロス戦争》	名詞
＠あくろすせん	《アクロス戦争》	名詞
＠あくろすせんそ	《アクロス戦争》	名詞
＠あくろすせんそう	《アクロス戦争》	名詞
＠あ	《アゴナスの雄牛》	名詞
＠あご	《アゴナスの雄牛》	名詞
＠あごな	《アゴナスの雄牛》	名詞
＠あごなす	《アゴナスの雄牛》	名詞
＠あごなすの	《アゴナスの雄牛》	名詞
＠あごなすのお	《アゴナスの雄牛》	名詞
＠あごなすのおう	《アゴナスの雄牛》	名詞
＠あごなすのおうし	《アゴナスの雄牛》	名詞
＠あ	《アショクの先駆け》	名詞
＠あし	《アショクの先駆け》	名詞
＠あしょ	《アショクの先駆け》	名詞
＠あしょく	《アショクの先駆け》	名詞
＠あしょくの	《アショクの先駆け》	名詞
＠あしょくのさ	《アショクの先駆け》	名詞
＠あしょくのさき	《アショクの先駆け》	名詞
＠あしょくのさきが	《アショクの先駆け》	名詞
＠あしょくのさきがけ	《アショクの先駆け》	名詞
＠あ	《アショクの消去》	名詞
＠あし	《アショクの消去》	名詞
＠あしょ	《アショクの消去》	名詞
＠あしょく	《アショクの消去》	名詞
＠あしょくの	《アショクの消去》	名詞
＠あしょくのし	《アショクの消去》	名詞
＠あしょくのしょ	《アショクの消去》	名詞
＠あしょくのしょう	《アショクの消去》	名詞
＠あしょくのしょうき	《アショクの消去》	名詞
＠あしょくのしょうきょ	《アショクの消去》	名詞
＠あ	《アスフォデルの灰色商人》	名詞
＠あす	《アスフォデルの灰色商人》	名詞
＠あすふ	《アスフォデルの灰色商人》	名詞
＠あすふぉ	《アスフォデルの灰色商人》	名詞
＠あすふぉで	《アスフォデルの灰色商人》	名詞
＠あすふぉでる	《アスフォデルの灰色商人》	名詞
＠あすふぉでるの	《アスフォデルの灰色商人》	名詞
＠あすふぉでるのは	《アスフォデルの灰色商人》	名詞
＠あすふぉでるのはい	《アスフォデルの灰色商人》	名詞
＠あすふぉでるのはいい	《アスフォデルの灰色商人》	名詞
＠あすふぉでるのはいいろ	《アスフォデルの灰色商人》	名詞
＠あすふぉでるのはいいろし	《アスフォデルの灰色商人》	名詞
＠あすふぉでるのはいいろしょ	《アスフォデルの灰色商人》	名詞
＠あすふぉでるのはいいろしょう	《アスフォデルの灰色商人》	名詞
＠あすふぉでるのはいいろしょうに	《アスフォデルの灰色商人》	名詞
＠あすふぉでるのはいいろしょうにん	《アスフォデルの灰色商人》	名詞
＠あ	《アナックスの勝利》	名詞
＠あな	《アナックスの勝利》	名詞
＠あなっ	《アナックスの勝利》	名詞
＠あなっく	《アナックスの勝利》	名詞
＠あなっくす	《アナックスの勝利》	名詞
＠あなっくすの	《アナックスの勝利》	名詞
＠あなっくすのし	《アナックスの勝利》	名詞
＠あなっくすのしょ	《アナックスの勝利》	名詞
＠あなっくすのしょう	《アナックスの勝利》	名詞
＠あなっくすのしょうり	《アナックスの勝利》	名詞
＠い	《イリーシアの女像樹》	名詞
＠いり	《イリーシアの女像樹》	名詞
＠いりー	《イリーシアの女像樹》	名詞
＠いりーし	《イリーシアの女像樹》	名詞
＠いりーしあ	《イリーシアの女像樹》	名詞
＠いりーしあの	《イリーシアの女像樹》	名詞
＠いりーしあのお	《イリーシアの女像樹》	名詞
＠いりーしあのおん	《イリーシアの女像樹》	名詞
＠いりーしあのおんな	《イリーシアの女像樹》	名詞
＠いりーしあのおんなぞ	《イリーシアの女像樹》	名詞
＠いりーしあのおんなぞう	《イリーシアの女像樹》	名詞
＠いりーしあのおんなぞうき	《イリーシアの女像樹》	名詞
＠い	《イリーシア木立のドライアド》	名詞
＠いり	《イリーシア木立のドライアド》	名詞
＠いりー	《イリーシア木立のドライアド》	名詞
＠いりーし	《イリーシア木立のドライアド》	名詞
＠いりーしあ	《イリーシア木立のドライアド》	名詞
＠いりーしあこ	《イリーシア木立のドライアド》	名詞
＠いりーしあこだ	《イリーシア木立のドライアド》	名詞
＠いりーしあこだち	《イリーシア木立のドライアド》	名詞
＠いりーしあこだちの	《イリーシア木立のドライアド》	名詞
＠いりーしあこだちのど	《イリーシア木立のドライアド》	名詞
＠いりーしあこだちのどら	《イリーシア木立のドライアド》	名詞
＠いりーしあこだちのどらい	《イリーシア木立のドライアド》	名詞
＠いりーしあこだちのどらいあ	《イリーシア木立のドライアド》	名詞
＠いりーしあこだちのどらいあど	《イリーシア木立のドライアド》	名詞
＠い	《イロアスの寵児》	名詞
＠いろ	《イロアスの寵児》	名詞
＠いろあ	《イロアスの寵児》	名詞
＠いろあす	《イロアスの寵児》	名詞
＠いろあすの	《イロアスの寵児》	名詞
＠いろあすのち	《イロアスの寵児》	名詞
＠いろあすのちょ	《イロアスの寵児》	名詞
＠いろあすのちょう	《イロアスの寵児》	名詞
＠いろあすのちょうじ	《イロアスの寵児》	名詞
＠い	《イロアスの恩寵》	名詞
＠いろ	《イロアスの恩寵》	名詞
＠いろあ	《イロアスの恩寵》	名詞
＠いろあす	《イロアスの恩寵》	名詞
＠いろあすの	《イロアスの恩寵》	名詞
＠いろあすのお	《イロアスの恩寵》	名詞
＠いろあすのおん	《イロアスの恩寵》	名詞
＠いろあすのおんち	《イロアスの恩寵》	名詞
＠いろあすのおんちょ	《イロアスの恩寵》	名詞
＠いろあすのおんちょう	《イロアスの恩寵》	名詞
＠え	《エイスリオスの番犬、クノロス》	名詞
＠えい	《エイスリオスの番犬、クノロス》	名詞
＠えいす	《エイスリオスの番犬、クノロス》	名詞
＠えいすり	《エイスリオスの番犬、クノロス》	名詞
＠えいすりお	《エイスリオスの番犬、クノロス》	名詞
＠えいすりおす	《エイスリオスの番犬、クノロス》	名詞
＠えいすりおすの	《エイスリオスの番犬、クノロス》	名詞
＠えいすりおすのば	《エイスリオスの番犬、クノロス》	名詞
＠えいすりおすのばん	《エイスリオスの番犬、クノロス》	名詞
＠えいすりおすのばんけ	《エイスリオスの番犬、クノロス》	名詞
＠えいすりおすのばんけん	《エイスリオスの番犬、クノロス》	名詞
＠えいすりおすのばんけん、	《エイスリオスの番犬、クノロス》	名詞
＠えいすりおすのばんけん、く	《エイスリオスの番犬、クノロス》	名詞
＠えいすりおすのばんけん、くの	《エイスリオスの番犬、クノロス》	名詞
＠えいすりおすのばんけん、くのろ	《エイスリオスの番犬、クノロス》	名詞
＠えいすりおすのばんけん、くのろす	《エイスリオスの番犬、クノロス》	名詞
＠く	《エイスリオスの番犬、クノロス》	名詞
＠くの	《エイスリオスの番犬、クノロス》	名詞
＠くのろ	《エイスリオスの番犬、クノロス》	名詞
＠くのろす	《エイスリオスの番犬、クノロス》	名詞
＠え	《エルズペス、死に打ち勝つ》	名詞
＠える	《エルズペス、死に打ち勝つ》	名詞
＠えるず	《エルズペス、死に打ち勝つ》	名詞
＠えるずぺ	《エルズペス、死に打ち勝つ》	名詞
＠えるずぺす	《エルズペス、死に打ち勝つ》	名詞
＠えるずぺす、	《エルズペス、死に打ち勝つ》	名詞
＠えるずぺす、し	《エルズペス、死に打ち勝つ》	名詞
＠えるずぺす、しに	《エルズペス、死に打ち勝つ》	名詞
＠えるずぺす、しにう	《エルズペス、死に打ち勝つ》	名詞
＠えるずぺす、しにうち	《エルズペス、死に打ち勝つ》	名詞
＠えるずぺす、しにうちか	《エルズペス、死に打ち勝つ》	名詞
＠えるずぺす、しにうちかつ	《エルズペス、死に打ち勝つ》	名詞
＠え	《エルズペスの信奉者》	名詞
＠える	《エルズペスの信奉者》	名詞
＠えるず	《エルズペスの信奉者》	名詞
＠えるずぺ	《エルズペスの信奉者》	名詞
＠えるずぺす	《エルズペスの信奉者》	名詞
＠えるずぺすの	《エルズペスの信奉者》	名詞
＠えるずぺすのし	《エルズペスの信奉者》	名詞
＠えるずぺすのしん	《エルズペスの信奉者》	名詞
＠えるずぺすのしんぽ	《エルズペスの信奉者》	名詞
＠えるずぺすのしんぽう	《エルズペスの信奉者》	名詞
＠えるずぺすのしんぽうし	《エルズペスの信奉者》	名詞
＠えるずぺすのしんぽうしゃ	《エルズペスの信奉者》	名詞
＠え	《エルズペスの悪夢》	名詞
＠える	《エルズペスの悪夢》	名詞
＠えるず	《エルズペスの悪夢》	名詞
＠えるずぺ	《エルズペスの悪夢》	名詞
＠えるずぺす	《エルズペスの悪夢》	名詞
＠えるずぺすの	《エルズペスの悪夢》	名詞
＠えるずぺすのあ	《エルズペスの悪夢》	名詞
＠えるずぺすのあく	《エルズペスの悪夢》	名詞
＠えるずぺすのあくむ	《エルズペスの悪夢》	名詞
＠え	《エレボスの介入》	名詞
＠えれ	《エレボスの介入》	名詞
＠えれぼ	《エレボスの介入》	名詞
＠えれぼす	《エレボスの介入》	名詞
＠えれぼすの	《エレボスの介入》	名詞
＠えれぼすのか	《エレボスの介入》	名詞
＠えれぼすのかい	《エレボスの介入》	名詞
＠えれぼすのかいに	《エレボスの介入》	名詞
＠えれぼすのかいにゅ	《エレボスの介入》	名詞
＠えれぼすのかいにゅう	《エレボスの介入》	名詞
＠き	《キオーラ、海神を打ち倒す》	名詞
＠きお	《キオーラ、海神を打ち倒す》	名詞
＠きおー	《キオーラ、海神を打ち倒す》	名詞
＠きおーら	《キオーラ、海神を打ち倒す》	名詞
＠きおーら、	《キオーラ、海神を打ち倒す》	名詞
＠きおーら、か	《キオーラ、海神を打ち倒す》	名詞
＠きおーら、かい	《キオーラ、海神を打ち倒す》	名詞
＠きおーら、かいじ	《キオーラ、海神を打ち倒す》	名詞
＠きおーら、かいじん	《キオーラ、海神を打ち倒す》	名詞
＠きおーら、かいじんを	《キオーラ、海神を打ち倒す》	名詞
＠きおーら、かいじんをう	《キオーラ、海神を打ち倒す》	名詞
＠きおーら、かいじんをうち	《キオーラ、海神を打ち倒す》	名詞
＠きおーら、かいじんをうちた	《キオーラ、海神を打ち倒す》	名詞
＠きおーら、かいじんをうちたお	《キオーラ、海神を打ち倒す》	名詞
＠きおーら、かいじんをうちたおす	《キオーラ、海神を打ち倒す》	名詞
＠く	《クローティスの企図》	名詞
＠くろ	《クローティスの企図》	名詞
＠くろー	《クローティスの企図》	名詞
＠くろーて	《クローティスの企図》	名詞
＠くろーてぃ	《クローティスの企図》	名詞
＠くろーてぃす	《クローティスの企図》	名詞
＠くろーてぃすの	《クローティスの企図》	名詞
＠くろーてぃすのき	《クローティスの企図》	名詞
＠くろーてぃすのきと	《クローティスの企図》	名詞
＠け	《ケイラメトラの恩恵》	名詞
＠けい	《ケイラメトラの恩恵》	名詞
＠けいら	《ケイラメトラの恩恵》	名詞
＠けいらめ	《ケイラメトラの恩恵》	名詞
＠けいらめと	《ケイラメトラの恩恵》	名詞
＠けいらめとら	《ケイラメトラの恩恵》	名詞
＠けいらめとらの	《ケイラメトラの恩恵》	名詞
＠けいらめとらのお	《ケイラメトラの恩恵》	名詞
＠けいらめとらのおん	《ケイラメトラの恩恵》	名詞
＠けいらめとらのおんけ	《ケイラメトラの恩恵》	名詞
＠けいらめとらのおんけい	《ケイラメトラの恩恵》	名詞
＠さ	《サテュロスの悪知恵》	名詞
＠さて	《サテュロスの悪知恵》	名詞
＠さてゅ	《サテュロスの悪知恵》	名詞
＠さてゅろ	《サテュロスの悪知恵》	名詞
＠さてゅろす	《サテュロスの悪知恵》	名詞
＠さてゅろすの	《サテュロスの悪知恵》	名詞
＠さてゅろすのわ	《サテュロスの悪知恵》	名詞
＠さてゅろすのわる	《サテュロスの悪知恵》	名詞
＠さてゅろすのわるぢ	《サテュロスの悪知恵》	名詞
＠さてゅろすのわるぢえ	《サテュロスの悪知恵》	名詞
＠す	《スコフォスの戦導者》	名詞
＠すこ	《スコフォスの戦導者》	名詞
＠すこふ	《スコフォスの戦導者》	名詞
＠すこふぉ	《スコフォスの戦導者》	名詞
＠すこふぉす	《スコフォスの戦導者》	名詞
＠すこふぉすの	《スコフォスの戦導者》	名詞
＠すこふぉすのい	《スコフォスの戦導者》	名詞
＠すこふぉすのいく	《スコフォスの戦導者》	名詞
＠すこふぉすのいくさ	《スコフォスの戦導者》	名詞
＠すこふぉすのいくさし	《スコフォスの戦導者》	名詞
＠すこふぉすのいくさしる	《スコフォスの戦導者》	名詞
＠すこふぉすのいくさしるべ	《スコフォスの戦導者》	名詞
＠すこふぉすのいくさしるべし	《スコフォスの戦導者》	名詞
＠すこふぉすのいくさしるべしゃ	《スコフォスの戦導者》	名詞
＠す	《スコフォスの迷宮》	名詞
＠すこ	《スコフォスの迷宮》	名詞
＠すこふ	《スコフォスの迷宮》	名詞
＠すこふぉ	《スコフォスの迷宮》	名詞
＠すこふぉす	《スコフォスの迷宮》	名詞
＠すこふぉすの	《スコフォスの迷宮》	名詞
＠すこふぉすのめ	《スコフォスの迷宮》	名詞
＠すこふぉすのめい	《スコフォスの迷宮》	名詞
＠すこふぉすのめいき	《スコフォスの迷宮》	名詞
＠すこふぉすのめいきゅ	《スコフォスの迷宮》	名詞
＠すこふぉすのめいきゅう	《スコフォスの迷宮》	名詞
＠す	《スコフォスの迷宮守り》	名詞
＠すこ	《スコフォスの迷宮守り》	名詞
＠すこふ	《スコフォスの迷宮守り》	名詞
＠すこふぉ	《スコフォスの迷宮守り》	名詞
＠すこふぉす	《スコフォスの迷宮守り》	名詞
＠すこふぉすの	《スコフォスの迷宮守り》	名詞
＠すこふぉすのめ	《スコフォスの迷宮守り》	名詞
＠すこふぉすのめい	《スコフォスの迷宮守り》	名詞
＠すこふぉすのめいき	《スコフォスの迷宮守り》	名詞
＠すこふぉすのめいきゅ	《スコフォスの迷宮守り》	名詞
＠すこふぉすのめいきゅう	《スコフォスの迷宮守り》	名詞
＠すこふぉすのめいきゅうま	《スコフォスの迷宮守り》	名詞
＠すこふぉすのめいきゅうまも	《スコフォスの迷宮守り》	名詞
＠すこふぉすのめいきゅうまもり	《スコフォスの迷宮守り》	名詞
＠す	《スコラの木立ち踊り》	名詞
＠すこ	《スコラの木立ち踊り》	名詞
＠すこら	《スコラの木立ち踊り》	名詞
＠すこらの	《スコラの木立ち踊り》	名詞
＠すこらのき	《スコラの木立ち踊り》	名詞
＠すこらのきだ	《スコラの木立ち踊り》	名詞
＠すこらのきだち	《スコラの木立ち踊り》	名詞
＠すこらのきだちお	《スコラの木立ち踊り》	名詞
＠すこらのきだちおど	《スコラの木立ち踊り》	名詞
＠すこらのきだちおどり	《スコラの木立ち踊り》	名詞
＠す	《スフィンクスの精神壊し》	名詞
＠すふ	《スフィンクスの精神壊し》	名詞
＠すふぃ	《スフィンクスの精神壊し》	名詞
＠すふぃん	《スフィンクスの精神壊し》	名詞
＠すふぃんく	《スフィンクスの精神壊し》	名詞
＠すふぃんくす	《スフィンクスの精神壊し》	名詞
＠すふぃんくすの	《スフィンクスの精神壊し》	名詞
＠すふぃんくすのせ	《スフィンクスの精神壊し》	名詞
＠すふぃんくすのせい	《スフィンクスの精神壊し》	名詞
＠すふぃんくすのせいし	《スフィンクスの精神壊し》	名詞
＠すふぃんくすのせいしん	《スフィンクスの精神壊し》	名詞
＠すふぃんくすのせいしんこ	《スフィンクスの精神壊し》	名詞
＠すふぃんくすのせいしんこわ	《スフィンクスの精神壊し》	名詞
＠すふぃんくすのせいしんこわし	《スフィンクスの精神壊し》	名詞
＠せ	《セテッサの勇者》	名詞
＠せて	《セテッサの勇者》	名詞
＠せてっ	《セテッサの勇者》	名詞
＠せてっさ	《セテッサの勇者》	名詞
＠せてっさの	《セテッサの勇者》	名詞
＠せてっさのゆ	《セテッサの勇者》	名詞
＠せてっさのゆう	《セテッサの勇者》	名詞
＠せてっさのゆうし	《セテッサの勇者》	名詞
＠せてっさのゆうしゃ	《セテッサの勇者》	名詞
＠せ	《セテッサの散兵》	名詞
＠せて	《セテッサの散兵》	名詞
＠せてっ	《セテッサの散兵》	名詞
＠せてっさ	《セテッサの散兵》	名詞
＠せてっさの	《セテッサの散兵》	名詞
＠せてっさのば	《セテッサの散兵》	名詞
＠せてっさのばら	《セテッサの散兵》	名詞
＠せてっさのばらへ	《セテッサの散兵》	名詞
＠せてっさのばらへい	《セテッサの散兵》	名詞
＠せ	《セテッサの請願者》	名詞
＠せて	《セテッサの請願者》	名詞
＠せてっ	《セテッサの請願者》	名詞
＠せてっさ	《セテッサの請願者》	名詞
＠せてっさの	《セテッサの請願者》	名詞
＠せてっさのせ	《セテッサの請願者》	名詞
＠せてっさのせい	《セテッサの請願者》	名詞
＠せてっさのせいが	《セテッサの請願者》	名詞
＠せてっさのせいがん	《セテッサの請願者》	名詞
＠せてっさのせいがんし	《セテッサの請願者》	名詞
＠せてっさのせいがんしゃ	《セテッサの請願者》	名詞
＠せ	《セテッサ式訓練》	名詞
＠せて	《セテッサ式訓練》	名詞
＠せてっ	《セテッサ式訓練》	名詞
＠せてっさ	《セテッサ式訓練》	名詞
＠せてっさし	《セテッサ式訓練》	名詞
＠せてっさしき	《セテッサ式訓練》	名詞
＠せてっさしきく	《セテッサ式訓練》	名詞
＠せてっさしきくん	《セテッサ式訓練》	名詞
＠せてっさしきくんれ	《セテッサ式訓練》	名詞
＠せてっさしきくんれん	《セテッサ式訓練》	名詞
＠た	《タイタンたちの軛》	名詞
＠たい	《タイタンたちの軛》	名詞
＠たいた	《タイタンたちの軛》	名詞
＠たいたん	《タイタンたちの軛》	名詞
＠たいたんた	《タイタンたちの軛》	名詞
＠たいたんたち	《タイタンたちの軛》	名詞
＠たいたんたちの	《タイタンたちの軛》	名詞
＠たいたんたちのく	《タイタンたちの軛》	名詞
＠たいたんたちのくび	《タイタンたちの軛》	名詞
＠たいたんたちのくびき	《タイタンたちの軛》	名詞
＠た	《タッサの介入》	名詞
＠たっ	《タッサの介入》	名詞
＠たっさ	《タッサの介入》	名詞
＠たっさの	《タッサの介入》	名詞
＠たっさのか	《タッサの介入》	名詞
＠たっさのかい	《タッサの介入》	名詞
＠たっさのかいに	《タッサの介入》	名詞
＠たっさのかいにゅ	《タッサの介入》	名詞
＠たっさのかいにゅう	《タッサの介入》	名詞
＠た	《タッサの神託者》	名詞
＠たっ	《タッサの神託者》	名詞
＠たっさ	《タッサの神託者》	名詞
＠たっさの	《タッサの神託者》	名詞
＠たっさのし	《タッサの神託者》	名詞
＠たっさのしん	《タッサの神託者》	名詞
＠たっさのしんた	《タッサの神託者》	名詞
＠たっさのしんたく	《タッサの神託者》	名詞
＠たっさのしんたくし	《タッサの神託者》	名詞
＠たっさのしんたくしゃ	《タッサの神託者》	名詞
＠て	《ティゼルスの果実》	名詞
＠てぃ	《ティゼルスの果実》	名詞
＠てぃぜ	《ティゼルスの果実》	名詞
＠てぃぜる	《ティゼルスの果実》	名詞
＠てぃぜるす	《ティゼルスの果実》	名詞
＠てぃぜるすの	《ティゼルスの果実》	名詞
＠てぃぜるすのか	《ティゼルスの果実》	名詞
＠てぃぜるすのかじ	《ティゼルスの果実》	名詞
＠てぃぜるすのかじつ	《ティゼルスの果実》	名詞
＠て	《ティマレット、死者を呼び出す》	名詞
＠てぃ	《ティマレット、死者を呼び出す》	名詞
＠てぃま	《ティマレット、死者を呼び出す》	名詞
＠てぃまれ	《ティマレット、死者を呼び出す》	名詞
＠てぃまれっ	《ティマレット、死者を呼び出す》	名詞
＠てぃまれっと	《ティマレット、死者を呼び出す》	名詞
＠てぃまれっと、	《ティマレット、死者を呼び出す》	名詞
＠てぃまれっと、し	《ティマレット、死者を呼び出す》	名詞
＠てぃまれっと、しし	《ティマレット、死者を呼び出す》	名詞
＠てぃまれっと、ししゃ	《ティマレット、死者を呼び出す》	名詞
＠てぃまれっと、ししゃを	《ティマレット、死者を呼び出す》	名詞
＠てぃまれっと、ししゃをよ	《ティマレット、死者を呼び出す》	名詞
＠てぃまれっと、ししゃをよび	《ティマレット、死者を呼び出す》	名詞
＠てぃまれっと、ししゃをよびだ	《ティマレット、死者を呼び出す》	名詞
＠てぃまれっと、ししゃをよびだす	《ティマレット、死者を呼び出す》	名詞
＠と	《トリトンの波渡り》	名詞
＠とり	《トリトンの波渡り》	名詞
＠とりと	《トリトンの波渡り》	名詞
＠とりとん	《トリトンの波渡り》	名詞
＠とりとんの	《トリトンの波渡り》	名詞
＠とりとんのな	《トリトンの波渡り》	名詞
＠とりとんのなみ	《トリトンの波渡り》	名詞
＠とりとんのなみわ	《トリトンの波渡り》	名詞
＠とりとんのなみわた	《トリトンの波渡り》	名詞
＠とりとんのなみわたり	《トリトンの波渡り》	名詞
＠な	《ナイレアの介入》	名詞
＠ない	《ナイレアの介入》	名詞
＠ないれ	《ナイレアの介入》	名詞
＠ないれあ	《ナイレアの介入》	名詞
＠ないれあの	《ナイレアの介入》	名詞
＠ないれあのか	《ナイレアの介入》	名詞
＠ないれあのかい	《ナイレアの介入》	名詞
＠ないれあのかいに	《ナイレアの介入》	名詞
＠ないれあのかいにゅ	《ナイレアの介入》	名詞
＠ないれあのかいにゅう	《ナイレアの介入》	名詞
＠な	《ナイレアの先駆け》	名詞
＠ない	《ナイレアの先駆け》	名詞
＠ないれ	《ナイレアの先駆け》	名詞
＠ないれあ	《ナイレアの先駆け》	名詞
＠ないれあの	《ナイレアの先駆け》	名詞
＠ないれあのさ	《ナイレアの先駆け》	名詞
＠ないれあのさき	《ナイレアの先駆け》	名詞
＠ないれあのさきが	《ナイレアの先駆け》	名詞
＠ないれあのさきがけ	《ナイレアの先駆け》	名詞
＠な	《ナイレアの猟匠》	名詞
＠ない	《ナイレアの猟匠》	名詞
＠ないれ	《ナイレアの猟匠》	名詞
＠ないれあ	《ナイレアの猟匠》	名詞
＠ないれあの	《ナイレアの猟匠》	名詞
＠ないれあのり	《ナイレアの猟匠》	名詞
＠ないれあのりょ	《ナイレアの猟匠》	名詞
＠ないれあのりょう	《ナイレアの猟匠》	名詞
＠ないれあのりょうた	《ナイレアの猟匠》	名詞
＠ないれあのりょうたく	《ナイレアの猟匠》	名詞
＠ないれあのりょうたくみ	《ナイレアの猟匠》	名詞
＠に	《ニクスの伝令》	名詞
＠にく	《ニクスの伝令》	名詞
＠にくす	《ニクスの伝令》	名詞
＠にくすの	《ニクスの伝令》	名詞
＠にくすので	《ニクスの伝令》	名詞
＠にくすのでん	《ニクスの伝令》	名詞
＠にくすのでんれ	《ニクスの伝令》	名詞
＠にくすのでんれい	《ニクスの伝令》	名詞
＠に	《ニクスの睡蓮》	名詞
＠にく	《ニクスの睡蓮》	名詞
＠にくす	《ニクスの睡蓮》	名詞
＠にくすの	《ニクスの睡蓮》	名詞
＠にくすのす	《ニクスの睡蓮》	名詞
＠にくすのすい	《ニクスの睡蓮》	名詞
＠にくすのすいれ	《ニクスの睡蓮》	名詞
＠にくすのすいれん	《ニクスの睡蓮》	名詞
＠に	《ニクス咲きの古きもの》	名詞
＠にく	《ニクス咲きの古きもの》	名詞
＠にくす	《ニクス咲きの古きもの》	名詞
＠にくすざ	《ニクス咲きの古きもの》	名詞
＠にくすざき	《ニクス咲きの古きもの》	名詞
＠にくすざきの	《ニクス咲きの古きもの》	名詞
＠にくすざきのふ	《ニクス咲きの古きもの》	名詞
＠にくすざきのふる	《ニクス咲きの古きもの》	名詞
＠にくすざきのふるき	《ニクス咲きの古きもの》	名詞
＠にくすざきのふるきも	《ニクス咲きの古きもの》	名詞
＠にくすざきのふるきもの	《ニクス咲きの古きもの》	名詞
＠に	《ニクス生まれの匪賊》	名詞
＠にく	《ニクス生まれの匪賊》	名詞
＠にくす	《ニクス生まれの匪賊》	名詞
＠にくすう	《ニクス生まれの匪賊》	名詞
＠にくすうま	《ニクス生まれの匪賊》	名詞
＠にくすうまれ	《ニクス生まれの匪賊》	名詞
＠にくすうまれの	《ニクス生まれの匪賊》	名詞
＠にくすうまれのひ	《ニクス生まれの匪賊》	名詞
＠にくすうまれのひぞ	《ニクス生まれの匪賊》	名詞
＠にくすうまれのひぞく	《ニクス生まれの匪賊》	名詞
＠に	《ニクス生まれの巨人》	名詞
＠にく	《ニクス生まれの巨人》	名詞
＠にくす	《ニクス生まれの巨人》	名詞
＠にくすう	《ニクス生まれの巨人》	名詞
＠にくすうま	《ニクス生まれの巨人》	名詞
＠にくすうまれ	《ニクス生まれの巨人》	名詞
＠にくすうまれの	《ニクス生まれの巨人》	名詞
＠にくすうまれのき	《ニクス生まれの巨人》	名詞
＠にくすうまれのきょ	《ニクス生まれの巨人》	名詞
＠にくすうまれのきょじ	《ニクス生まれの巨人》	名詞
＠にくすうまれのきょじん	《ニクス生まれの巨人》	名詞
＠に	《ニクス生まれの海護》	名詞
＠にく	《ニクス生まれの海護》	名詞
＠にくす	《ニクス生まれの海護》	名詞
＠にくすう	《ニクス生まれの海護》	名詞
＠にくすうま	《ニクス生まれの海護》	名詞
＠にくすうまれ	《ニクス生まれの海護》	名詞
＠にくすうまれの	《ニクス生まれの海護》	名詞
＠にくすうまれのう	《ニクス生まれの海護》	名詞
＠にくすうまれのうみ	《ニクス生まれの海護》	名詞
＠にくすうまれのうみま	《ニクス生まれの海護》	名詞
＠にくすうまれのうみまも	《ニクス生まれの海護》	名詞
＠にくすうまれのうみまもり	《ニクス生まれの海護》	名詞
＠に	《ニクス生まれの狩猟者》	名詞
＠にく	《ニクス生まれの狩猟者》	名詞
＠にくす	《ニクス生まれの狩猟者》	名詞
＠にくすう	《ニクス生まれの狩猟者》	名詞
＠にくすうま	《ニクス生まれの狩猟者》	名詞
＠にくすうまれ	《ニクス生まれの狩猟者》	名詞
＠にくすうまれの	《ニクス生まれの狩猟者》	名詞
＠にくすうまれのし	《ニクス生まれの狩猟者》	名詞
＠にくすうまれのしゅ	《ニクス生まれの狩猟者》	名詞
＠にくすうまれのしゅり	《ニクス生まれの狩猟者》	名詞
＠にくすうまれのしゅりょ	《ニクス生まれの狩猟者》	名詞
＠にくすうまれのしゅりょう	《ニクス生まれの狩猟者》	名詞
＠にくすうまれのしゅりょうし	《ニクス生まれの狩猟者》	名詞
＠にくすうまれのしゅりょうしゃ	《ニクス生まれの狩猟者》	名詞
＠に	《ニクス生まれの粗暴者》	名詞
＠にく	《ニクス生まれの粗暴者》	名詞
＠にくす	《ニクス生まれの粗暴者》	名詞
＠にくすう	《ニクス生まれの粗暴者》	名詞
＠にくすうま	《ニクス生まれの粗暴者》	名詞
＠にくすうまれ	《ニクス生まれの粗暴者》	名詞
＠にくすうまれの	《ニクス生まれの粗暴者》	名詞
＠にくすうまれのそ	《ニクス生まれの粗暴者》	名詞
＠にくすうまれのそぼ	《ニクス生まれの粗暴者》	名詞
＠にくすうまれのそぼう	《ニクス生まれの粗暴者》	名詞
＠にくすうまれのそぼうし	《ニクス生まれの粗暴者》	名詞
＠にくすうまれのそぼうしゃ	《ニクス生まれの粗暴者》	名詞
＠に	《ニクス生まれの英雄》	名詞
＠にく	《ニクス生まれの英雄》	名詞
＠にくす	《ニクス生まれの英雄》	名詞
＠にくすう	《ニクス生まれの英雄》	名詞
＠にくすうま	《ニクス生まれの英雄》	名詞
＠にくすうまれ	《ニクス生まれの英雄》	名詞
＠にくすうまれの	《ニクス生まれの英雄》	名詞
＠にくすうまれのえ	《ニクス生まれの英雄》	名詞
＠にくすうまれのえい	《ニクス生まれの英雄》	名詞
＠にくすうまれのえいゆ	《ニクス生まれの英雄》	名詞
＠にくすうまれのえいゆう	《ニクス生まれの英雄》	名詞
＠ね	《ネシアンの放浪者》	名詞
＠ねし	《ネシアンの放浪者》	名詞
＠ねしあ	《ネシアンの放浪者》	名詞
＠ねしあん	《ネシアンの放浪者》	名詞
＠ねしあんの	《ネシアンの放浪者》	名詞
＠ねしあんのほ	《ネシアンの放浪者》	名詞
＠ねしあんのほう	《ネシアンの放浪者》	名詞
＠ねしあんのほうろ	《ネシアンの放浪者》	名詞
＠ねしあんのほうろう	《ネシアンの放浪者》	名詞
＠ねしあんのほうろうし	《ネシアンの放浪者》	名詞
＠ねしあんのほうろうしゃ	《ネシアンの放浪者》	名詞
＠ね	《ネシアンの猪》	名詞
＠ねし	《ネシアンの猪》	名詞
＠ねしあ	《ネシアンの猪》	名詞
＠ねしあん	《ネシアンの猪》	名詞
＠ねしあんの	《ネシアンの猪》	名詞
＠ねしあんのい	《ネシアンの猪》	名詞
＠ねしあんのいの	《ネシアンの猪》	名詞
＠ねしあんのいのし	《ネシアンの猪》	名詞
＠ねしあんのいのしし	《ネシアンの猪》	名詞
＠ね	《ネシアンの角甲虫》	名詞
＠ねし	《ネシアンの角甲虫》	名詞
＠ねしあ	《ネシアンの角甲虫》	名詞
＠ねしあん	《ネシアンの角甲虫》	名詞
＠ねしあんの	《ネシアンの角甲虫》	名詞
＠ねしあんのか	《ネシアンの角甲虫》	名詞
＠ねしあんのかく	《ネシアンの角甲虫》	名詞
＠ねしあんのかくか	《ネシアンの角甲虫》	名詞
＠ねしあんのかくかぶ	《ネシアンの角甲虫》	名詞
＠ねしあんのかくかぶと	《ネシアンの角甲虫》	名詞
＠ねしあんのかくかぶとむ	《ネシアンの角甲虫》	名詞
＠ねしあんのかくかぶとむし	《ネシアンの角甲虫》	名詞
＠は	《ハイドラの成長》	名詞
＠はい	《ハイドラの成長》	名詞
＠はいど	《ハイドラの成長》	名詞
＠はいどら	《ハイドラの成長》	名詞
＠はいどらの	《ハイドラの成長》	名詞
＠はいどらのせ	《ハイドラの成長》	名詞
＠はいどらのせい	《ハイドラの成長》	名詞
＠はいどらのせいち	《ハイドラの成長》	名詞
＠はいどらのせいちょ	《ハイドラの成長》	名詞
＠はいどらのせいちょう	《ハイドラの成長》	名詞
＠は	《ハイラックス塔の斥候》	名詞
＠はい	《ハイラックス塔の斥候》	名詞
＠はいら	《ハイラックス塔の斥候》	名詞
＠はいらっ	《ハイラックス塔の斥候》	名詞
＠はいらっく	《ハイラックス塔の斥候》	名詞
＠はいらっくす	《ハイラックス塔の斥候》	名詞
＠はいらっくすと	《ハイラックス塔の斥候》	名詞
＠はいらっくすとう	《ハイラックス塔の斥候》	名詞
＠はいらっくすとうの	《ハイラックス塔の斥候》	名詞
＠はいらっくすとうのせ	《ハイラックス塔の斥候》	名詞
＠はいらっくすとうのせっ	《ハイラックス塔の斥候》	名詞
＠はいらっくすとうのせっこ	《ハイラックス塔の斥候》	名詞
＠はいらっくすとうのせっこう	《ハイラックス塔の斥候》	名詞
＠ぱ	《パーフォロスの介入》	名詞
＠ぱー	《パーフォロスの介入》	名詞
＠ぱーふ	《パーフォロスの介入》	名詞
＠ぱーふぉ	《パーフォロスの介入》	名詞
＠ぱーふぉろ	《パーフォロスの介入》	名詞
＠ぱーふぉろす	《パーフォロスの介入》	名詞
＠ぱーふぉろすの	《パーフォロスの介入》	名詞
＠ぱーふぉろすのか	《パーフォロスの介入》	名詞
＠ぱーふぉろすのかい	《パーフォロスの介入》	名詞
＠ぱーふぉろすのかいに	《パーフォロスの介入》	名詞
＠ぱーふぉろすのかいにゅ	《パーフォロスの介入》	名詞
＠ぱーふぉろすのかいにゅう	《パーフォロスの介入》	名詞
＠ぴ	《ピレアス号の艦長、シオーナ》	名詞
＠ぴれ	《ピレアス号の艦長、シオーナ》	名詞
＠ぴれあ	《ピレアス号の艦長、シオーナ》	名詞
＠ぴれあす	《ピレアス号の艦長、シオーナ》	名詞
＠ぴれあすご	《ピレアス号の艦長、シオーナ》	名詞
＠ぴれあすごう	《ピレアス号の艦長、シオーナ》	名詞
＠ぴれあすごうの	《ピレアス号の艦長、シオーナ》	名詞
＠ぴれあすごうのか	《ピレアス号の艦長、シオーナ》	名詞
＠ぴれあすごうのかん	《ピレアス号の艦長、シオーナ》	名詞
＠ぴれあすごうのかんち	《ピレアス号の艦長、シオーナ》	名詞
＠ぴれあすごうのかんちょ	《ピレアス号の艦長、シオーナ》	名詞
＠ぴれあすごうのかんちょう	《ピレアス号の艦長、シオーナ》	名詞
＠ぴれあすごうのかんちょう、	《ピレアス号の艦長、シオーナ》	名詞
＠ぴれあすごうのかんちょう、し	《ピレアス号の艦長、シオーナ》	名詞
＠ぴれあすごうのかんちょう、しお	《ピレアス号の艦長、シオーナ》	名詞
＠ぴれあすごうのかんちょう、しおー	《ピレアス号の艦長、シオーナ》	名詞
＠ぴれあすごうのかんちょう、しおーな	《ピレアス号の艦長、シオーナ》	名詞
＠し	《ピレアス号の艦長、シオーナ》	名詞
＠しお	《ピレアス号の艦長、シオーナ》	名詞
＠しおー	《ピレアス号の艦長、シオーナ》	名詞
＠しおーな	《ピレアス号の艦長、シオーナ》	名詞
＠ふ	《ファリカの献杯》	名詞
＠ふぁ	《ファリカの献杯》	名詞
＠ふぁり	《ファリカの献杯》	名詞
＠ふぁりか	《ファリカの献杯》	名詞
＠ふぁりかの	《ファリカの献杯》	名詞
＠ふぁりかのけ	《ファリカの献杯》	名詞
＠ふぁりかのけん	《ファリカの献杯》	名詞
＠ふぁりかのけんぱ	《ファリカの献杯》	名詞
＠ふぁりかのけんぱい	《ファリカの献杯》	名詞
＠ふ	《ファリカの落とし子》	名詞
＠ふぁ	《ファリカの落とし子》	名詞
＠ふぁり	《ファリカの落とし子》	名詞
＠ふぁりか	《ファリカの落とし子》	名詞
＠ふぁりかの	《ファリカの落とし子》	名詞
＠ふぁりかのお	《ファリカの落とし子》	名詞
＠ふぁりかのおと	《ファリカの落とし子》	名詞
＠ふぁりかのおとし	《ファリカの落とし子》	名詞
＠ふぁりかのおとしご	《ファリカの落とし子》	名詞
＠ふ	《フィーリーズ団の喧嘩屋》	名詞
＠ふぃ	《フィーリーズ団の喧嘩屋》	名詞
＠ふぃー	《フィーリーズ団の喧嘩屋》	名詞
＠ふぃーり	《フィーリーズ団の喧嘩屋》	名詞
＠ふぃーりー	《フィーリーズ団の喧嘩屋》	名詞
＠ふぃーりーず	《フィーリーズ団の喧嘩屋》	名詞
＠ふぃーりーずだ	《フィーリーズ団の喧嘩屋》	名詞
＠ふぃーりーずだん	《フィーリーズ団の喧嘩屋》	名詞
＠ふぃーりーずだんの	《フィーリーズ団の喧嘩屋》	名詞
＠ふぃーりーずだんのけ	《フィーリーズ団の喧嘩屋》	名詞
＠ふぃーりーずだんのけん	《フィーリーズ団の喧嘩屋》	名詞
＠ふぃーりーずだんのけんか	《フィーリーズ団の喧嘩屋》	名詞
＠ふぃーりーずだんのけんかや	《フィーリーズ団の喧嘩屋》	名詞
＠へ	《ヘリオッドの介入》	名詞
＠へり	《ヘリオッドの介入》	名詞
＠へりお	《ヘリオッドの介入》	名詞
＠へりおっ	《ヘリオッドの介入》	名詞
＠へりおっど	《ヘリオッドの介入》	名詞
＠へりおっどの	《ヘリオッドの介入》	名詞
＠へりおっどのか	《ヘリオッドの介入》	名詞
＠へりおっどのかい	《ヘリオッドの介入》	名詞
＠へりおっどのかいに	《ヘリオッドの介入》	名詞
＠へりおっどのかいにゅ	《ヘリオッドの介入》	名詞
＠へりおっどのかいにゅう	《ヘリオッドの介入》	名詞
＠へ	《ヘリオッドの巡礼者》	名詞
＠へり	《ヘリオッドの巡礼者》	名詞
＠へりお	《ヘリオッドの巡礼者》	名詞
＠へりおっ	《ヘリオッドの巡礼者》	名詞
＠へりおっど	《ヘリオッドの巡礼者》	名詞
＠へりおっどの	《ヘリオッドの巡礼者》	名詞
＠へりおっどのじ	《ヘリオッドの巡礼者》	名詞
＠へりおっどのじゅ	《ヘリオッドの巡礼者》	名詞
＠へりおっどのじゅん	《ヘリオッドの巡礼者》	名詞
＠へりおっどのじゅんれ	《ヘリオッドの巡礼者》	名詞
＠へりおっどのじゅんれい	《ヘリオッドの巡礼者》	名詞
＠へりおっどのじゅんれいし	《ヘリオッドの巡礼者》	名詞
＠へりおっどのじゅんれいしゃ	《ヘリオッドの巡礼者》	名詞
＠へ	《ヘリオッドの神罰》	名詞
＠へり	《ヘリオッドの神罰》	名詞
＠へりお	《ヘリオッドの神罰》	名詞
＠へりおっ	《ヘリオッドの神罰》	名詞
＠へりおっど	《ヘリオッドの神罰》	名詞
＠へりおっどの	《ヘリオッドの神罰》	名詞
＠へりおっどのし	《ヘリオッドの神罰》	名詞
＠へりおっどのしん	《ヘリオッドの神罰》	名詞
＠へりおっどのしんば	《ヘリオッドの神罰》	名詞
＠へりおっどのしんばつ	《ヘリオッドの神罰》	名詞
＠ま	《マンティコアの様相》	名詞
＠まん	《マンティコアの様相》	名詞
＠まんて	《マンティコアの様相》	名詞
＠まんてぃ	《マンティコアの様相》	名詞
＠まんてぃこ	《マンティコアの様相》	名詞
＠まんてぃこあ	《マンティコアの様相》	名詞
＠まんてぃこあの	《マンティコアの様相》	名詞
＠まんてぃこあのよ	《マンティコアの様相》	名詞
＠まんてぃこあのよう	《マンティコアの様相》	名詞
＠まんてぃこあのようそ	《マンティコアの様相》	名詞
＠まんてぃこあのようそう	《マンティコアの様相》	名詞
＠め	《メドマイの予言》	名詞
＠めど	《メドマイの予言》	名詞
＠めどま	《メドマイの予言》	名詞
＠めどまい	《メドマイの予言》	名詞
＠めどまいの	《メドマイの予言》	名詞
＠めどまいのよ	《メドマイの予言》	名詞
＠めどまいのよげ	《メドマイの予言》	名詞
＠めどまいのよげん	《メドマイの予言》	名詞
＠め	《メレティス誕生》	名詞
＠めれ	《メレティス誕生》	名詞
＠めれて	《メレティス誕生》	名詞
＠めれてぃ	《メレティス誕生》	名詞
＠めれてぃす	《メレティス誕生》	名詞
＠めれてぃすた	《メレティス誕生》	名詞
＠めれてぃすたん	《メレティス誕生》	名詞
＠めれてぃすたんじ	《メレティス誕生》	名詞
＠めれてぃすたんじょ	《メレティス誕生》	名詞
＠めれてぃすたんじょう	《メレティス誕生》	名詞
＠も	《モーギスの好意》	名詞
＠もー	《モーギスの好意》	名詞
＠もーぎ	《モーギスの好意》	名詞
＠もーぎす	《モーギスの好意》	名詞
＠もーぎすの	《モーギスの好意》	名詞
＠もーぎすのこ	《モーギスの好意》	名詞
＠もーぎすのこう	《モーギスの好意》	名詞
＠もーぎすのこうい	《モーギスの好意》	名詞
＠も	《モーギスの殺戮神官》	名詞
＠もー	《モーギスの殺戮神官》	名詞
＠もーぎ	《モーギスの殺戮神官》	名詞
＠もーぎす	《モーギスの殺戮神官》	名詞
＠もーぎすの	《モーギスの殺戮神官》	名詞
＠もーぎすのさ	《モーギスの殺戮神官》	名詞
＠もーぎすのさつ	《モーギスの殺戮神官》	名詞
＠もーぎすのさつり	《モーギスの殺戮神官》	名詞
＠もーぎすのさつりく	《モーギスの殺戮神官》	名詞
＠もーぎすのさつりくし	《モーギスの殺戮神官》	名詞
＠もーぎすのさつりくしん	《モーギスの殺戮神官》	名詞
＠もーぎすのさつりくしんか	《モーギスの殺戮神官》	名詞
＠もーぎすのさつりくしんかん	《モーギスの殺戮神官》	名詞
＠も	《モーギスの魂刈り》	名詞
＠もー	《モーギスの魂刈り》	名詞
＠もーぎ	《モーギスの魂刈り》	名詞
＠もーぎす	《モーギスの魂刈り》	名詞
＠もーぎすの	《モーギスの魂刈り》	名詞
＠もーぎすのた	《モーギスの魂刈り》	名詞
＠もーぎすのたま	《モーギスの魂刈り》	名詞
＠もーぎすのたまし	《モーギスの魂刈り》	名詞
＠もーぎすのたましい	《モーギスの魂刈り》	名詞
＠もーぎすのたましいが	《モーギスの魂刈り》	名詞
＠もーぎすのたましいがり	《モーギスの魂刈り》	名詞
＠や	《ヤツメの様相》	名詞
＠やつ	《ヤツメの様相》	名詞
＠やつめ	《ヤツメの様相》	名詞
＠やつめの	《ヤツメの様相》	名詞
＠やつめのよ	《ヤツメの様相》	名詞
＠やつめのよう	《ヤツメの様相》	名詞
＠やつめのようそ	《ヤツメの様相》	名詞
＠やつめのようそう	《ヤツメの様相》	名詞
＠ら	《ラゴンナ団の語り部》	名詞
＠らご	《ラゴンナ団の語り部》	名詞
＠らごん	《ラゴンナ団の語り部》	名詞
＠らごんな	《ラゴンナ団の語り部》	名詞
＠らごんなだ	《ラゴンナ団の語り部》	名詞
＠らごんなだん	《ラゴンナ団の語り部》	名詞
＠らごんなだんの	《ラゴンナ団の語り部》	名詞
＠らごんなだんのか	《ラゴンナ団の語り部》	名詞
＠らごんなだんのかた	《ラゴンナ団の語り部》	名詞
＠らごんなだんのかたり	《ラゴンナ団の語り部》	名詞
＠らごんなだんのかたりべ	《ラゴンナ団の語り部》	名詞
＠ヴ	《ヴェリュス山の恐怖》	名詞
＠ヴぇ	《ヴェリュス山の恐怖》	名詞
＠ヴぇり	《ヴェリュス山の恐怖》	名詞
＠ヴぇりゅ	《ヴェリュス山の恐怖》	名詞
＠ヴぇりゅす	《ヴェリュス山の恐怖》	名詞
＠ヴぇりゅすや	《ヴェリュス山の恐怖》	名詞
＠ヴぇりゅすやま	《ヴェリュス山の恐怖》	名詞
＠ヴぇりゅすやまの	《ヴェリュス山の恐怖》	名詞
＠ヴぇりゅすやまのき	《ヴェリュス山の恐怖》	名詞
＠ヴぇりゅすやまのきょ	《ヴェリュス山の恐怖》	名詞
＠ヴぇりゅすやまのきょう	《ヴェリュス山の恐怖》	名詞
＠ヴぇりゅすやまのきょうふ	《ヴェリュス山の恐怖》	名詞
＠ま	《万神殿の祭壇》	名詞
＠まん	《万神殿の祭壇》	名詞
＠まんし	《万神殿の祭壇》	名詞
＠まんしん	《万神殿の祭壇》	名詞
＠まんしんで	《万神殿の祭壇》	名詞
＠まんしんでん	《万神殿の祭壇》	名詞
＠まんしんでんの	《万神殿の祭壇》	名詞
＠まんしんでんのさ	《万神殿の祭壇》	名詞
＠まんしんでんのさい	《万神殿の祭壇》	名詞
＠まんしんでんのさいだ	《万神殿の祭壇》	名詞
＠まんしんでんのさいだん	《万神殿の祭壇》	名詞
＠げ	《下僕の復活》	名詞
＠げぼ	《下僕の復活》	名詞
＠げぼく	《下僕の復活》	名詞
＠げぼくの	《下僕の復活》	名詞
＠げぼくのふ	《下僕の復活》	名詞
＠げぼくのふっ	《下僕の復活》	名詞
＠げぼくのふっか	《下僕の復活》	名詞
＠げぼくのふっかつ	《下僕の復活》	名詞
＠ふ	《不協和音の笛吹き》	名詞
＠ふき	《不協和音の笛吹き》	名詞
＠ふきょ	《不協和音の笛吹き》	名詞
＠ふきょう	《不協和音の笛吹き》	名詞
＠ふきょうわ	《不協和音の笛吹き》	名詞
＠ふきょうわお	《不協和音の笛吹き》	名詞
＠ふきょうわおん	《不協和音の笛吹き》	名詞
＠ふきょうわおんの	《不協和音の笛吹き》	名詞
＠ふきょうわおんのふ	《不協和音の笛吹き》	名詞
＠ふきょうわおんのふえ	《不協和音の笛吹き》	名詞
＠ふきょうわおんのふえふ	《不協和音の笛吹き》	名詞
＠ふきょうわおんのふえふき	《不協和音の笛吹き》	名詞
＠ふ	《不屈の英雄、エルズペス》	名詞
＠ふく	《不屈の英雄、エルズペス》	名詞
＠ふくつ	《不屈の英雄、エルズペス》	名詞
＠ふくつの	《不屈の英雄、エルズペス》	名詞
＠ふくつのえ	《不屈の英雄、エルズペス》	名詞
＠ふくつのえい	《不屈の英雄、エルズペス》	名詞
＠ふくつのえいゆ	《不屈の英雄、エルズペス》	名詞
＠ふくつのえいゆう	《不屈の英雄、エルズペス》	名詞
＠ふくつのえいゆう、	《不屈の英雄、エルズペス》	名詞
＠ふくつのえいゆう、え	《不屈の英雄、エルズペス》	名詞
＠ふくつのえいゆう、える	《不屈の英雄、エルズペス》	名詞
＠ふくつのえいゆう、えるず	《不屈の英雄、エルズペス》	名詞
＠ふくつのえいゆう、えるずぺ	《不屈の英雄、エルズペス》	名詞
＠ふくつのえいゆう、えるずぺす	《不屈の英雄、エルズペス》	名詞
＠え	《不屈の英雄、エルズペス》	名詞
＠える	《不屈の英雄、エルズペス》	名詞
＠えるず	《不屈の英雄、エルズペス》	名詞
＠えるずぺ	《不屈の英雄、エルズペス》	名詞
＠えるずぺす	《不屈の英雄、エルズペス》	名詞
＠ふ	《不退転の意志》	名詞
＠ふた	《不退転の意志》	名詞
＠ふたい	《不退転の意志》	名詞
＠ふたいこ	《不退転の意志》	名詞
＠ふたいころ	《不退転の意志》	名詞
＠ふたいころが	《不退転の意志》	名詞
＠ふたいころがし	《不退転の意志》	名詞
＠ふたいころがしの	《不退転の意志》	名詞
＠ふたいころがしのい	《不退転の意志》	名詞
＠ふたいころがしのいし	《不退転の意志》	名詞
＠ふ	《不遜な歓楽者》	名詞
＠ふそ	《不遜な歓楽者》	名詞
＠ふそん	《不遜な歓楽者》	名詞
＠ふそんな	《不遜な歓楽者》	名詞
＠ふそんなか	《不遜な歓楽者》	名詞
＠ふそんなかん	《不遜な歓楽者》	名詞
＠ふそんなかんら	《不遜な歓楽者》	名詞
＠ふそんなかんらく	《不遜な歓楽者》	名詞
＠ふそんなかんらくし	《不遜な歓楽者》	名詞
＠ふそんなかんらくしゃ	《不遜な歓楽者》	名詞
＠ち	《二柱に愛されしユートロピア》	名詞
＠ちゅ	《二柱に愛されしユートロピア》	名詞
＠ちゅう	《二柱に愛されしユートロピア》	名詞
＠ちゅうに	《二柱に愛されしユートロピア》	名詞
＠ちゅうにあ	《二柱に愛されしユートロピア》	名詞
＠ちゅうにあい	《二柱に愛されしユートロピア》	名詞
＠ちゅうにあいさ	《二柱に愛されしユートロピア》	名詞
＠ちゅうにあいされ	《二柱に愛されしユートロピア》	名詞
＠ちゅうにあいされし	《二柱に愛されしユートロピア》	名詞
＠ちゅうにあいされしゆ	《二柱に愛されしユートロピア》	名詞
＠ちゅうにあいされしゆー	《二柱に愛されしユートロピア》	名詞
＠ちゅうにあいされしゆーと	《二柱に愛されしユートロピア》	名詞
＠ちゅうにあいされしゆーとろ	《二柱に愛されしユートロピア》	名詞
＠ちゅうにあいされしゆーとろぴ	《二柱に愛されしユートロピア》	名詞
＠ちゅうにあいされしゆーとろぴあ	《二柱に愛されしユートロピア》	名詞
＠ご	《傲慢の翼》	名詞
＠ごう	《傲慢の翼》	名詞
＠ごうま	《傲慢の翼》	名詞
＠ごうまん	《傲慢の翼》	名詞
＠ごうまんの	《傲慢の翼》	名詞
＠ごうまんのつ	《傲慢の翼》	名詞
＠ごうまんのつば	《傲慢の翼》	名詞
＠ごうまんのつばさ	《傲慢の翼》	名詞
＠せ	《凄絶な無気力》	名詞
＠せい	《凄絶な無気力》	名詞
＠せいぜ	《凄絶な無気力》	名詞
＠せいぜつ	《凄絶な無気力》	名詞
＠せいぜつな	《凄絶な無気力》	名詞
＠せいぜつなむ	《凄絶な無気力》	名詞
＠せいぜつなむき	《凄絶な無気力》	名詞
＠せいぜつなむきり	《凄絶な無気力》	名詞
＠せいぜつなむきりょ	《凄絶な無気力》	名詞
＠せいぜつなむきりょく	《凄絶な無気力》	名詞
＠し	《勝利の特使》	名詞
＠しょ	《勝利の特使》	名詞
＠しょう	《勝利の特使》	名詞
＠しょうり	《勝利の特使》	名詞
＠しょうりの	《勝利の特使》	名詞
＠しょうりのと	《勝利の特使》	名詞
＠しょうりのとく	《勝利の特使》	名詞
＠しょうりのとくし	《勝利の特使》	名詞
＠し	《勝利への躍進》	名詞
＠しょ	《勝利への躍進》	名詞
＠しょう	《勝利への躍進》	名詞
＠しょうり	《勝利への躍進》	名詞
＠しょうりへ	《勝利への躍進》	名詞
＠しょうりへの	《勝利への躍進》	名詞
＠しょうりへのや	《勝利への躍進》	名詞
＠しょうりへのやく	《勝利への躍進》	名詞
＠しょうりへのやくし	《勝利への躍進》	名詞
＠しょうりへのやくしん	《勝利への躍進》	名詞
＠は	《半真実の神託者、アトリス》	名詞
＠はん	《半真実の神託者、アトリス》	名詞
＠はんし	《半真実の神託者、アトリス》	名詞
＠はんしん	《半真実の神託者、アトリス》	名詞
＠はんしんじ	《半真実の神託者、アトリス》	名詞
＠はんしんじつ	《半真実の神託者、アトリス》	名詞
＠はんしんじつの	《半真実の神託者、アトリス》	名詞
＠はんしんじつのし	《半真実の神託者、アトリス》	名詞
＠はんしんじつのしん	《半真実の神託者、アトリス》	名詞
＠はんしんじつのしんた	《半真実の神託者、アトリス》	名詞
＠はんしんじつのしんたく	《半真実の神託者、アトリス》	名詞
＠はんしんじつのしんたくし	《半真実の神託者、アトリス》	名詞
＠はんしんじつのしんたくしゃ	《半真実の神託者、アトリス》	名詞
＠はんしんじつのしんたくしゃ、	《半真実の神託者、アトリス》	名詞
＠はんしんじつのしんたくしゃ、あ	《半真実の神託者、アトリス》	名詞
＠はんしんじつのしんたくしゃ、あと	《半真実の神託者、アトリス》	名詞
＠はんしんじつのしんたくしゃ、あとり	《半真実の神託者、アトリス》	名詞
＠はんしんじつのしんたくしゃ、あとりす	《半真実の神託者、アトリス》	名詞
＠あ	《半真実の神託者、アトリス》	名詞
＠あと	《半真実の神託者、アトリス》	名詞
＠あとり	《半真実の神託者、アトリス》	名詞
＠あとりす	《半真実の神託者、アトリス》	名詞
＠た	《卓絶した特使》	名詞
＠たく	《卓絶した特使》	名詞
＠たくぜ	《卓絶した特使》	名詞
＠たくぜつ	《卓絶した特使》	名詞
＠たくぜつし	《卓絶した特使》	名詞
＠たくぜつした	《卓絶した特使》	名詞
＠たくぜつしたと	《卓絶した特使》	名詞
＠たくぜつしたとく	《卓絶した特使》	名詞
＠たくぜつしたとくし	《卓絶した特使》	名詞
＠げ	《厳格な放逐》	名詞
＠げん	《厳格な放逐》	名詞
＠げんか	《厳格な放逐》	名詞
＠げんかく	《厳格な放逐》	名詞
＠げんかくな	《厳格な放逐》	名詞
＠げんかくなほ	《厳格な放逐》	名詞
＠げんかくなほう	《厳格な放逐》	名詞
＠げんかくなほうち	《厳格な放逐》	名詞
＠げんかくなほうちく	《厳格な放逐》	名詞
＠い	《命の恵みのアルセイド》	名詞
＠いの	《命の恵みのアルセイド》	名詞
＠いのち	《命の恵みのアルセイド》	名詞
＠いのちの	《命の恵みのアルセイド》	名詞
＠いのちのめ	《命の恵みのアルセイド》	名詞
＠いのちのめぐ	《命の恵みのアルセイド》	名詞
＠いのちのめぐみ	《命の恵みのアルセイド》	名詞
＠いのちのめぐみの	《命の恵みのアルセイド》	名詞
＠いのちのめぐみのあ	《命の恵みのアルセイド》	名詞
＠いのちのめぐみのある	《命の恵みのアルセイド》	名詞
＠いのちのめぐみのあるせ	《命の恵みのアルセイド》	名詞
＠いのちのめぐみのあるせい	《命の恵みのアルセイド》	名詞
＠いのちのめぐみのあるせいど	《命の恵みのアルセイド》	名詞
＠て	《哲学の幻霊》	名詞
＠てつ	《哲学の幻霊》	名詞
＠てつが	《哲学の幻霊》	名詞
＠てつがく	《哲学の幻霊》	名詞
＠てつがくの	《哲学の幻霊》	名詞
＠てつがくのま	《哲学の幻霊》	名詞
＠てつがくのまぼ	《哲学の幻霊》	名詞
＠てつがくのまぼろ	《哲学の幻霊》	名詞
＠てつがくのまぼろし	《哲学の幻霊》	名詞
＠てつがくのまぼろしれ	《哲学の幻霊》	名詞
＠てつがくのまぼろしれい	《哲学の幻霊》	名詞
＠け	《啓蒙の敵》	名詞
＠けい	《啓蒙の敵》	名詞
＠けいも	《啓蒙の敵》	名詞
＠けいもう	《啓蒙の敵》	名詞
＠けいもうの	《啓蒙の敵》	名詞
＠けいもうのて	《啓蒙の敵》	名詞
＠けいもうのてき	《啓蒙の敵》	名詞
＠け	《啓蒙の神殿》	名詞
＠けい	《啓蒙の神殿》	名詞
＠けいも	《啓蒙の神殿》	名詞
＠けいもう	《啓蒙の神殿》	名詞
＠けいもうの	《啓蒙の神殿》	名詞
＠けいもうのし	《啓蒙の神殿》	名詞
＠けいもうのしん	《啓蒙の神殿》	名詞
＠けいもうのしんで	《啓蒙の神殿》	名詞
＠けいもうのしんでん	《啓蒙の神殿》	名詞
＠あ	《圧倒的洞察》	名詞
＠あっ	《圧倒的洞察》	名詞
＠あっと	《圧倒的洞察》	名詞
＠あっとう	《圧倒的洞察》	名詞
＠あっとうて	《圧倒的洞察》	名詞
＠あっとうてき	《圧倒的洞察》	名詞
＠あっとうてきど	《圧倒的洞察》	名詞
＠あっとうてきどう	《圧倒的洞察》	名詞
＠あっとうてきどうさ	《圧倒的洞察》	名詞
＠あっとうてきどうさつ	《圧倒的洞察》	名詞
＠じ	《地獄界の夢》	名詞
＠じご	《地獄界の夢》	名詞
＠じごく	《地獄界の夢》	名詞
＠じごくか	《地獄界の夢》	名詞
＠じごくかい	《地獄界の夢》	名詞
＠じごくかいの	《地獄界の夢》	名詞
＠じごくかいのゆ	《地獄界の夢》	名詞
＠じごくかいのゆめ	《地獄界の夢》	名詞
＠じ	《地盤の巨人》	名詞
＠じば	《地盤の巨人》	名詞
＠じばん	《地盤の巨人》	名詞
＠じばんの	《地盤の巨人》	名詞
＠じばんのき	《地盤の巨人》	名詞
＠じばんのきょ	《地盤の巨人》	名詞
＠じばんのきょじ	《地盤の巨人》	名詞
＠じばんのきょじん	《地盤の巨人》	名詞
＠す	《垂直落下》	名詞
＠すい	《垂直落下》	名詞
＠すいち	《垂直落下》	名詞
＠すいちょ	《垂直落下》	名詞
＠すいちょく	《垂直落下》	名詞
＠すいちょくら	《垂直落下》	名詞
＠すいちょくらっ	《垂直落下》	名詞
＠すいちょくらっか	《垂直落下》	名詞
＠か	《垣間見た自由》	名詞
＠かい	《垣間見た自由》	名詞
＠かいま	《垣間見た自由》	名詞
＠かいまみ	《垣間見た自由》	名詞
＠かいまみた	《垣間見た自由》	名詞
＠かいまみたじ	《垣間見た自由》	名詞
＠かいまみたじゆ	《垣間見た自由》	名詞
＠かいまみたじゆう	《垣間見た自由》	名詞
＠ま	《埋葬布を纏う者、エイスリオス》	名詞
＠まい	《埋葬布を纏う者、エイスリオス》	名詞
＠まいそ	《埋葬布を纏う者、エイスリオス》	名詞
＠まいそう	《埋葬布を纏う者、エイスリオス》	名詞
＠まいそうふ	《埋葬布を纏う者、エイスリオス》	名詞
＠まいそうふを	《埋葬布を纏う者、エイスリオス》	名詞
＠まいそうふをま	《埋葬布を纏う者、エイスリオス》	名詞
＠まいそうふをまと	《埋葬布を纏う者、エイスリオス》	名詞
＠まいそうふをまとう	《埋葬布を纏う者、エイスリオス》	名詞
＠まいそうふをまとうも	《埋葬布を纏う者、エイスリオス》	名詞
＠まいそうふをまとうもの	《埋葬布を纏う者、エイスリオス》	名詞
＠まいそうふをまとうもの、	《埋葬布を纏う者、エイスリオス》	名詞
＠まいそうふをまとうもの、え	《埋葬布を纏う者、エイスリオス》	名詞
＠まいそうふをまとうもの、えい	《埋葬布を纏う者、エイスリオス》	名詞
＠まいそうふをまとうもの、えいす	《埋葬布を纏う者、エイスリオス》	名詞
＠まいそうふをまとうもの、えいすり	《埋葬布を纏う者、エイスリオス》	名詞
＠まいそうふをまとうもの、えいすりお	《埋葬布を纏う者、エイスリオス》	名詞
＠まいそうふをまとうもの、えいすりおす	《埋葬布を纏う者、エイスリオス》	名詞
＠え	《埋葬布を纏う者、エイスリオス》	名詞
＠えい	《埋葬布を纏う者、エイスリオス》	名詞
＠えいす	《埋葬布を纏う者、エイスリオス》	名詞
＠えいすり	《埋葬布を纏う者、エイスリオス》	名詞
＠えいすりお	《埋葬布を纏う者、エイスリオス》	名詞
＠えいすりおす	《埋葬布を纏う者、エイスリオス》	名詞
＠し	《執拗な探求》	名詞
＠しつ	《執拗な探求》	名詞
＠しつよ	《執拗な探求》	名詞
＠しつよう	《執拗な探求》	名詞
＠しつような	《執拗な探求》	名詞
＠しつようなた	《執拗な探求》	名詞
＠しつようなたん	《執拗な探求》	名詞
＠しつようなたんき	《執拗な探求》	名詞
＠しつようなたんきゅ	《執拗な探求》	名詞
＠しつようなたんきゅう	《執拗な探求》	名詞
＠し	《塩水の巨人》	名詞
＠しお	《塩水の巨人》	名詞
＠しおみ	《塩水の巨人》	名詞
＠しおみず	《塩水の巨人》	名詞
＠しおみずの	《塩水の巨人》	名詞
＠しおみずのき	《塩水の巨人》	名詞
＠しおみずのきょ	《塩水の巨人》	名詞
＠しおみずのきょじ	《塩水の巨人》	名詞
＠しおみずのきょじん	《塩水の巨人》	名詞
＠ち	《塵へのしがみつき》	名詞
＠ちり	《塵へのしがみつき》	名詞
＠ちりへ	《塵へのしがみつき》	名詞
＠ちりへの	《塵へのしがみつき》	名詞
＠ちりへのし	《塵へのしがみつき》	名詞
＠ちりへのしが	《塵へのしがみつき》	名詞
＠ちりへのしがみ	《塵へのしがみつき》	名詞
＠ちりへのしがみつ	《塵へのしがみつき》	名詞
＠ちりへのしがみつき	《塵へのしがみつき》	名詞
＠は	《墓破りのラミア》	名詞
＠はか	《墓破りのラミア》	名詞
＠はかや	《墓破りのラミア》	名詞
＠はかやぶ	《墓破りのラミア》	名詞
＠はかやぶり	《墓破りのラミア》	名詞
＠はかやぶりの	《墓破りのラミア》	名詞
＠はかやぶりのら	《墓破りのラミア》	名詞
＠はかやぶりのらみ	《墓破りのラミア》	名詞
＠はかやぶりのらみあ	《墓破りのラミア》	名詞
＠へ	《変幻の秘術師》	名詞
＠へん	《変幻の秘術師》	名詞
＠へんげ	《変幻の秘術師》	名詞
＠へんげん	《変幻の秘術師》	名詞
＠へんげんの	《変幻の秘術師》	名詞
＠へんげんのひ	《変幻の秘術師》	名詞
＠へんげんのひじ	《変幻の秘術師》	名詞
＠へんげんのひじゅ	《変幻の秘術師》	名詞
＠へんげんのひじゅつ	《変幻の秘術師》	名詞
＠へんげんのひじゅつし	《変幻の秘術師》	名詞
＠よ	《夜明けのキマイラ》	名詞
＠よあ	《夜明けのキマイラ》	名詞
＠よあけ	《夜明けのキマイラ》	名詞
＠よあけの	《夜明けのキマイラ》	名詞
＠よあけのき	《夜明けのキマイラ》	名詞
＠よあけのきま	《夜明けのキマイラ》	名詞
＠よあけのきまい	《夜明けのキマイラ》	名詞
＠よあけのきまいら	《夜明けのキマイラ》	名詞
＠ゆ	《夢さらい》	名詞
＠ゆめ	《夢さらい》	名詞
＠ゆめさ	《夢さらい》	名詞
＠ゆめさら	《夢さらい》	名詞
＠ゆめさらい	《夢さらい》	名詞
＠ゆ	《夢固めのシャーマン》	名詞
＠ゆめ	《夢固めのシャーマン》	名詞
＠ゆめか	《夢固めのシャーマン》	名詞
＠ゆめかた	《夢固めのシャーマン》	名詞
＠ゆめかため	《夢固めのシャーマン》	名詞
＠ゆめかための	《夢固めのシャーマン》	名詞
＠ゆめかためのし	《夢固めのシャーマン》	名詞
＠ゆめかためのしゃ	《夢固めのシャーマン》	名詞
＠ゆめかためのしゃー	《夢固めのシャーマン》	名詞
＠ゆめかためのしゃーま	《夢固めのシャーマン》	名詞
＠ゆめかためのしゃーまん	《夢固めのシャーマン》	名詞
＠ゆ	《夢忍びのマンティコア》	名詞
＠ゆめ	《夢忍びのマンティコア》	名詞
＠ゆめし	《夢忍びのマンティコア》	名詞
＠ゆめしの	《夢忍びのマンティコア》	名詞
＠ゆめしのび	《夢忍びのマンティコア》	名詞
＠ゆめしのびの	《夢忍びのマンティコア》	名詞
＠ゆめしのびのま	《夢忍びのマンティコア》	名詞
＠ゆめしのびのまん	《夢忍びのマンティコア》	名詞
＠ゆめしのびのまんて	《夢忍びのマンティコア》	名詞
＠ゆめしのびのまんてぃ	《夢忍びのマンティコア》	名詞
＠ゆめしのびのまんてぃこ	《夢忍びのマンティコア》	名詞
＠ゆめしのびのまんてぃこあ	《夢忍びのマンティコア》	名詞
＠た	《大樹揺らしのキマイラ》	名詞
＠たい	《大樹揺らしのキマイラ》	名詞
＠たいじ	《大樹揺らしのキマイラ》	名詞
＠たいじゅ	《大樹揺らしのキマイラ》	名詞
＠たいじゅゆ	《大樹揺らしのキマイラ》	名詞
＠たいじゅゆら	《大樹揺らしのキマイラ》	名詞
＠たいじゅゆらし	《大樹揺らしのキマイラ》	名詞
＠たいじゅゆらしの	《大樹揺らしのキマイラ》	名詞
＠たいじゅゆらしのき	《大樹揺らしのキマイラ》	名詞
＠たいじゅゆらしのきま	《大樹揺らしのキマイラ》	名詞
＠たいじゅゆらしのきまい	《大樹揺らしのキマイラ》	名詞
＠たいじゅゆらしのきまいら	《大樹揺らしのキマイラ》	名詞
＠た	《大食のテュポーン》	名詞
＠たい	《大食のテュポーン》	名詞
＠たいし	《大食のテュポーン》	名詞
＠たいしょ	《大食のテュポーン》	名詞
＠たいしょく	《大食のテュポーン》	名詞
＠たいしょくの	《大食のテュポーン》	名詞
＠たいしょくのて	《大食のテュポーン》	名詞
＠たいしょくのてゅ	《大食のテュポーン》	名詞
＠たいしょくのてゅぽ	《大食のテュポーン》	名詞
＠たいしょくのてゅぽー	《大食のテュポーン》	名詞
＠たいしょくのてゅぽーん	《大食のテュポーン》	名詞
＠た	《太陽に祝福されしダクソス》	名詞
＠たい	《太陽に祝福されしダクソス》	名詞
＠たいよ	《太陽に祝福されしダクソス》	名詞
＠たいよう	《太陽に祝福されしダクソス》	名詞
＠たいように	《太陽に祝福されしダクソス》	名詞
＠たいようにし	《太陽に祝福されしダクソス》	名詞
＠たいようにしゅ	《太陽に祝福されしダクソス》	名詞
＠たいようにしゅく	《太陽に祝福されしダクソス》	名詞
＠たいようにしゅくふ	《太陽に祝福されしダクソス》	名詞
＠たいようにしゅくふく	《太陽に祝福されしダクソス》	名詞
＠たいようにしゅくふくさ	《太陽に祝福されしダクソス》	名詞
＠たいようにしゅくふくされ	《太陽に祝福されしダクソス》	名詞
＠たいようにしゅくふくされし	《太陽に祝福されしダクソス》	名詞
＠たいようにしゅくふくされしだ	《太陽に祝福されしダクソス》	名詞
＠たいようにしゅくふくされしだく	《太陽に祝福されしダクソス》	名詞
＠たいようにしゅくふくされしだくそ	《太陽に祝福されしダクソス》	名詞
＠たいようにしゅくふくされしだくそす	《太陽に祝福されしダクソス》	名詞
＠た	《太陽の宿敵、エルズペス》	名詞
＠たい	《太陽の宿敵、エルズペス》	名詞
＠たいよ	《太陽の宿敵、エルズペス》	名詞
＠たいよう	《太陽の宿敵、エルズペス》	名詞
＠たいようの	《太陽の宿敵、エルズペス》	名詞
＠たいようのし	《太陽の宿敵、エルズペス》	名詞
＠たいようのしゅ	《太陽の宿敵、エルズペス》	名詞
＠たいようのしゅく	《太陽の宿敵、エルズペス》	名詞
＠たいようのしゅくて	《太陽の宿敵、エルズペス》	名詞
＠たいようのしゅくてき	《太陽の宿敵、エルズペス》	名詞
＠たいようのしゅくてき、	《太陽の宿敵、エルズペス》	名詞
＠たいようのしゅくてき、え	《太陽の宿敵、エルズペス》	名詞
＠たいようのしゅくてき、える	《太陽の宿敵、エルズペス》	名詞
＠たいようのしゅくてき、えるず	《太陽の宿敵、エルズペス》	名詞
＠たいようのしゅくてき、えるずぺ	《太陽の宿敵、エルズペス》	名詞
＠たいようのしゅくてき、えるずぺす	《太陽の宿敵、エルズペス》	名詞
＠え	《太陽の宿敵、エルズペス》	名詞
＠える	《太陽の宿敵、エルズペス》	名詞
＠えるず	《太陽の宿敵、エルズペス》	名詞
＠えるずぺ	《太陽の宿敵、エルズペス》	名詞
＠えるずぺす	《太陽の宿敵、エルズペス》	名詞
＠た	《太陽の恵みの執政官》	名詞
＠たい	《太陽の恵みの執政官》	名詞
＠たいよ	《太陽の恵みの執政官》	名詞
＠たいよう	《太陽の恵みの執政官》	名詞
＠たいようの	《太陽の恵みの執政官》	名詞
＠たいようのめ	《太陽の恵みの執政官》	名詞
＠たいようのめぐ	《太陽の恵みの執政官》	名詞
＠たいようのめぐみ	《太陽の恵みの執政官》	名詞
＠たいようのめぐみの	《太陽の恵みの執政官》	名詞
＠たいようのめぐみのし	《太陽の恵みの執政官》	名詞
＠たいようのめぐみのしっ	《太陽の恵みの執政官》	名詞
＠たいようのめぐみのしっせ	《太陽の恵みの執政官》	名詞
＠たいようのめぐみのしっせい	《太陽の恵みの執政官》	名詞
＠たいようのめぐみのしっせいか	《太陽の恵みの執政官》	名詞
＠たいようのめぐみのしっせいかん	《太陽の恵みの執政官》	名詞
＠た	《太陽の神のお告げ》	名詞
＠たい	《太陽の神のお告げ》	名詞
＠たいよ	《太陽の神のお告げ》	名詞
＠たいよう	《太陽の神のお告げ》	名詞
＠たいようの	《太陽の神のお告げ》	名詞
＠たいようのか	《太陽の神のお告げ》	名詞
＠たいようのかみ	《太陽の神のお告げ》	名詞
＠たいようのかみの	《太陽の神のお告げ》	名詞
＠たいようのかみのお	《太陽の神のお告げ》	名詞
＠たいようのかみのおつ	《太陽の神のお告げ》	名詞
＠たいようのかみのおつげ	《太陽の神のお告げ》	名詞
＠た	《太陽冠のヘリオッド》	名詞
＠たい	《太陽冠のヘリオッド》	名詞
＠たいよ	《太陽冠のヘリオッド》	名詞
＠たいよう	《太陽冠のヘリオッド》	名詞
＠たいようか	《太陽冠のヘリオッド》	名詞
＠たいようかん	《太陽冠のヘリオッド》	名詞
＠たいようかんむ	《太陽冠のヘリオッド》	名詞
＠たいようかんむり	《太陽冠のヘリオッド》	名詞
＠たいようかんむりの	《太陽冠のヘリオッド》	名詞
＠たいようかんむりのへ	《太陽冠のヘリオッド》	名詞
＠たいようかんむりのへり	《太陽冠のヘリオッド》	名詞
＠たいようかんむりのへりお	《太陽冠のヘリオッド》	名詞
＠たいようかんむりのへりおっ	《太陽冠のヘリオッド》	名詞
＠たいようかんむりのへりおっど	《太陽冠のヘリオッド》	名詞
＠う	《失われた群れのレオニン》	名詞
＠うし	《失われた群れのレオニン》	名詞
＠うしな	《失われた群れのレオニン》	名詞
＠うしなわ	《失われた群れのレオニン》	名詞
＠うしなわれ	《失われた群れのレオニン》	名詞
＠うしなわれた	《失われた群れのレオニン》	名詞
＠うしなわれたむ	《失われた群れのレオニン》	名詞
＠うしなわれたむれ	《失われた群れのレオニン》	名詞
＠うしなわれたむれの	《失われた群れのレオニン》	名詞
＠うしなわれたむれのれ	《失われた群れのレオニン》	名詞
＠うしなわれたむれのれお	《失われた群れのレオニン》	名詞
＠うしなわれたむれのれおに	《失われた群れのレオニン》	名詞
＠うしなわれたむれのれおにん	《失われた群れのレオニン》	名詞
＠き	《奇怪な具現》	名詞
＠きか	《奇怪な具現》	名詞
＠きかい	《奇怪な具現》	名詞
＠きかいな	《奇怪な具現》	名詞
＠きかいなぐ	《奇怪な具現》	名詞
＠きかいなぐげ	《奇怪な具現》	名詞
＠きかいなぐげん	《奇怪な具現》	名詞
＠ほ	《奔放の神殿》	名詞
＠ほん	《奔放の神殿》	名詞
＠ほんぽ	《奔放の神殿》	名詞
＠ほんぽう	《奔放の神殿》	名詞
＠ほんぽうの	《奔放の神殿》	名詞
＠ほんぽうのし	《奔放の神殿》	名詞
＠ほんぽうのしん	《奔放の神殿》	名詞
＠ほんぽうのしんで	《奔放の神殿》	名詞
＠ほんぽうのしんでん	《奔放の神殿》	名詞
＠い	《威厳ある存在》	名詞
＠いげ	《威厳ある存在》	名詞
＠いげん	《威厳ある存在》	名詞
＠いげんあ	《威厳ある存在》	名詞
＠いげんある	《威厳ある存在》	名詞
＠いげんあるそ	《威厳ある存在》	名詞
＠いげんあるそん	《威厳ある存在》	名詞
＠いげんあるそんざ	《威厳ある存在》	名詞
＠いげんあるそんざい	《威厳ある存在》	名詞
＠け	《嫌悪の悪魔》	名詞
＠けん	《嫌悪の悪魔》	名詞
＠けんお	《嫌悪の悪魔》	名詞
＠けんおの	《嫌悪の悪魔》	名詞
＠けんおのあ	《嫌悪の悪魔》	名詞
＠けんおのあく	《嫌悪の悪魔》	名詞
＠けんおのあくま	《嫌悪の悪魔》	名詞
＠そ	《存在の破棄》	名詞
＠そん	《存在の破棄》	名詞
＠そんざ	《存在の破棄》	名詞
＠そんざい	《存在の破棄》	名詞
＠そんざいの	《存在の破棄》	名詞
＠そんざいのは	《存在の破棄》	名詞
＠そんざいのはき	《存在の破棄》	名詞
＠み	《密集戦術》	名詞
＠みっ	《密集戦術》	名詞
＠みっし	《密集戦術》	名詞
＠みっしゅ	《密集戦術》	名詞
＠みっしゅう	《密集戦術》	名詞
＠みっしゅうせ	《密集戦術》	名詞
＠みっしゅうせん	《密集戦術》	名詞
＠みっしゅうせんじ	《密集戦術》	名詞
＠みっしゅうせんじゅ	《密集戦術》	名詞
＠みっしゅうせんじゅつ	《密集戦術》	名詞
＠や	《山》	名詞
＠やま	《山》	名詞
＠さ	《山岳猛火のオリアード》	名詞
＠さん	《山岳猛火のオリアード》	名詞
＠さんが	《山岳猛火のオリアード》	名詞
＠さんがく	《山岳猛火のオリアード》	名詞
＠さんがくも	《山岳猛火のオリアード》	名詞
＠さんがくもう	《山岳猛火のオリアード》	名詞
＠さんがくもうか	《山岳猛火のオリアード》	名詞
＠さんがくもうかの	《山岳猛火のオリアード》	名詞
＠さんがくもうかのお	《山岳猛火のオリアード》	名詞
＠さんがくもうかのおり	《山岳猛火のオリアード》	名詞
＠さんがくもうかのおりあ	《山岳猛火のオリアード》	名詞
＠さんがくもうかのおりあー	《山岳猛火のオリアード》	名詞
＠さんがくもうかのおりあーど	《山岳猛火のオリアード》	名詞
＠じ	《島》	名詞
＠じま	《島》	名詞
＠あ	《嵐の伝令》	名詞
＠あら	《嵐の伝令》	名詞
＠あらし	《嵐の伝令》	名詞
＠あらしの	《嵐の伝令》	名詞
＠あらしので	《嵐の伝令》	名詞
＠あらしのでん	《嵐の伝令》	名詞
＠あらしのでんれ	《嵐の伝令》	名詞
＠あらしのでんれい	《嵐の伝令》	名詞
＠あ	《嵐の怒り》	名詞
＠あら	《嵐の怒り》	名詞
＠あらし	《嵐の怒り》	名詞
＠あらしの	《嵐の怒り》	名詞
＠あらしのい	《嵐の怒り》	名詞
＠あらしのいか	《嵐の怒り》	名詞
＠あらしのいかり	《嵐の怒り》	名詞
＠へ	《平地》	名詞
＠へい	《平地》	名詞
＠へいち	《平地》	名詞
＠げ	《幻惑する竪琴》	名詞
＠げん	《幻惑する竪琴》	名詞
＠げんわ	《幻惑する竪琴》	名詞
＠げんわく	《幻惑する竪琴》	名詞
＠げんわくす	《幻惑する竪琴》	名詞
＠げんわくする	《幻惑する竪琴》	名詞
＠げんわくするた	《幻惑する竪琴》	名詞
＠げんわくするたて	《幻惑する竪琴》	名詞
＠げんわくするたてご	《幻惑する竪琴》	名詞
＠げんわくするたてごと	《幻惑する竪琴》	名詞
＠は	《廃墟の地》	名詞
＠はい	《廃墟の地》	名詞
＠はいき	《廃墟の地》	名詞
＠はいきょ	《廃墟の地》	名詞
＠はいきょの	《廃墟の地》	名詞
＠はいきょのち	《廃墟の地》	名詞
＠か	《影槍》	名詞
＠かげ	《影槍》	名詞
＠かげや	《影槍》	名詞
＠かげやり	《影槍》	名詞
＠い	《怒り傷の狂戦士》	名詞
＠いか	《怒り傷の狂戦士》	名詞
＠いかり	《怒り傷の狂戦士》	名詞
＠いかりき	《怒り傷の狂戦士》	名詞
＠いかりきず	《怒り傷の狂戦士》	名詞
＠いかりきずの	《怒り傷の狂戦士》	名詞
＠いかりきずのく	《怒り傷の狂戦士》	名詞
＠いかりきずのくる	《怒り傷の狂戦士》	名詞
＠いかりきずのくるい	《怒り傷の狂戦士》	名詞
＠いかりきずのくるいせ	《怒り傷の狂戦士》	名詞
＠いかりきずのくるいせん	《怒り傷の狂戦士》	名詞
＠いかりきずのくるいせんし	《怒り傷の狂戦士》	名詞
＠き	《急嵐のトリクス》	名詞
＠きゅ	《急嵐のトリクス》	名詞
＠きゅう	《急嵐のトリクス》	名詞
＠きゅうあ	《急嵐のトリクス》	名詞
＠きゅうあら	《急嵐のトリクス》	名詞
＠きゅうあらし	《急嵐のトリクス》	名詞
＠きゅうあらしの	《急嵐のトリクス》	名詞
＠きゅうあらしのと	《急嵐のトリクス》	名詞
＠きゅうあらしのとり	《急嵐のトリクス》	名詞
＠きゅうあらしのとりく	《急嵐のトリクス》	名詞
＠きゅうあらしのとりくす	《急嵐のトリクス》	名詞
＠き	《恐怖を彫る者、アショク》	名詞
＠きょ	《恐怖を彫る者、アショク》	名詞
＠きょう	《恐怖を彫る者、アショク》	名詞
＠きょうふ	《恐怖を彫る者、アショク》	名詞
＠きょうふを	《恐怖を彫る者、アショク》	名詞
＠きょうふをほ	《恐怖を彫る者、アショク》	名詞
＠きょうふをほる	《恐怖を彫る者、アショク》	名詞
＠きょうふをほるも	《恐怖を彫る者、アショク》	名詞
＠きょうふをほるもの	《恐怖を彫る者、アショク》	名詞
＠きょうふをほるもの、	《恐怖を彫る者、アショク》	名詞
＠きょうふをほるもの、あ	《恐怖を彫る者、アショク》	名詞
＠きょうふをほるもの、あし	《恐怖を彫る者、アショク》	名詞
＠きょうふをほるもの、あしょ	《恐怖を彫る者、アショク》	名詞
＠きょうふをほるもの、あしょく	《恐怖を彫る者、アショク》	名詞
＠あ	《恐怖を彫る者、アショク》	名詞
＠あし	《恐怖を彫る者、アショク》	名詞
＠あしょ	《恐怖を彫る者、アショク》	名詞
＠あしょく	《恐怖を彫る者、アショク》	名詞
＠う	《恭しき重装歩兵》	名詞
＠うや	《恭しき重装歩兵》	名詞
＠うやう	《恭しき重装歩兵》	名詞
＠うやうや	《恭しき重装歩兵》	名詞
＠うやうやし	《恭しき重装歩兵》	名詞
＠うやうやしき	《恭しき重装歩兵》	名詞
＠うやうやしきじ	《恭しき重装歩兵》	名詞
＠うやうやしきじゅ	《恭しき重装歩兵》	名詞
＠うやうやしきじゅう	《恭しき重装歩兵》	名詞
＠うやうやしきじゅうよ	《恭しき重装歩兵》	名詞
＠うやうやしきじゅうよそ	《恭しき重装歩兵》	名詞
＠うやうやしきじゅうよそい	《恭しき重装歩兵》	名詞
＠うやうやしきじゅうよそいほ	《恭しき重装歩兵》	名詞
＠うやうやしきじゅうよそいほへ	《恭しき重装歩兵》	名詞
＠うやうやしきじゅうよそいほへい	《恭しき重装歩兵》	名詞
＠あ	《悪夢の番人》	名詞
＠あく	《悪夢の番人》	名詞
＠あくむ	《悪夢の番人》	名詞
＠あくむの	《悪夢の番人》	名詞
＠あくむのば	《悪夢の番人》	名詞
＠あくむのばん	《悪夢の番人》	名詞
＠あくむのばんに	《悪夢の番人》	名詞
＠あくむのばんにん	《悪夢の番人》	名詞
＠あ	《悪夢の詩神、アショク》	名詞
＠あく	《悪夢の詩神、アショク》	名詞
＠あくむ	《悪夢の詩神、アショク》	名詞
＠あくむの	《悪夢の詩神、アショク》	名詞
＠あくむのし	《悪夢の詩神、アショク》	名詞
＠あくむのしし	《悪夢の詩神、アショク》	名詞
＠あくむのししん	《悪夢の詩神、アショク》	名詞
＠あくむのししん、	《悪夢の詩神、アショク》	名詞
＠あくむのししん、あ	《悪夢の詩神、アショク》	名詞
＠あくむのししん、あし	《悪夢の詩神、アショク》	名詞
＠あくむのししん、あしょ	《悪夢の詩神、アショク》	名詞
＠あくむのししん、あしょく	《悪夢の詩神、アショク》	名詞
＠あ	《悪夢の詩神、アショク》	名詞
＠あし	《悪夢の詩神、アショク》	名詞
＠あしょ	《悪夢の詩神、アショク》	名詞
＠あしょく	《悪夢の詩神、アショク》	名詞
＠あ	《悪夢を泳ぐ者》	名詞
＠あく	《悪夢を泳ぐ者》	名詞
＠あくむ	《悪夢を泳ぐ者》	名詞
＠あくむを	《悪夢を泳ぐ者》	名詞
＠あくむをお	《悪夢を泳ぐ者》	名詞
＠あくむをおよ	《悪夢を泳ぐ者》	名詞
＠あくむをおよぐ	《悪夢を泳ぐ者》	名詞
＠あくむをおよぐも	《悪夢を泳ぐ者》	名詞
＠あくむをおよぐもの	《悪夢を泳ぐ者》	名詞
＠あ	《悪意の神殿》	名詞
＠あく	《悪意の神殿》	名詞
＠あくい	《悪意の神殿》	名詞
＠あくいの	《悪意の神殿》	名詞
＠あくいのし	《悪意の神殿》	名詞
＠あくいのしん	《悪意の神殿》	名詞
＠あくいのしんで	《悪意の神殿》	名詞
＠あくいのしんでん	《悪意の神殿》	名詞
＠い	《悪戯なキマイラ》	名詞
＠いた	《悪戯なキマイラ》	名詞
＠いたず	《悪戯なキマイラ》	名詞
＠いたずら	《悪戯なキマイラ》	名詞
＠いたずらな	《悪戯なキマイラ》	名詞
＠いたずらなき	《悪戯なキマイラ》	名詞
＠いたずらなきま	《悪戯なキマイラ》	名詞
＠いたずらなきまい	《悪戯なキマイラ》	名詞
＠いたずらなきまいら	《悪戯なキマイラ》	名詞
＠ひ	《悲哀の徘徊者》	名詞
＠ひあ	《悲哀の徘徊者》	名詞
＠ひあい	《悲哀の徘徊者》	名詞
＠ひあいの	《悲哀の徘徊者》	名詞
＠ひあいのは	《悲哀の徘徊者》	名詞
＠ひあいのはい	《悲哀の徘徊者》	名詞
＠ひあいのはいか	《悲哀の徘徊者》	名詞
＠ひあいのはいかい	《悲哀の徘徊者》	名詞
＠ひあいのはいかいし	《悲哀の徘徊者》	名詞
＠ひあいのはいかいしゃ	《悲哀の徘徊者》	名詞
＠い	《意味の渇望》	名詞
＠いみ	《意味の渇望》	名詞
＠いみの	《意味の渇望》	名詞
＠いみのか	《意味の渇望》	名詞
＠いみのかつ	《意味の渇望》	名詞
＠いみのかつぼ	《意味の渇望》	名詞
＠いみのかつぼう	《意味の渇望》	名詞
＠に	《憎しみの幻霊》	名詞
＠にく	《憎しみの幻霊》	名詞
＠にくし	《憎しみの幻霊》	名詞
＠にくしみ	《憎しみの幻霊》	名詞
＠にくしみの	《憎しみの幻霊》	名詞
＠にくしみのま	《憎しみの幻霊》	名詞
＠にくしみのまぼ	《憎しみの幻霊》	名詞
＠にくしみのまぼろ	《憎しみの幻霊》	名詞
＠にくしみのまぼろし	《憎しみの幻霊》	名詞
＠にくしみのまぼろしれ	《憎しみの幻霊》	名詞
＠にくしみのまぼろしれい	《憎しみの幻霊》	名詞
＠せ	《戦茨の恩恵》	名詞
＠せん	《戦茨の恩恵》	名詞
＠せんい	《戦茨の恩恵》	名詞
＠せんいば	《戦茨の恩恵》	名詞
＠せんいばら	《戦茨の恩恵》	名詞
＠せんいばらの	《戦茨の恩恵》	名詞
＠せんいばらのお	《戦茨の恩恵》	名詞
＠せんいばらのおん	《戦茨の恩恵》	名詞
＠せんいばらのおんけ	《戦茨の恩恵》	名詞
＠せんいばらのおんけい	《戦茨の恩恵》	名詞
＠ふ	《払拭の光》	名詞
＠ふっ	《払拭の光》	名詞
＠ふっし	《払拭の光》	名詞
＠ふっしょ	《払拭の光》	名詞
＠ふっしょく	《払拭の光》	名詞
＠ふっしょくの	《払拭の光》	名詞
＠ふっしょくのひ	《払拭の光》	名詞
＠ふっしょくのひか	《払拭の光》	名詞
＠ふっしょくのひかり	《払拭の光》	名詞
＠ば	《挽歌の歌い手》	名詞
＠ばん	《挽歌の歌い手》	名詞
＠ばんか	《挽歌の歌い手》	名詞
＠ばんかの	《挽歌の歌い手》	名詞
＠ばんかのう	《挽歌の歌い手》	名詞
＠ばんかのうた	《挽歌の歌い手》	名詞
＠ばんかのうたい	《挽歌の歌い手》	名詞
＠ばんかのうたいて	《挽歌の歌い手》	名詞
＠け	《敬虔な旅人》	名詞
＠けい	《敬虔な旅人》	名詞
＠けいけ	《敬虔な旅人》	名詞
＠けいけん	《敬虔な旅人》	名詞
＠けいけんな	《敬虔な旅人》	名詞
＠けいけんなた	《敬虔な旅人》	名詞
＠けいけんなたび	《敬虔な旅人》	名詞
＠けいけんなたびび	《敬虔な旅人》	名詞
＠けいけんなたびびと	《敬虔な旅人》	名詞
＠り	《旅行者の護符》	名詞
＠りょ	《旅行者の護符》	名詞
＠りょこ	《旅行者の護符》	名詞
＠りょこう	《旅行者の護符》	名詞
＠りょこうし	《旅行者の護符》	名詞
＠りょこうしゃ	《旅行者の護符》	名詞
＠りょこうしゃの	《旅行者の護符》	名詞
＠りょこうしゃのご	《旅行者の護符》	名詞
＠りょこうしゃのごふ	《旅行者の護符》	名詞
＠せ	《旋風のごとき否定》	名詞
＠せん	《旋風のごとき否定》	名詞
＠せんぷ	《旋風のごとき否定》	名詞
＠せんぷう	《旋風のごとき否定》	名詞
＠せんぷうの	《旋風のごとき否定》	名詞
＠せんぷうのご	《旋風のごとき否定》	名詞
＠せんぷうのごと	《旋風のごとき否定》	名詞
＠せんぷうのごとき	《旋風のごとき否定》	名詞
＠せんぷうのごときひ	《旋風のごとき否定》	名詞
＠せんぷうのごときひて	《旋風のごとき否定》	名詞
＠せんぷうのごときひてい	《旋風のごとき否定》	名詞
＠あ	《明日の目撃者》	名詞
＠あし	《明日の目撃者》	名詞
＠あした	《明日の目撃者》	名詞
＠あしたの	《明日の目撃者》	名詞
＠あしたのも	《明日の目撃者》	名詞
＠あしたのもく	《明日の目撃者》	名詞
＠あしたのもくげ	《明日の目撃者》	名詞
＠あしたのもくげき	《明日の目撃者》	名詞
＠あしたのもくげきし	《明日の目撃者》	名詞
＠あしたのもくげきしゃ	《明日の目撃者》	名詞
＠ほ	《星々とあるもの》	名詞
＠ほし	《星々とあるもの》	名詞
＠ほしと	《星々とあるもの》	名詞
＠ほしとあ	《星々とあるもの》	名詞
＠ほしとある	《星々とあるもの》	名詞
＠ほしとあるも	《星々とあるもの》	名詞
＠ほしとあるもの	《星々とあるもの》	名詞
＠ほ	《星明かりのマント》	名詞
＠ほし	《星明かりのマント》	名詞
＠ほしあ	《星明かりのマント》	名詞
＠ほしあか	《星明かりのマント》	名詞
＠ほしあかり	《星明かりのマント》	名詞
＠ほしあかりの	《星明かりのマント》	名詞
＠ほしあかりのま	《星明かりのマント》	名詞
＠ほしあかりのまん	《星明かりのマント》	名詞
＠ほしあかりのまんと	《星明かりのマント》	名詞
＠あ	《暁の福音者》	名詞
＠あか	《暁の福音者》	名詞
＠あかつ	《暁の福音者》	名詞
＠あかつき	《暁の福音者》	名詞
＠あかつきの	《暁の福音者》	名詞
＠あかつきのふ	《暁の福音者》	名詞
＠あかつきのふく	《暁の福音者》	名詞
＠あかつきのふくい	《暁の福音者》	名詞
＠あかつきのふくいん	《暁の福音者》	名詞
＠あかつきのふくいんし	《暁の福音者》	名詞
＠あかつきのふくいんしゃ	《暁の福音者》	名詞
＠ぼ	《暴走乗り》	名詞
＠ぼう	《暴走乗り》	名詞
＠ぼうそ	《暴走乗り》	名詞
＠ぼうそう	《暴走乗り》	名詞
＠ぼうそうの	《暴走乗り》	名詞
＠ぼうそうのり	《暴走乗り》	名詞
＠さ	《最後の死》	名詞
＠さい	《最後の死》	名詞
＠さいご	《最後の死》	名詞
＠さいごの	《最後の死》	名詞
＠さいごのし	《最後の死》	名詞
＠さ	《最期の噴炎》	名詞
＠さい	《最期の噴炎》	名詞
＠さいご	《最期の噴炎》	名詞
＠さいごの	《最期の噴炎》	名詞
＠さいごのふ	《最期の噴炎》	名詞
＠さいごのふん	《最期の噴炎》	名詞
＠さいごのふんほ	《最期の噴炎》	名詞
＠さいごのふんほの	《最期の噴炎》	名詞
＠さいごのふんほのお	《最期の噴炎》	名詞
＠さ	《最深淵の海蛇》	名詞
＠さい	《最深淵の海蛇》	名詞
＠さいし	《最深淵の海蛇》	名詞
＠さいしん	《最深淵の海蛇》	名詞
＠さいしんぶ	《最深淵の海蛇》	名詞
＠さいしんぶち	《最深淵の海蛇》	名詞
＠さいしんぶちの	《最深淵の海蛇》	名詞
＠さいしんぶちのう	《最深淵の海蛇》	名詞
＠さいしんぶちのうみ	《最深淵の海蛇》	名詞
＠さいしんぶちのうみへ	《最深淵の海蛇》	名詞
＠さいしんぶちのうみへび	《最深淵の海蛇》	名詞
＠ゆ	《有刺カサゴ》	名詞
＠ゆう	《有刺カサゴ》	名詞
＠ゆうし	《有刺カサゴ》	名詞
＠ゆうしか	《有刺カサゴ》	名詞
＠ゆうしかさ	《有刺カサゴ》	名詞
＠ゆうしかさご	《有刺カサゴ》	名詞
＠み	《未知なるものの魅惑》	名詞
＠みち	《未知なるものの魅惑》	名詞
＠みちな	《未知なるものの魅惑》	名詞
＠みちなる	《未知なるものの魅惑》	名詞
＠みちなるも	《未知なるものの魅惑》	名詞
＠みちなるもの	《未知なるものの魅惑》	名詞
＠みちなるものの	《未知なるものの魅惑》	名詞
＠みちなるもののみ	《未知なるものの魅惑》	名詞
＠みちなるもののみわ	《未知なるものの魅惑》	名詞
＠みちなるもののみわく	《未知なるものの魅惑》	名詞
＠み	《未知の岸》	名詞
＠みち	《未知の岸》	名詞
＠みちの	《未知の岸》	名詞
＠みちのき	《未知の岸》	名詞
＠みちのきし	《未知の岸》	名詞
＠が	《枯れ息吹のカトブレパス》	名詞
＠がれ	《枯れ息吹のカトブレパス》	名詞
＠がれい	《枯れ息吹のカトブレパス》	名詞
＠がれいぶ	《枯れ息吹のカトブレパス》	名詞
＠がれいぶき	《枯れ息吹のカトブレパス》	名詞
＠がれいぶきの	《枯れ息吹のカトブレパス》	名詞
＠がれいぶきのか	《枯れ息吹のカトブレパス》	名詞
＠がれいぶきのかと	《枯れ息吹のカトブレパス》	名詞
＠がれいぶきのかとぶ	《枯れ息吹のカトブレパス》	名詞
＠がれいぶきのかとぶれ	《枯れ息吹のカトブレパス》	名詞
＠がれいぶきのかとぶれぱ	《枯れ息吹のカトブレパス》	名詞
＠がれいぶきのかとぶれぱす	《枯れ息吹のカトブレパス》	名詞
＠え	《栄光の重装歩兵》	名詞
＠えい	《栄光の重装歩兵》	名詞
＠えいこ	《栄光の重装歩兵》	名詞
＠えいこう	《栄光の重装歩兵》	名詞
＠えいこうの	《栄光の重装歩兵》	名詞
＠えいこうのじ	《栄光の重装歩兵》	名詞
＠えいこうのじゅ	《栄光の重装歩兵》	名詞
＠えいこうのじゅう	《栄光の重装歩兵》	名詞
＠えいこうのじゅうよ	《栄光の重装歩兵》	名詞
＠えいこうのじゅうよそ	《栄光の重装歩兵》	名詞
＠えいこうのじゅうよそい	《栄光の重装歩兵》	名詞
＠えいこうのじゅうよそいほ	《栄光の重装歩兵》	名詞
＠えいこうのじゅうよそいほへ	《栄光の重装歩兵》	名詞
＠えいこうのじゅうよそいほへい	《栄光の重装歩兵》	名詞
＠え	《栄光への目覚め》	名詞
＠えい	《栄光への目覚め》	名詞
＠えいこ	《栄光への目覚め》	名詞
＠えいこう	《栄光への目覚め》	名詞
＠えいこうへ	《栄光への目覚め》	名詞
＠えいこうへの	《栄光への目覚め》	名詞
＠えいこうへのめ	《栄光への目覚め》	名詞
＠えいこうへのめざ	《栄光への目覚め》	名詞
＠えいこうへのめざめ	《栄光への目覚め》	名詞
＠え	《栄光を携える者》	名詞
＠えい	《栄光を携える者》	名詞
＠えいこ	《栄光を携える者》	名詞
＠えいこう	《栄光を携える者》	名詞
＠えいこうを	《栄光を携える者》	名詞
＠えいこうをた	《栄光を携える者》	名詞
＠えいこうをたず	《栄光を携える者》	名詞
＠えいこうをたずさ	《栄光を携える者》	名詞
＠えいこうをたずさえ	《栄光を携える者》	名詞
＠えいこうをたずさえる	《栄光を携える者》	名詞
＠えいこうをたずさえるも	《栄光を携える者》	名詞
＠えいこうをたずさえるもの	《栄光を携える者》	名詞
＠も	《森》	名詞
＠もり	《森》	名詞
＠ぎ	《欺瞞の神殿》	名詞
＠ぎま	《欺瞞の神殿》	名詞
＠ぎまん	《欺瞞の神殿》	名詞
＠ぎまんの	《欺瞞の神殿》	名詞
＠ぎまんのし	《欺瞞の神殿》	名詞
＠ぎまんのしん	《欺瞞の神殿》	名詞
＠ぎまんのしんで	《欺瞞の神殿》	名詞
＠ぎまんのしんでん	《欺瞞の神殿》	名詞
＠か	《歓楽の英雄》	名詞
＠かん	《歓楽の英雄》	名詞
＠かんら	《歓楽の英雄》	名詞
＠かんらく	《歓楽の英雄》	名詞
＠かんらくの	《歓楽の英雄》	名詞
＠かんらくのえ	《歓楽の英雄》	名詞
＠かんらくのえい	《歓楽の英雄》	名詞
＠かんらくのえいゆ	《歓楽の英雄》	名詞
＠かんらくのえいゆう	《歓楽の英雄》	名詞
＠ほ	《歩哨の目》	名詞
＠ほし	《歩哨の目》	名詞
＠ほしょ	《歩哨の目》	名詞
＠ほしょう	《歩哨の目》	名詞
＠ほしょうの	《歩哨の目》	名詞
＠ほしょうのめ	《歩哨の目》	名詞
＠し	《死の国からの脱出》	名詞
＠しの	《死の国からの脱出》	名詞
＠しのく	《死の国からの脱出》	名詞
＠しのくに	《死の国からの脱出》	名詞
＠しのくにか	《死の国からの脱出》	名詞
＠しのくにから	《死の国からの脱出》	名詞
＠しのくにからの	《死の国からの脱出》	名詞
＠しのくにからのだ	《死の国からの脱出》	名詞
＠しのくにからのだっ	《死の国からの脱出》	名詞
＠しのくにからのだっし	《死の国からの脱出》	名詞
＠しのくにからのだっしゅ	《死の国からの脱出》	名詞
＠しのくにからのだっしゅつ	《死の国からの脱出》	名詞
＠し	《死の国の憤怒犬》	名詞
＠しの	《死の国の憤怒犬》	名詞
＠しのく	《死の国の憤怒犬》	名詞
＠しのくに	《死の国の憤怒犬》	名詞
＠しのくにの	《死の国の憤怒犬》	名詞
＠しのくにのふ	《死の国の憤怒犬》	名詞
＠しのくにのふん	《死の国の憤怒犬》	名詞
＠しのくにのふんぬ	《死の国の憤怒犬》	名詞
＠しのくにのふんぬい	《死の国の憤怒犬》	名詞
＠しのくにのふんぬいぬ	《死の国の憤怒犬》	名詞
＠し	《死の国の火》	名詞
＠しの	《死の国の火》	名詞
＠しのく	《死の国の火》	名詞
＠しのくに	《死の国の火》	名詞
＠しのくにの	《死の国の火》	名詞
＠しのくにのひ	《死の国の火》	名詞
＠し	《死の国の突撃馬》	名詞
＠しの	《死の国の突撃馬》	名詞
＠しのく	《死の国の突撃馬》	名詞
＠しのくに	《死の国の突撃馬》	名詞
＠しのくにの	《死の国の突撃馬》	名詞
＠しのくにのと	《死の国の突撃馬》	名詞
＠しのくにのとつ	《死の国の突撃馬》	名詞
＠しのくにのとつげ	《死の国の突撃馬》	名詞
＠しのくにのとつげき	《死の国の突撃馬》	名詞
＠しのくにのとつげきば	《死の国の突撃馬》	名詞
＠し	《死の国の衛兵》	名詞
＠しの	《死の国の衛兵》	名詞
＠しのく	《死の国の衛兵》	名詞
＠しのくに	《死の国の衛兵》	名詞
＠しのくにの	《死の国の衛兵》	名詞
＠しのくにのえ	《死の国の衛兵》	名詞
＠しのくにのえい	《死の国の衛兵》	名詞
＠しのくにのえいへ	《死の国の衛兵》	名詞
＠しのくにのえいへい	《死の国の衛兵》	名詞
＠し	《死の国への引き込み》	名詞
＠しの	《死の国への引き込み》	名詞
＠しのく	《死の国への引き込み》	名詞
＠しのくに	《死の国への引き込み》	名詞
＠しのくにへ	《死の国への引き込み》	名詞
＠しのくにへの	《死の国への引き込み》	名詞
＠しのくにへのひ	《死の国への引き込み》	名詞
＠しのくにへのひき	《死の国への引き込み》	名詞
＠しのくにへのひきこ	《死の国への引き込み》	名詞
＠しのくにへのひきこみ	《死の国への引き込み》	名詞
＠し	《死の夜番のランパード》	名詞
＠しの	《死の夜番のランパード》	名詞
＠しのや	《死の夜番のランパード》	名詞
＠しのやば	《死の夜番のランパード》	名詞
＠しのやばん	《死の夜番のランパード》	名詞
＠しのやばんの	《死の夜番のランパード》	名詞
＠しのやばんのら	《死の夜番のランパード》	名詞
＠しのやばんのらん	《死の夜番のランパード》	名詞
＠しのやばんのらんぱ	《死の夜番のランパード》	名詞
＠しのやばんのらんぱー	《死の夜番のランパード》	名詞
＠しのやばんのらんぱーど	《死の夜番のランパード》	名詞
＠し	《死の飢えのタイタン、クロクサ》	名詞
＠しの	《死の飢えのタイタン、クロクサ》	名詞
＠しのう	《死の飢えのタイタン、クロクサ》	名詞
＠しのうえ	《死の飢えのタイタン、クロクサ》	名詞
＠しのうえの	《死の飢えのタイタン、クロクサ》	名詞
＠しのうえのた	《死の飢えのタイタン、クロクサ》	名詞
＠しのうえのたい	《死の飢えのタイタン、クロクサ》	名詞
＠しのうえのたいた	《死の飢えのタイタン、クロクサ》	名詞
＠しのうえのたいたん	《死の飢えのタイタン、クロクサ》	名詞
＠しのうえのたいたん、	《死の飢えのタイタン、クロクサ》	名詞
＠しのうえのたいたん、く	《死の飢えのタイタン、クロクサ》	名詞
＠しのうえのたいたん、くろ	《死の飢えのタイタン、クロクサ》	名詞
＠しのうえのたいたん、くろく	《死の飢えのタイタン、クロクサ》	名詞
＠しのうえのたいたん、くろくさ	《死の飢えのタイタン、クロクサ》	名詞
＠く	《死の飢えのタイタン、クロクサ》	名詞
＠くろ	《死の飢えのタイタン、クロクサ》	名詞
＠くろく	《死の飢えのタイタン、クロクサ》	名詞
＠くろくさ	《死の飢えのタイタン、クロクサ》	名詞
＠し	《死より選ばれしティマレット》	名詞
＠しよ	《死より選ばれしティマレット》	名詞
＠しより	《死より選ばれしティマレット》	名詞
＠しよりえ	《死より選ばれしティマレット》	名詞
＠しよりえら	《死より選ばれしティマレット》	名詞
＠しよりえらば	《死より選ばれしティマレット》	名詞
＠しよりえらばれ	《死より選ばれしティマレット》	名詞
＠しよりえらばれし	《死より選ばれしティマレット》	名詞
＠しよりえらばれして	《死より選ばれしティマレット》	名詞
＠しよりえらばれしてぃ	《死より選ばれしティマレット》	名詞
＠しよりえらばれしてぃま	《死より選ばれしティマレット》	名詞
＠しよりえらばれしてぃまれ	《死より選ばれしティマレット》	名詞
＠しよりえらばれしてぃまれっ	《死より選ばれしティマレット》	名詞
＠しよりえらばれしてぃまれっと	《死より選ばれしティマレット》	名詞
＠し	《死体あさりのハーピー》	名詞
＠した	《死体あさりのハーピー》	名詞
＠したい	《死体あさりのハーピー》	名詞
＠したいあ	《死体あさりのハーピー》	名詞
＠したいあさ	《死体あさりのハーピー》	名詞
＠したいあさり	《死体あさりのハーピー》	名詞
＠したいあさりの	《死体あさりのハーピー》	名詞
＠したいあさりのは	《死体あさりのハーピー》	名詞
＠したいあさりのはー	《死体あさりのハーピー》	名詞
＠したいあさりのはーぴ	《死体あさりのハーピー》	名詞
＠したいあさりのはーぴー	《死体あさりのハーピー》	名詞
＠し	《死呻きの鬨の声》	名詞
＠しう	《死呻きの鬨の声》	名詞
＠しうめ	《死呻きの鬨の声》	名詞
＠しうめき	《死呻きの鬨の声》	名詞
＠しうめきの	《死呻きの鬨の声》	名詞
＠しうめきのと	《死呻きの鬨の声》	名詞
＠しうめきのとき	《死呻きの鬨の声》	名詞
＠しうめきのときの	《死呻きの鬨の声》	名詞
＠しうめきのときのこ	《死呻きの鬨の声》	名詞
＠しうめきのときのこえ	《死呻きの鬨の声》	名詞
＠し	《死者の眠り》	名詞
＠しし	《死者の眠り》	名詞
＠ししゃ	《死者の眠り》	名詞
＠ししゃの	《死者の眠り》	名詞
＠ししゃのね	《死者の眠り》	名詞
＠ししゃのねむ	《死者の眠り》	名詞
＠ししゃのねむり	《死者の眠り》	名詞
＠し	《死者の神のお告げ》	名詞
＠しし	《死者の神のお告げ》	名詞
＠ししゃ	《死者の神のお告げ》	名詞
＠ししゃの	《死者の神のお告げ》	名詞
＠ししゃのか	《死者の神のお告げ》	名詞
＠ししゃのかみ	《死者の神のお告げ》	名詞
＠ししゃのかみの	《死者の神のお告げ》	名詞
＠ししゃのかみのお	《死者の神のお告げ》	名詞
＠ししゃのかみのおつ	《死者の神のお告げ》	名詞
＠ししゃのかみのおつげ	《死者の神のお告げ》	名詞
＠ざ	《残酷な医師》	名詞
＠ざん	《残酷な医師》	名詞
＠ざんこ	《残酷な医師》	名詞
＠ざんこく	《残酷な医師》	名詞
＠ざんこくな	《残酷な医師》	名詞
＠ざんこくない	《残酷な医師》	名詞
＠ざんこくないし	《残酷な医師》	名詞
＠ど	《毒々しいキマイラ》	名詞
＠どく	《毒々しいキマイラ》	名詞
＠どくど	《毒々しいキマイラ》	名詞
＠どくどく	《毒々しいキマイラ》	名詞
＠どくどくし	《毒々しいキマイラ》	名詞
＠どくどくしい	《毒々しいキマイラ》	名詞
＠どくどくしいき	《毒々しいキマイラ》	名詞
＠どくどくしいきま	《毒々しいキマイラ》	名詞
＠どくどくしいきまい	《毒々しいキマイラ》	名詞
＠どくどくしいきまいら	《毒々しいキマイラ》	名詞
＠ど	《毒の秘義司祭》	名詞
＠どく	《毒の秘義司祭》	名詞
＠どくの	《毒の秘義司祭》	名詞
＠どくのひ	《毒の秘義司祭》	名詞
＠どくのひぎ	《毒の秘義司祭》	名詞
＠どくのひぎし	《毒の秘義司祭》	名詞
＠どくのひぎしさ	《毒の秘義司祭》	名詞
＠どくのひぎしさい	《毒の秘義司祭》	名詞
＠す	《水底のクラーケン》	名詞
＠すい	《水底のクラーケン》	名詞
＠すいて	《水底のクラーケン》	名詞
＠すいてい	《水底のクラーケン》	名詞
＠すいていの	《水底のクラーケン》	名詞
＠すいていのく	《水底のクラーケン》	名詞
＠すいていのくら	《水底のクラーケン》	名詞
＠すいていのくらー	《水底のクラーケン》	名詞
＠すいていのくらーけ	《水底のクラーケン》	名詞
＠すいていのくらーけん	《水底のクラーケン》	名詞
＠わ	《沸き起こる畏怖》	名詞
＠わき	《沸き起こる畏怖》	名詞
＠わきお	《沸き起こる畏怖》	名詞
＠わきおこ	《沸き起こる畏怖》	名詞
＠わきおこる	《沸き起こる畏怖》	名詞
＠わきおこるい	《沸き起こる畏怖》	名詞
＠わきおこるいふ	《沸き起こる畏怖》	名詞
＠ぬ	《沼》	名詞
＠ぬま	《沼》	名詞
＠な	《波破りの海馬》	名詞
＠なみ	《波破りの海馬》	名詞
＠なみや	《波破りの海馬》	名詞
＠なみやぶ	《波破りの海馬》	名詞
＠なみやぶり	《波破りの海馬》	名詞
＠なみやぶりの	《波破りの海馬》	名詞
＠なみやぶりのと	《波破りの海馬》	名詞
＠なみやぶりのとど	《波破りの海馬》	名詞
＠か	《活力の贈り物》	名詞
＠かつ	《活力の贈り物》	名詞
＠かつり	《活力の贈り物》	名詞
＠かつりょ	《活力の贈り物》	名詞
＠かつりょく	《活力の贈り物》	名詞
＠かつりょくの	《活力の贈り物》	名詞
＠かつりょくのお	《活力の贈り物》	名詞
＠かつりょくのおく	《活力の贈り物》	名詞
＠かつりょくのおくり	《活力の贈り物》	名詞
＠かつりょくのおくりも	《活力の贈り物》	名詞
＠かつりょくのおくりもの	《活力の贈り物》	名詞
＠り	《流星の執政官》	名詞
＠りゅ	《流星の執政官》	名詞
＠りゅう	《流星の執政官》	名詞
＠りゅうせ	《流星の執政官》	名詞
＠りゅうせい	《流星の執政官》	名詞
＠りゅうせいの	《流星の執政官》	名詞
＠りゅうせいのし	《流星の執政官》	名詞
＠りゅうせいのしっ	《流星の執政官》	名詞
＠りゅうせいのしっせ	《流星の執政官》	名詞
＠りゅうせいのしっせい	《流星の執政官》	名詞
＠りゅうせいのしっせいか	《流星の執政官》	名詞
＠りゅうせいのしっせいかん	《流星の執政官》	名詞
＠あ	《浅瀬のクラーケン》	名詞
＠あさ	《浅瀬のクラーケン》	名詞
＠あさせ	《浅瀬のクラーケン》	名詞
＠あさせの	《浅瀬のクラーケン》	名詞
＠あさせのく	《浅瀬のクラーケン》	名詞
＠あさせのくら	《浅瀬のクラーケン》	名詞
＠あさせのくらー	《浅瀬のクラーケン》	名詞
＠あさせのくらーけ	《浅瀬のクラーケン》	名詞
＠あさせのくらーけん	《浅瀬のクラーケン》	名詞
＠う	《海に愛されしカラフィ》	名詞
＠うみ	《海に愛されしカラフィ》	名詞
＠うみに	《海に愛されしカラフィ》	名詞
＠うみにあ	《海に愛されしカラフィ》	名詞
＠うみにあい	《海に愛されしカラフィ》	名詞
＠うみにあいさ	《海に愛されしカラフィ》	名詞
＠うみにあいされ	《海に愛されしカラフィ》	名詞
＠うみにあいされし	《海に愛されしカラフィ》	名詞
＠うみにあいされしか	《海に愛されしカラフィ》	名詞
＠うみにあいされしから	《海に愛されしカラフィ》	名詞
＠うみにあいされしからふ	《海に愛されしカラフィ》	名詞
＠うみにあいされしからふぃ	《海に愛されしカラフィ》	名詞
＠う	《海の神のお告げ》	名詞
＠うみ	《海の神のお告げ》	名詞
＠うみの	《海の神のお告げ》	名詞
＠うみのか	《海の神のお告げ》	名詞
＠うみのかみ	《海の神のお告げ》	名詞
＠うみのかみの	《海の神のお告げ》	名詞
＠うみのかみのお	《海の神のお告げ》	名詞
＠うみのかみのおつ	《海の神のお告げ》	名詞
＠うみのかみのおつげ	《海の神のお告げ》	名詞
＠か	《海神の嘲笑》	名詞
＠かい	《海神の嘲笑》	名詞
＠かいじ	《海神の嘲笑》	名詞
＠かいじん	《海神の嘲笑》	名詞
＠かいじんの	《海神の嘲笑》	名詞
＠かいじんのち	《海神の嘲笑》	名詞
＠かいじんのちょ	《海神の嘲笑》	名詞
＠かいじんのちょう	《海神の嘲笑》	名詞
＠かいじんのちょうし	《海神の嘲笑》	名詞
＠かいじんのちょうしょ	《海神の嘲笑》	名詞
＠かいじんのちょうしょう	《海神の嘲笑》	名詞
＠し	《深海住まいのタッサ》	名詞
＠しん	《深海住まいのタッサ》	名詞
＠しんか	《深海住まいのタッサ》	名詞
＠しんかい	《深海住まいのタッサ》	名詞
＠しんかいず	《深海住まいのタッサ》	名詞
＠しんかいずま	《深海住まいのタッサ》	名詞
＠しんかいずまい	《深海住まいのタッサ》	名詞
＠しんかいずまいの	《深海住まいのタッサ》	名詞
＠しんかいずまいのた	《深海住まいのタッサ》	名詞
＠しんかいずまいのたっ	《深海住まいのタッサ》	名詞
＠しんかいずまいのたっさ	《深海住まいのタッサ》	名詞
＠こ	《混乱したサイクロプス》	名詞
＠こん	《混乱したサイクロプス》	名詞
＠こんら	《混乱したサイクロプス》	名詞
＠こんらん	《混乱したサイクロプス》	名詞
＠こんらんし	《混乱したサイクロプス》	名詞
＠こんらんした	《混乱したサイクロプス》	名詞
＠こんらんしたさ	《混乱したサイクロプス》	名詞
＠こんらんしたさい	《混乱したサイクロプス》	名詞
＠こんらんしたさいく	《混乱したサイクロプス》	名詞
＠こんらんしたさいくろ	《混乱したサイクロプス》	名詞
＠こんらんしたさいくろぷ	《混乱したサイクロプス》	名詞
＠こんらんしたさいくろぷす	《混乱したサイクロプス》	名詞
＠げ	《激浪の亀》	名詞
＠げき	《激浪の亀》	名詞
＠げきろ	《激浪の亀》	名詞
＠げきろう	《激浪の亀》	名詞
＠げきろうの	《激浪の亀》	名詞
＠げきろうのか	《激浪の亀》	名詞
＠げきろうのかめ	《激浪の亀》	名詞
＠は	《灰のフェニックス》	名詞
＠はい	《灰のフェニックス》	名詞
＠はいの	《灰のフェニックス》	名詞
＠はいのふ	《灰のフェニックス》	名詞
＠はいのふぇ	《灰のフェニックス》	名詞
＠はいのふぇに	《灰のフェニックス》	名詞
＠はいのふぇにっ	《灰のフェニックス》	名詞
＠はいのふぇにっく	《灰のフェニックス》	名詞
＠はいのふぇにっくす	《灰のフェニックス》	名詞
＠え	《炎の覆い》	名詞
＠えん	《炎の覆い》	名詞
＠えんの	《炎の覆い》	名詞
＠えんのお	《炎の覆い》	名詞
＠えんのおお	《炎の覆い》	名詞
＠えんのおおい	《炎の覆い》	名詞
＠む	《無傷のハクトス》	名詞
＠むき	《無傷のハクトス》	名詞
＠むきず	《無傷のハクトス》	名詞
＠むきずの	《無傷のハクトス》	名詞
＠むきずのは	《無傷のハクトス》	名詞
＠むきずのはく	《無傷のハクトス》	名詞
＠むきずのはくと	《無傷のハクトス》	名詞
＠むきずのはくとす	《無傷のハクトス》	名詞
＠し	《焼夷神託者》	名詞
＠しょ	《焼夷神託者》	名詞
＠しょう	《焼夷神託者》	名詞
＠しょうい	《焼夷神託者》	名詞
＠しょういし	《焼夷神託者》	名詞
＠しょういしん	《焼夷神託者》	名詞
＠しょういしんた	《焼夷神託者》	名詞
＠しょういしんたく	《焼夷神託者》	名詞
＠しょういしんたくし	《焼夷神託者》	名詞
＠しょういしんたくしゃ	《焼夷神託者》	名詞
＠ぼ	《牧歌的な教示者》	名詞
＠ぼっ	《牧歌的な教示者》	名詞
＠ぼっか	《牧歌的な教示者》	名詞
＠ぼっかて	《牧歌的な教示者》	名詞
＠ぼっかてき	《牧歌的な教示者》	名詞
＠ぼっかてきな	《牧歌的な教示者》	名詞
＠ぼっかてきなき	《牧歌的な教示者》	名詞
＠ぼっかてきなきょ	《牧歌的な教示者》	名詞
＠ぼっかてきなきょう	《牧歌的な教示者》	名詞
＠ぼっかてきなきょうじ	《牧歌的な教示者》	名詞
＠ぼっかてきなきょうじし	《牧歌的な教示者》	名詞
＠ぼっかてきなきょうじしゃ	《牧歌的な教示者》	名詞
＠が	《狩りに喚ばれしレナータ》	名詞
＠がり	《狩りに喚ばれしレナータ》	名詞
＠がりに	《狩りに喚ばれしレナータ》	名詞
＠がりによ	《狩りに喚ばれしレナータ》	名詞
＠がりによば	《狩りに喚ばれしレナータ》	名詞
＠がりによばれ	《狩りに喚ばれしレナータ》	名詞
＠がりによばれし	《狩りに喚ばれしレナータ》	名詞
＠がりによばれしれ	《狩りに喚ばれしレナータ》	名詞
＠がりによばれしれな	《狩りに喚ばれしレナータ》	名詞
＠がりによばれしれなー	《狩りに喚ばれしレナータ》	名詞
＠がりによばれしれなーた	《狩りに喚ばれしレナータ》	名詞
＠し	《狩猟の神のお告げ》	名詞
＠しゅ	《狩猟の神のお告げ》	名詞
＠しゅり	《狩猟の神のお告げ》	名詞
＠しゅりょ	《狩猟の神のお告げ》	名詞
＠しゅりょう	《狩猟の神のお告げ》	名詞
＠しゅりょうの	《狩猟の神のお告げ》	名詞
＠しゅりょうのか	《狩猟の神のお告げ》	名詞
＠しゅりょうのかみ	《狩猟の神のお告げ》	名詞
＠しゅりょうのかみの	《狩猟の神のお告げ》	名詞
＠しゅりょうのかみのお	《狩猟の神のお告げ》	名詞
＠しゅりょうのかみのおつ	《狩猟の神のお告げ》	名詞
＠しゅりょうのかみのおつげ	《狩猟の神のお告げ》	名詞
＠お	《狼のまとい身》	名詞
＠おお	《狼のまとい身》	名詞
＠おおか	《狼のまとい身》	名詞
＠おおかみ	《狼のまとい身》	名詞
＠おおかみの	《狼のまとい身》	名詞
＠おおかみのま	《狼のまとい身》	名詞
＠おおかみのまと	《狼のまとい身》	名詞
＠おおかみのまとい	《狼のまとい身》	名詞
＠おおかみのまといみ	《狼のまとい身》	名詞
＠お	《狼柳の安息所》	名詞
＠おお	《狼柳の安息所》	名詞
＠おおか	《狼柳の安息所》	名詞
＠おおかみ	《狼柳の安息所》	名詞
＠おおかみや	《狼柳の安息所》	名詞
＠おおかみやな	《狼柳の安息所》	名詞
＠おおかみやなぎ	《狼柳の安息所》	名詞
＠おおかみやなぎの	《狼柳の安息所》	名詞
＠おおかみやなぎのあ	《狼柳の安息所》	名詞
＠おおかみやなぎのあん	《狼柳の安息所》	名詞
＠おおかみやなぎのあんそ	《狼柳の安息所》	名詞
＠おおかみやなぎのあんそく	《狼柳の安息所》	名詞
＠おおかみやなぎのあんそくじ	《狼柳の安息所》	名詞
＠おおかみやなぎのあんそくじょ	《狼柳の安息所》	名詞
＠も	《猛然たる顕現》	名詞
＠もう	《猛然たる顕現》	名詞
＠もうぜ	《猛然たる顕現》	名詞
＠もうぜん	《猛然たる顕現》	名詞
＠もうぜんた	《猛然たる顕現》	名詞
＠もうぜんたる	《猛然たる顕現》	名詞
＠もうぜんたるけ	《猛然たる顕現》	名詞
＠もうぜんたるけん	《猛然たる顕現》	名詞
＠もうぜんたるけんげ	《猛然たる顕現》	名詞
＠もうぜんたるけんげん	《猛然たる顕現》	名詞
＠か	《甘美な忘却》	名詞
＠かん	《甘美な忘却》	名詞
＠かんび	《甘美な忘却》	名詞
＠かんびな	《甘美な忘却》	名詞
＠かんびなぼ	《甘美な忘却》	名詞
＠かんびなぼう	《甘美な忘却》	名詞
＠かんびなぼうき	《甘美な忘却》	名詞
＠かんびなぼうきゃ	《甘美な忘却》	名詞
＠かんびなぼうきゃく	《甘美な忘却》	名詞
＠は	《発想の幻霊》	名詞
＠はっ	《発想の幻霊》	名詞
＠はっそ	《発想の幻霊》	名詞
＠はっそう	《発想の幻霊》	名詞
＠はっそうの	《発想の幻霊》	名詞
＠はっそうのま	《発想の幻霊》	名詞
＠はっそうのまぼ	《発想の幻霊》	名詞
＠はっそうのまぼろ	《発想の幻霊》	名詞
＠はっそうのまぼろし	《発想の幻霊》	名詞
＠はっそうのまぼろしれ	《発想の幻霊》	名詞
＠はっそうのまぼろしれい	《発想の幻霊》	名詞
＠ま	《瞬き翼のキマイラ》	名詞
＠また	《瞬き翼のキマイラ》	名詞
＠またた	《瞬き翼のキマイラ》	名詞
＠またたき	《瞬き翼のキマイラ》	名詞
＠またたきつ	《瞬き翼のキマイラ》	名詞
＠またたきつば	《瞬き翼のキマイラ》	名詞
＠またたきつばさ	《瞬き翼のキマイラ》	名詞
＠またたきつばさの	《瞬き翼のキマイラ》	名詞
＠またたきつばさのき	《瞬き翼のキマイラ》	名詞
＠またたきつばさのきま	《瞬き翼のキマイラ》	名詞
＠またたきつばさのきまい	《瞬き翼のキマイラ》	名詞
＠またたきつばさのきまいら	《瞬き翼のキマイラ》	名詞
＠し	《神性の否定》	名詞
＠しん	《神性の否定》	名詞
＠しんせ	《神性の否定》	名詞
＠しんせい	《神性の否定》	名詞
＠しんせいの	《神性の否定》	名詞
＠しんせいのひ	《神性の否定》	名詞
＠しんせいのひて	《神性の否定》	名詞
＠しんせいのひてい	《神性の否定》	名詞
＠し	《神殿泥棒》	名詞
＠しん	《神殿泥棒》	名詞
＠しんで	《神殿泥棒》	名詞
＠しんでん	《神殿泥棒》	名詞
＠しんでんど	《神殿泥棒》	名詞
＠しんでんどろ	《神殿泥棒》	名詞
＠しんでんどろぼ	《神殿泥棒》	名詞
＠しんでんどろぼう	《神殿泥棒》	名詞
＠し	《神秘の撤回》	名詞
＠しん	《神秘の撤回》	名詞
＠しんぴ	《神秘の撤回》	名詞
＠しんぴの	《神秘の撤回》	名詞
＠しんぴのて	《神秘の撤回》	名詞
＠しんぴのてっ	《神秘の撤回》	名詞
＠しんぴのてっか	《神秘の撤回》	名詞
＠しんぴのてっかい	《神秘の撤回》	名詞
＠し	《神秘の賢者》	名詞
＠しん	《神秘の賢者》	名詞
＠しんぴ	《神秘の賢者》	名詞
＠しんぴの	《神秘の賢者》	名詞
＠しんぴのけ	《神秘の賢者》	名詞
＠しんぴのけん	《神秘の賢者》	名詞
＠しんぴのけんじ	《神秘の賢者》	名詞
＠しんぴのけんじゃ	《神秘の賢者》	名詞
＠ひ	《秘術師の使い魔》	名詞
＠ひじ	《秘術師の使い魔》	名詞
＠ひじゅ	《秘術師の使い魔》	名詞
＠ひじゅつ	《秘術師の使い魔》	名詞
＠ひじゅつし	《秘術師の使い魔》	名詞
＠ひじゅつしの	《秘術師の使い魔》	名詞
＠ひじゅつしのつ	《秘術師の使い魔》	名詞
＠ひじゅつしのつか	《秘術師の使い魔》	名詞
＠ひじゅつしのつかい	《秘術師の使い魔》	名詞
＠ひじゅつしのつかいま	《秘術師の使い魔》	名詞
＠そ	《空の粉砕》	名詞
＠そら	《空の粉砕》	名詞
＠そらの	《空の粉砕》	名詞
＠そらのふ	《空の粉砕》	名詞
＠そらのふん	《空の粉砕》	名詞
＠そらのふんさ	《空の粉砕》	名詞
＠そらのふんさい	《空の粉砕》	名詞
＠り	《立腹》	名詞
＠りっ	《立腹》	名詞
＠りっぷ	《立腹》	名詞
＠りっぷく	《立腹》	名詞
＠き	《競技会の英雄》	名詞
＠きょ	《競技会の英雄》	名詞
＠きょう	《競技会の英雄》	名詞
＠きょうぎ	《競技会の英雄》	名詞
＠きょうぎか	《競技会の英雄》	名詞
＠きょうぎかい	《競技会の英雄》	名詞
＠きょうぎかいの	《競技会の英雄》	名詞
＠きょうぎかいのえ	《競技会の英雄》	名詞
＠きょうぎかいのえい	《競技会の英雄》	名詞
＠きょうぎかいのえいゆ	《競技会の英雄》	名詞
＠きょうぎかいのえいゆう	《競技会の英雄》	名詞
＠だ	《第１回イロアス競技会》	名詞
＠だい	《第１回イロアス競技会》	名詞
＠だい１	《第１回イロアス競技会》	名詞
＠だい１か	《第１回イロアス競技会》	名詞
＠だい１かい	《第１回イロアス競技会》	名詞
＠だい１かいい	《第１回イロアス競技会》	名詞
＠だい１かいいろ	《第１回イロアス競技会》	名詞
＠だい１かいいろあ	《第１回イロアス競技会》	名詞
＠だい１かいいろあす	《第１回イロアス競技会》	名詞
＠だい１かいいろあすき	《第１回イロアス競技会》	名詞
＠だい１かいいろあすきょ	《第１回イロアス競技会》	名詞
＠だい１かいいろあすきょう	《第１回イロアス競技会》	名詞
＠だい１かいいろあすきょうぎ	《第１回イロアス競技会》	名詞
＠だい１かいいろあすきょうぎか	《第１回イロアス競技会》	名詞
＠だい１かいいろあすきょうぎかい	《第１回イロアス競技会》	名詞
＠せ	《精神潰しのハーピー》	名詞
＠せい	《精神潰しのハーピー》	名詞
＠せいし	《精神潰しのハーピー》	名詞
＠せいしん	《精神潰しのハーピー》	名詞
＠せいしんつ	《精神潰しのハーピー》	名詞
＠せいしんつぶ	《精神潰しのハーピー》	名詞
＠せいしんつぶし	《精神潰しのハーピー》	名詞
＠せいしんつぶしの	《精神潰しのハーピー》	名詞
＠せいしんつぶしのは	《精神潰しのハーピー》	名詞
＠せいしんつぶしのはー	《精神潰しのハーピー》	名詞
＠せいしんつぶしのはーぴ	《精神潰しのハーピー》	名詞
＠せいしんつぶしのはーぴー	《精神潰しのハーピー》	名詞
＠せ	《精鋭の教官》	名詞
＠せい	《精鋭の教官》	名詞
＠せいえ	《精鋭の教官》	名詞
＠せいえい	《精鋭の教官》	名詞
＠せいえいの	《精鋭の教官》	名詞
＠せいえいのき	《精鋭の教官》	名詞
＠せいえいのきょ	《精鋭の教官》	名詞
＠せいえいのきょう	《精鋭の教官》	名詞
＠せいえいのきょうか	《精鋭の教官》	名詞
＠せいえいのきょうかん	《精鋭の教官》	名詞
＠お	《終わりなき巣網のアラスタ》	名詞
＠おわ	《終わりなき巣網のアラスタ》	名詞
＠おわり	《終わりなき巣網のアラスタ》	名詞
＠おわりな	《終わりなき巣網のアラスタ》	名詞
＠おわりなき	《終わりなき巣網のアラスタ》	名詞
＠おわりなきす	《終わりなき巣網のアラスタ》	名詞
＠おわりなきすあ	《終わりなき巣網のアラスタ》	名詞
＠おわりなきすあみ	《終わりなき巣網のアラスタ》	名詞
＠おわりなきすあみの	《終わりなき巣網のアラスタ》	名詞
＠おわりなきすあみのあ	《終わりなき巣網のアラスタ》	名詞
＠おわりなきすあみのあら	《終わりなき巣網のアラスタ》	名詞
＠おわりなきすあみのあらす	《終わりなき巣網のアラスタ》	名詞
＠おわりなきすあみのあらすた	《終わりなき巣網のアラスタ》	名詞
＠お	《終わりなき踊りのガリア》	名詞
＠おわ	《終わりなき踊りのガリア》	名詞
＠おわり	《終わりなき踊りのガリア》	名詞
＠おわりな	《終わりなき踊りのガリア》	名詞
＠おわりなき	《終わりなき踊りのガリア》	名詞
＠おわりなきお	《終わりなき踊りのガリア》	名詞
＠おわりなきおど	《終わりなき踊りのガリア》	名詞
＠おわりなきおどり	《終わりなき踊りのガリア》	名詞
＠おわりなきおどりの	《終わりなき踊りのガリア》	名詞
＠おわりなきおどりのが	《終わりなき踊りのガリア》	名詞
＠おわりなきおどりのがり	《終わりなき踊りのガリア》	名詞
＠おわりなきおどりのがりあ	《終わりなき踊りのガリア》	名詞
＠け	《結節点の番人》	名詞
＠けっ	《結節点の番人》	名詞
＠けっせ	《結節点の番人》	名詞
＠けっせつ	《結節点の番人》	名詞
＠けっせつて	《結節点の番人》	名詞
＠けっせつてん	《結節点の番人》	名詞
＠けっせつてんの	《結節点の番人》	名詞
＠けっせつてんのば	《結節点の番人》	名詞
＠けっせつてんのばん	《結節点の番人》	名詞
＠けっせつてんのばんに	《結節点の番人》	名詞
＠けっせつてんのばんにん	《結節点の番人》	名詞
＠つ	《繋がれた者の番人》	名詞
＠つな	《繋がれた者の番人》	名詞
＠つなが	《繋がれた者の番人》	名詞
＠つながれ	《繋がれた者の番人》	名詞
＠つながれた	《繋がれた者の番人》	名詞
＠つながれたも	《繋がれた者の番人》	名詞
＠つながれたもの	《繋がれた者の番人》	名詞
＠つながれたものの	《繋がれた者の番人》	名詞
＠つながれたもののば	《繋がれた者の番人》	名詞
＠つながれたもののばん	《繋がれた者の番人》	名詞
＠つながれたもののばんに	《繋がれた者の番人》	名詞
＠つながれたもののばんにん	《繋がれた者の番人》	名詞
＠む	《群れの英雄》	名詞
＠むれ	《群れの英雄》	名詞
＠むれの	《群れの英雄》	名詞
＠むれのえ	《群れの英雄》	名詞
＠むれのえい	《群れの英雄》	名詞
＠むれのえいゆ	《群れの英雄》	名詞
＠むれのえいゆう	《群れの英雄》	名詞
＠む	《胸躍る可能性》	名詞
＠むね	《胸躍る可能性》	名詞
＠むねお	《胸躍る可能性》	名詞
＠むねおど	《胸躍る可能性》	名詞
＠むねおどる	《胸躍る可能性》	名詞
＠むねおどるか	《胸躍る可能性》	名詞
＠むねおどるかの	《胸躍る可能性》	名詞
＠むねおどるかのう	《胸躍る可能性》	名詞
＠むねおどるかのうせ	《胸躍る可能性》	名詞
＠むねおどるかのうせい	《胸躍る可能性》	名詞
＠だ	《脱出速度》	名詞
＠だっ	《脱出速度》	名詞
＠だっし	《脱出速度》	名詞
＠だっしゅ	《脱出速度》	名詞
＠だっしゅつ	《脱出速度》	名詞
＠だっしゅつそ	《脱出速度》	名詞
＠だっしゅつそく	《脱出速度》	名詞
＠だっしゅつそくど	《脱出速度》	名詞
＠し	《自然の怒りのタイタン、ウーロ》	名詞
＠しぜ	《自然の怒りのタイタン、ウーロ》	名詞
＠しぜん	《自然の怒りのタイタン、ウーロ》	名詞
＠しぜんの	《自然の怒りのタイタン、ウーロ》	名詞
＠しぜんのい	《自然の怒りのタイタン、ウーロ》	名詞
＠しぜんのいか	《自然の怒りのタイタン、ウーロ》	名詞
＠しぜんのいかり	《自然の怒りのタイタン、ウーロ》	名詞
＠しぜんのいかりの	《自然の怒りのタイタン、ウーロ》	名詞
＠しぜんのいかりのた	《自然の怒りのタイタン、ウーロ》	名詞
＠しぜんのいかりのたい	《自然の怒りのタイタン、ウーロ》	名詞
＠しぜんのいかりのたいた	《自然の怒りのタイタン、ウーロ》	名詞
＠しぜんのいかりのたいたん	《自然の怒りのタイタン、ウーロ》	名詞
＠しぜんのいかりのたいたん、	《自然の怒りのタイタン、ウーロ》	名詞
＠しぜんのいかりのたいたん、う	《自然の怒りのタイタン、ウーロ》	名詞
＠しぜんのいかりのたいたん、うー	《自然の怒りのタイタン、ウーロ》	名詞
＠しぜんのいかりのたいたん、うーろ	《自然の怒りのタイタン、ウーロ》	名詞
＠う	《自然の怒りのタイタン、ウーロ》	名詞
＠うー	《自然の怒りのタイタン、ウーロ》	名詞
＠うーろ	《自然の怒りのタイタン、ウーロ》	名詞
＠し	《自然への回帰》	名詞
＠しぜ	《自然への回帰》	名詞
＠しぜん	《自然への回帰》	名詞
＠しぜんへ	《自然への回帰》	名詞
＠しぜんへの	《自然への回帰》	名詞
＠しぜんへのか	《自然への回帰》	名詞
＠しぜんへのかい	《自然への回帰》	名詞
＠しぜんへのかいき	《自然への回帰》	名詞
＠ご	《苔のバイパー》	名詞
＠ごけ	《苔のバイパー》	名詞
＠ごけの	《苔のバイパー》	名詞
＠ごけのば	《苔のバイパー》	名詞
＠ごけのばい	《苔のバイパー》	名詞
＠ごけのばいぱ	《苔のバイパー》	名詞
＠ごけのばいぱー	《苔のバイパー》	名詞
＠く	《苦悶の侍祭》	名詞
＠くも	《苦悶の侍祭》	名詞
＠くもん	《苦悶の侍祭》	名詞
＠くもんの	《苦悶の侍祭》	名詞
＠くもんのさ	《苦悶の侍祭》	名詞
＠くもんのさむ	《苦悶の侍祭》	名詞
＠くもんのさむら	《苦悶の侍祭》	名詞
＠くもんのさむらい	《苦悶の侍祭》	名詞
＠くもんのさむらいさ	《苦悶の侍祭》	名詞
＠くもんのさむらいさい	《苦悶の侍祭》	名詞
＠く	《苦悶の悔恨》	名詞
＠くも	《苦悶の悔恨》	名詞
＠くもん	《苦悶の悔恨》	名詞
＠くもんの	《苦悶の悔恨》	名詞
＠くもんのか	《苦悶の悔恨》	名詞
＠くもんのかい	《苦悶の悔恨》	名詞
＠くもんのかいこ	《苦悶の悔恨》	名詞
＠くもんのかいこん	《苦悶の悔恨》	名詞
＠こ	《荒涼とした心のエレボス》	名詞
＠こう	《荒涼とした心のエレボス》	名詞
＠こうり	《荒涼とした心のエレボス》	名詞
＠こうりょ	《荒涼とした心のエレボス》	名詞
＠こうりょう	《荒涼とした心のエレボス》	名詞
＠こうりょうと	《荒涼とした心のエレボス》	名詞
＠こうりょうとし	《荒涼とした心のエレボス》	名詞
＠こうりょうとした	《荒涼とした心のエレボス》	名詞
＠こうりょうとしたこ	《荒涼とした心のエレボス》	名詞
＠こうりょうとしたここ	《荒涼とした心のエレボス》	名詞
＠こうりょうとしたこころ	《荒涼とした心のエレボス》	名詞
＠こうりょうとしたこころの	《荒涼とした心のエレボス》	名詞
＠こうりょうとしたこころのえ	《荒涼とした心のエレボス》	名詞
＠こうりょうとしたこころのえれ	《荒涼とした心のエレボス》	名詞
＠こうりょうとしたこころのえれぼ	《荒涼とした心のエレボス》	名詞
＠こうりょうとしたこころのえれぼす	《荒涼とした心のエレボス》	名詞
＠そ	《葬儀》	名詞
＠そう	《葬儀》	名詞
＠そうぎ	《葬儀》	名詞
＠こ	《蠱惑的なユニコーン》	名詞
＠こわ	《蠱惑的なユニコーン》	名詞
＠こわく	《蠱惑的なユニコーン》	名詞
＠こわくて	《蠱惑的なユニコーン》	名詞
＠こわくてき	《蠱惑的なユニコーン》	名詞
＠こわくてきな	《蠱惑的なユニコーン》	名詞
＠こわくてきなゆ	《蠱惑的なユニコーン》	名詞
＠こわくてきなゆに	《蠱惑的なユニコーン》	名詞
＠こわくてきなゆにこ	《蠱惑的なユニコーン》	名詞
＠こわくてきなゆにこー	《蠱惑的なユニコーン》	名詞
＠こわくてきなゆにこーん	《蠱惑的なユニコーン》	名詞
＠ち	《血の野心家》	名詞
＠ちの	《血の野心家》	名詞
＠ちのや	《血の野心家》	名詞
＠ちのやし	《血の野心家》	名詞
＠ちのやしん	《血の野心家》	名詞
＠ちのやしんか	《血の野心家》	名詞
＠う	《裏切りの先触れ》	名詞
＠うら	《裏切りの先触れ》	名詞
＠うらぎ	《裏切りの先触れ》	名詞
＠うらぎり	《裏切りの先触れ》	名詞
＠うらぎりの	《裏切りの先触れ》	名詞
＠うらぎりのさ	《裏切りの先触れ》	名詞
＠うらぎりのさき	《裏切りの先触れ》	名詞
＠うらぎりのさきぶ	《裏切りの先触れ》	名詞
＠うらぎりのさきぶれ	《裏切りの先触れ》	名詞
＠う	《裏切る恵み》	名詞
＠うら	《裏切る恵み》	名詞
＠うらぎ	《裏切る恵み》	名詞
＠うらぎる	《裏切る恵み》	名詞
＠うらぎるめ	《裏切る恵み》	名詞
＠うらぎるめぐ	《裏切る恵み》	名詞
＠うらぎるめぐみ	《裏切る恵み》	名詞
＠き	《記憶からの束縛》	名詞
＠きお	《記憶からの束縛》	名詞
＠きおく	《記憶からの束縛》	名詞
＠きおくか	《記憶からの束縛》	名詞
＠きおくから	《記憶からの束縛》	名詞
＠きおくからの	《記憶からの束縛》	名詞
＠きおくからのそ	《記憶からの束縛》	名詞
＠きおくからのそく	《記憶からの束縛》	名詞
＠きおくからのそくば	《記憶からの束縛》	名詞
＠きおくからのそくばく	《記憶からの束縛》	名詞
＠き	《記憶を飲み込むもの》	名詞
＠きお	《記憶を飲み込むもの》	名詞
＠きおく	《記憶を飲み込むもの》	名詞
＠きおくを	《記憶を飲み込むもの》	名詞
＠きおくをの	《記憶を飲み込むもの》	名詞
＠きおくをのみ	《記憶を飲み込むもの》	名詞
＠きおくをのみこ	《記憶を飲み込むもの》	名詞
＠きおくをのみこむ	《記憶を飲み込むもの》	名詞
＠きおくをのみこむも	《記憶を飲み込むもの》	名詞
＠きおくをのみこむもの	《記憶を飲み込むもの》	名詞
＠き	《記憶流出》	名詞
＠きお	《記憶流出》	名詞
＠きおく	《記憶流出》	名詞
＠きおくり	《記憶流出》	名詞
＠きおくりゅ	《記憶流出》	名詞
＠きおくりゅう	《記憶流出》	名詞
＠きおくりゅうし	《記憶流出》	名詞
＠きおくりゅうしゅ	《記憶流出》	名詞
＠きおくりゅうしゅつ	《記憶流出》	名詞
＠ほ	《豊潤の神殿》	名詞
＠ほう	《豊潤の神殿》	名詞
＠ほうじ	《豊潤の神殿》	名詞
＠ほうじゅ	《豊潤の神殿》	名詞
＠ほうじゅん	《豊潤の神殿》	名詞
＠ほうじゅんの	《豊潤の神殿》	名詞
＠ほうじゅんのし	《豊潤の神殿》	名詞
＠ほうじゅんのしん	《豊潤の神殿》	名詞
＠ほうじゅんのしんで	《豊潤の神殿》	名詞
＠ほうじゅんのしんでん	《豊潤の神殿》	名詞
＠け	《軽率な祝賀者》	名詞
＠けい	《軽率な祝賀者》	名詞
＠けいそ	《軽率な祝賀者》	名詞
＠けいそつ	《軽率な祝賀者》	名詞
＠けいそつな	《軽率な祝賀者》	名詞
＠けいそつなし	《軽率な祝賀者》	名詞
＠けいそつなしゅ	《軽率な祝賀者》	名詞
＠けいそつなしゅく	《軽率な祝賀者》	名詞
＠けいそつなしゅくが	《軽率な祝賀者》	名詞
＠けいそつなしゅくがし	《軽率な祝賀者》	名詞
＠けいそつなしゅくがしゃ	《軽率な祝賀者》	名詞
＠と	《轟く戦車》	名詞
＠とど	《轟く戦車》	名詞
＠とどろ	《轟く戦車》	名詞
＠とどろく	《轟く戦車》	名詞
＠とどろくせ	《轟く戦車》	名詞
＠とどろくせん	《轟く戦車》	名詞
＠とどろくせんし	《轟く戦車》	名詞
＠とどろくせんしゃ	《轟く戦車》	名詞
＠と	《轟く歩哨》	名詞
＠とど	《轟く歩哨》	名詞
＠とどろ	《轟く歩哨》	名詞
＠とどろく	《轟く歩哨》	名詞
＠とどろくほ	《轟く歩哨》	名詞
＠とどろくほし	《轟く歩哨》	名詞
＠とどろくほしょ	《轟く歩哨》	名詞
＠とどろくほしょう	《轟く歩哨》	名詞
＠う	《運命のちらつき》	名詞
＠うん	《運命のちらつき》	名詞
＠うんめ	《運命のちらつき》	名詞
＠うんめい	《運命のちらつき》	名詞
＠うんめいの	《運命のちらつき》	名詞
＠うんめいのち	《運命のちらつき》	名詞
＠うんめいのちら	《運命のちらつき》	名詞
＠うんめいのちらつ	《運命のちらつき》	名詞
＠うんめいのちらつき	《運命のちらつき》	名詞
＠う	《運命の手、ケイリクス》	名詞
＠うん	《運命の手、ケイリクス》	名詞
＠うんめ	《運命の手、ケイリクス》	名詞
＠うんめい	《運命の手、ケイリクス》	名詞
＠うんめいの	《運命の手、ケイリクス》	名詞
＠うんめいのて	《運命の手、ケイリクス》	名詞
＠うんめいのて、	《運命の手、ケイリクス》	名詞
＠うんめいのて、け	《運命の手、ケイリクス》	名詞
＠うんめいのて、けい	《運命の手、ケイリクス》	名詞
＠うんめいのて、けいり	《運命の手、ケイリクス》	名詞
＠うんめいのて、けいりく	《運命の手、ケイリクス》	名詞
＠うんめいのて、けいりくす	《運命の手、ケイリクス》	名詞
＠け	《運命の手、ケイリクス》	名詞
＠けい	《運命の手、ケイリクス》	名詞
＠けいり	《運命の手、ケイリクス》	名詞
＠けいりく	《運命の手、ケイリクス》	名詞
＠けいりくす	《運命の手、ケイリクス》	名詞
＠う	《運命の神、クローティス》	名詞
＠うん	《運命の神、クローティス》	名詞
＠うんめ	《運命の神、クローティス》	名詞
＠うんめい	《運命の神、クローティス》	名詞
＠うんめいの	《運命の神、クローティス》	名詞
＠うんめいのか	《運命の神、クローティス》	名詞
＠うんめいのかみ	《運命の神、クローティス》	名詞
＠うんめいのかみ、	《運命の神、クローティス》	名詞
＠うんめいのかみ、く	《運命の神、クローティス》	名詞
＠うんめいのかみ、くろ	《運命の神、クローティス》	名詞
＠うんめいのかみ、くろー	《運命の神、クローティス》	名詞
＠うんめいのかみ、くろーて	《運命の神、クローティス》	名詞
＠うんめいのかみ、くろーてぃ	《運命の神、クローティス》	名詞
＠うんめいのかみ、くろーてぃす	《運命の神、クローティス》	名詞
＠く	《運命の神、クローティス》	名詞
＠くろ	《運命の神、クローティス》	名詞
＠くろー	《運命の神、クローティス》	名詞
＠くろーて	《運命の神、クローティス》	名詞
＠くろーてぃ	《運命の神、クローティス》	名詞
＠くろーてぃす	《運命の神、クローティス》	名詞
＠う	《運命を紡ぐ者》	名詞
＠うん	《運命を紡ぐ者》	名詞
＠うんめ	《運命を紡ぐ者》	名詞
＠うんめい	《運命を紡ぐ者》	名詞
＠うんめいを	《運命を紡ぐ者》	名詞
＠うんめいをつ	《運命を紡ぐ者》	名詞
＠うんめいをつむ	《運命を紡ぐ者》	名詞
＠うんめいをつむぐ	《運命を紡ぐ者》	名詞
＠うんめいをつむぐも	《運命を紡ぐ者》	名詞
＠うんめいをつむぐもの	《運命を紡ぐ者》	名詞
＠う	《運命的結末》	名詞
＠うん	《運命的結末》	名詞
＠うんめ	《運命的結末》	名詞
＠うんめい	《運命的結末》	名詞
＠うんめいて	《運命的結末》	名詞
＠うんめいてき	《運命的結末》	名詞
＠うんめいてきけ	《運命的結末》	名詞
＠うんめいてきけつ	《運命的結末》	名詞
＠うんめいてきけつま	《運命的結末》	名詞
＠うんめいてきけつまつ	《運命的結末》	名詞
＠さ	《避け難い最期》	名詞
＠さけ	《避け難い最期》	名詞
＠さけが	《避け難い最期》	名詞
＠さけがた	《避け難い最期》	名詞
＠さけがたい	《避け難い最期》	名詞
＠さけがたいさ	《避け難い最期》	名詞
＠さけがたいさい	《避け難い最期》	名詞
＠さけがたいさいご	《避け難い最期》	名詞
＠て	《鉄鱗のハイドラ》	名詞
＠てつ	《鉄鱗のハイドラ》	名詞
＠てつう	《鉄鱗のハイドラ》	名詞
＠てつうろ	《鉄鱗のハイドラ》	名詞
＠てつうろこ	《鉄鱗のハイドラ》	名詞
＠てつうろこの	《鉄鱗のハイドラ》	名詞
＠てつうろこのは	《鉄鱗のハイドラ》	名詞
＠てつうろこのはい	《鉄鱗のハイドラ》	名詞
＠てつうろこのはいど	《鉄鱗のハイドラ》	名詞
＠てつうろこのはいどら	《鉄鱗のハイドラ》	名詞
＠す	《鋭い目、ナイレア》	名詞
＠する	《鋭い目、ナイレア》	名詞
＠するど	《鋭い目、ナイレア》	名詞
＠するどい	《鋭い目、ナイレア》	名詞
＠するどいめ	《鋭い目、ナイレア》	名詞
＠するどいめ、	《鋭い目、ナイレア》	名詞
＠するどいめ、な	《鋭い目、ナイレア》	名詞
＠するどいめ、ない	《鋭い目、ナイレア》	名詞
＠するどいめ、ないれ	《鋭い目、ナイレア》	名詞
＠するどいめ、ないれあ	《鋭い目、ナイレア》	名詞
＠な	《鋭い目、ナイレア》	名詞
＠ない	《鋭い目、ナイレア》	名詞
＠ないれ	《鋭い目、ナイレア》	名詞
＠ないれあ	《鋭い目、ナイレア》	名詞
＠か	《鍛冶で鍛えられしアナックス》	名詞
＠かじ	《鍛冶で鍛えられしアナックス》	名詞
＠かじで	《鍛冶で鍛えられしアナックス》	名詞
＠かじでき	《鍛冶で鍛えられしアナックス》	名詞
＠かじできた	《鍛冶で鍛えられしアナックス》	名詞
＠かじできたえ	《鍛冶で鍛えられしアナックス》	名詞
＠かじできたえら	《鍛冶で鍛えられしアナックス》	名詞
＠かじできたえられ	《鍛冶で鍛えられしアナックス》	名詞
＠かじできたえられし	《鍛冶で鍛えられしアナックス》	名詞
＠かじできたえられしあ	《鍛冶で鍛えられしアナックス》	名詞
＠かじできたえられしあな	《鍛冶で鍛えられしアナックス》	名詞
＠かじできたえられしあなっ	《鍛冶で鍛えられしアナックス》	名詞
＠かじできたえられしあなっく	《鍛冶で鍛えられしアナックス》	名詞
＠かじできたえられしあなっくす	《鍛冶で鍛えられしアナックス》	名詞
＠か	《鍛冶の神のお告げ》	名詞
＠かじ	《鍛冶の神のお告げ》	名詞
＠かじの	《鍛冶の神のお告げ》	名詞
＠かじのか	《鍛冶の神のお告げ》	名詞
＠かじのかみ	《鍛冶の神のお告げ》	名詞
＠かじのかみの	《鍛冶の神のお告げ》	名詞
＠かじのかみのお	《鍛冶の神のお告げ》	名詞
＠かじのかみのおつ	《鍛冶の神のお告げ》	名詞
＠かじのかみのおつげ	《鍛冶の神のお告げ》	名詞
＠く	《鎖を解かれしもの、ポルクラノス》	名詞
＠くさ	《鎖を解かれしもの、ポルクラノス》	名詞
＠くさり	《鎖を解かれしもの、ポルクラノス》	名詞
＠くさりを	《鎖を解かれしもの、ポルクラノス》	名詞
＠くさりをと	《鎖を解かれしもの、ポルクラノス》	名詞
＠くさりをとか	《鎖を解かれしもの、ポルクラノス》	名詞
＠くさりをとかれ	《鎖を解かれしもの、ポルクラノス》	名詞
＠くさりをとかれし	《鎖を解かれしもの、ポルクラノス》	名詞
＠くさりをとかれしも	《鎖を解かれしもの、ポルクラノス》	名詞
＠くさりをとかれしもの	《鎖を解かれしもの、ポルクラノス》	名詞
＠くさりをとかれしもの、	《鎖を解かれしもの、ポルクラノス》	名詞
＠くさりをとかれしもの、ぽ	《鎖を解かれしもの、ポルクラノス》	名詞
＠くさりをとかれしもの、ぽる	《鎖を解かれしもの、ポルクラノス》	名詞
＠くさりをとかれしもの、ぽるく	《鎖を解かれしもの、ポルクラノス》	名詞
＠くさりをとかれしもの、ぽるくら	《鎖を解かれしもの、ポルクラノス》	名詞
＠くさりをとかれしもの、ぽるくらの	《鎖を解かれしもの、ポルクラノス》	名詞
＠くさりをとかれしもの、ぽるくらのす	《鎖を解かれしもの、ポルクラノス》	名詞
＠ぽ	《鎖を解かれしもの、ポルクラノス》	名詞
＠ぽる	《鎖を解かれしもの、ポルクラノス》	名詞
＠ぽるく	《鎖を解かれしもの、ポルクラノス》	名詞
＠ぽるくら	《鎖を解かれしもの、ポルクラノス》	名詞
＠ぽるくらの	《鎖を解かれしもの、ポルクラノス》	名詞
＠ぽるくらのす	《鎖を解かれしもの、ポルクラノス》	名詞
＠く	《鎖巣網のアラクニル》	名詞
＠くさ	《鎖巣網のアラクニル》	名詞
＠くさり	《鎖巣網のアラクニル》	名詞
＠くさりす	《鎖巣網のアラクニル》	名詞
＠くさりすあ	《鎖巣網のアラクニル》	名詞
＠くさりすあみ	《鎖巣網のアラクニル》	名詞
＠くさりすあみの	《鎖巣網のアラクニル》	名詞
＠くさりすあみのあ	《鎖巣網のアラクニル》	名詞
＠くさりすあみのあら	《鎖巣網のアラクニル》	名詞
＠くさりすあみのあらく	《鎖巣網のアラクニル》	名詞
＠くさりすあみのあらくに	《鎖巣網のアラクニル》	名詞
＠くさりすあみのあらくにる	《鎖巣網のアラクニル》	名詞
＠か	《鏡の盾》	名詞
＠かが	《鏡の盾》	名詞
＠かがみ	《鏡の盾》	名詞
＠かがみの	《鏡の盾》	名詞
＠かがみのた	《鏡の盾》	名詞
＠かがみのたて	《鏡の盾》	名詞
＠と	《闘技場のペテン師》	名詞
＠とう	《闘技場のペテン師》	名詞
＠とうぎ	《闘技場のペテン師》	名詞
＠とうぎじ	《闘技場のペテン師》	名詞
＠とうぎじょ	《闘技場のペテン師》	名詞
＠とうぎじょう	《闘技場のペテン師》	名詞
＠とうぎじょうの	《闘技場のペテン師》	名詞
＠とうぎじょうのぺ	《闘技場のペテン師》	名詞
＠とうぎじょうのぺて	《闘技場のペテン師》	名詞
＠とうぎじょうのぺてん	《闘技場のペテン師》	名詞
＠とうぎじょうのぺてんし	《闘技場のペテン師》	名詞
＠よ	《陽光たてがみのペガサス》	名詞
＠よう	《陽光たてがみのペガサス》	名詞
＠ようこ	《陽光たてがみのペガサス》	名詞
＠ようこう	《陽光たてがみのペガサス》	名詞
＠ようこうた	《陽光たてがみのペガサス》	名詞
＠ようこうたて	《陽光たてがみのペガサス》	名詞
＠ようこうたてが	《陽光たてがみのペガサス》	名詞
＠ようこうたてがみ	《陽光たてがみのペガサス》	名詞
＠ようこうたてがみの	《陽光たてがみのペガサス》	名詞
＠ようこうたてがみのぺ	《陽光たてがみのペガサス》	名詞
＠ようこうたてがみのぺが	《陽光たてがみのペガサス》	名詞
＠ようこうたてがみのぺがさ	《陽光たてがみのペガサス》	名詞
＠ようこうたてがみのぺがさす	《陽光たてがみのペガサス》	名詞
＠し	《障害の幻霊》	名詞
＠しょ	《障害の幻霊》	名詞
＠しょう	《障害の幻霊》	名詞
＠しょうが	《障害の幻霊》	名詞
＠しょうがい	《障害の幻霊》	名詞
＠しょうがいの	《障害の幻霊》	名詞
＠しょうがいのま	《障害の幻霊》	名詞
＠しょうがいのまぼ	《障害の幻霊》	名詞
＠しょうがいのまぼろ	《障害の幻霊》	名詞
＠しょうがいのまぼろし	《障害の幻霊》	名詞
＠しょうがいのまぼろしれ	《障害の幻霊》	名詞
＠しょうがいのまぼろしれい	《障害の幻霊》	名詞
＠か	《隠れた入り江のナイアード》	名詞
＠かく	《隠れた入り江のナイアード》	名詞
＠かくれ	《隠れた入り江のナイアード》	名詞
＠かくれた	《隠れた入り江のナイアード》	名詞
＠かくれたい	《隠れた入り江のナイアード》	名詞
＠かくれたいり	《隠れた入り江のナイアード》	名詞
＠かくれたいりえ	《隠れた入り江のナイアード》	名詞
＠かくれたいりえの	《隠れた入り江のナイアード》	名詞
＠かくれたいりえのな	《隠れた入り江のナイアード》	名詞
＠かくれたいりえのない	《隠れた入り江のナイアード》	名詞
＠かくれたいりえのないあ	《隠れた入り江のナイアード》	名詞
＠かくれたいりえのないあー	《隠れた入り江のナイアード》	名詞
＠かくれたいりえのないあーど	《隠れた入り江のナイアード》	名詞
＠せ	《青銅の剣》	名詞
＠せい	《青銅の剣》	名詞
＠せいど	《青銅の剣》	名詞
＠せいどう	《青銅の剣》	名詞
＠せいどうの	《青銅の剣》	名詞
＠せいどうのけ	《青銅の剣》	名詞
＠せいどうのけん	《青銅の剣》	名詞
＠せ	《青銅皮ライオン》	名詞
＠せい	《青銅皮ライオン》	名詞
＠せいど	《青銅皮ライオン》	名詞
＠せいどう	《青銅皮ライオン》	名詞
＠せいどうか	《青銅皮ライオン》	名詞
＠せいどうかわ	《青銅皮ライオン》	名詞
＠せいどうかわら	《青銅皮ライオン》	名詞
＠せいどうかわらい	《青銅皮ライオン》	名詞
＠せいどうかわらいお	《青銅皮ライオン》	名詞
＠せいどうかわらいおん	《青銅皮ライオン》	名詞
＠せ	《青銅血のパーフォロス》	名詞
＠せい	《青銅血のパーフォロス》	名詞
＠せいど	《青銅血のパーフォロス》	名詞
＠せいどう	《青銅血のパーフォロス》	名詞
＠せいどうち	《青銅血のパーフォロス》	名詞
＠せいどうちの	《青銅血のパーフォロス》	名詞
＠せいどうちのぱ	《青銅血のパーフォロス》	名詞
＠せいどうちのぱー	《青銅血のパーフォロス》	名詞
＠せいどうちのぱーふ	《青銅血のパーフォロス》	名詞
＠せいどうちのぱーふぉ	《青銅血のパーフォロス》	名詞
＠せいどうちのぱーふぉろ	《青銅血のパーフォロス》	名詞
＠せいどうちのぱーふぉろす	《青銅血のパーフォロス》	名詞
＠ふ	《風の英雄》	名詞
＠ふう	《風の英雄》	名詞
＠ふうの	《風の英雄》	名詞
＠ふうのえ	《風の英雄》	名詞
＠ふうのえい	《風の英雄》	名詞
＠ふうのえいゆ	《風の英雄》	名詞
＠ふうのえいゆう	《風の英雄》	名詞
＠く	《食らいつくし》	名詞
＠くら	《食らいつくし》	名詞
＠くらい	《食らいつくし》	名詞
＠くらいつ	《食らいつくし》	名詞
＠くらいつく	《食らいつくし》	名詞
＠くらいつくし	《食らいつくし》	名詞
＠そ	《騒音のアフィミア》	名詞
＠そう	《騒音のアフィミア》	名詞
＠そうお	《騒音のアフィミア》	名詞
＠そうおん	《騒音のアフィミア》	名詞
＠そうおんの	《騒音のアフィミア》	名詞
＠そうおんのあ	《騒音のアフィミア》	名詞
＠そうおんのあふ	《騒音のアフィミア》	名詞
＠そうおんのあふぃ	《騒音のアフィミア》	名詞
＠そうおんのあふぃみ	《騒音のアフィミア》	名詞
＠そうおんのあふぃみあ	《騒音のアフィミア》	名詞
＠き	《驚異の造り手、ダラコス》	名詞
＠きょ	《驚異の造り手、ダラコス》	名詞
＠きょう	《驚異の造り手、ダラコス》	名詞
＠きょうい	《驚異の造り手、ダラコス》	名詞
＠きょういの	《驚異の造り手、ダラコス》	名詞
＠きょういのつ	《驚異の造り手、ダラコス》	名詞
＠きょういのつく	《驚異の造り手、ダラコス》	名詞
＠きょういのつくり	《驚異の造り手、ダラコス》	名詞
＠きょういのつくりて	《驚異の造り手、ダラコス》	名詞
＠きょういのつくりて、	《驚異の造り手、ダラコス》	名詞
＠きょういのつくりて、だ	《驚異の造り手、ダラコス》	名詞
＠きょういのつくりて、だら	《驚異の造り手、ダラコス》	名詞
＠きょういのつくりて、だらこ	《驚異の造り手、ダラコス》	名詞
＠きょういのつくりて、だらこす	《驚異の造り手、ダラコス》	名詞
＠だ	《驚異の造り手、ダラコス》	名詞
＠だら	《驚異の造り手、ダラコス》	名詞
＠だらこ	《驚異の造り手、ダラコス》	名詞
＠だらこす	《驚異の造り手、ダラコス》	名詞
＠た	《高波の神秘家》	名詞
＠たか	《高波の神秘家》	名詞
＠たかな	《高波の神秘家》	名詞
＠たかなみ	《高波の神秘家》	名詞
＠たかなみの	《高波の神秘家》	名詞
＠たかなみのし	《高波の神秘家》	名詞
＠たかなみのしん	《高波の神秘家》	名詞
＠たかなみのしんぴ	《高波の神秘家》	名詞
＠たかなみのしんぴか	《高波の神秘家》	名詞
＠う	《鬱陶しいカモメ》	名詞
＠うっ	《鬱陶しいカモメ》	名詞
＠うっと	《鬱陶しいカモメ》	名詞
＠うっとう	《鬱陶しいカモメ》	名詞
＠うっとうし	《鬱陶しいカモメ》	名詞
＠うっとうしい	《鬱陶しいカモメ》	名詞
＠うっとうしいか	《鬱陶しいカモメ》	名詞
＠うっとうしいかも	《鬱陶しいカモメ》	名詞
＠うっとうしいかもめ	《鬱陶しいカモメ》	名詞
＠た	《魂標ランタン》	名詞
＠たま	《魂標ランタン》	名詞
＠たまし	《魂標ランタン》	名詞
＠たましい	《魂標ランタン》	名詞
＠たましいし	《魂標ランタン》	名詞
＠たましいしめ	《魂標ランタン》	名詞
＠たましいしめら	《魂標ランタン》	名詞
＠たましいしめらん	《魂標ランタン》	名詞
＠たましいしめらんた	《魂標ランタン》	名詞
＠たましいしめらんたん	《魂標ランタン》	名詞
＠み	《魅了された者、アリリオス》	名詞
＠みり	《魅了された者、アリリオス》	名詞
＠みりょ	《魅了された者、アリリオス》	名詞
＠みりょう	《魅了された者、アリリオス》	名詞
＠みりょうさ	《魅了された者、アリリオス》	名詞
＠みりょうされ	《魅了された者、アリリオス》	名詞
＠みりょうされた	《魅了された者、アリリオス》	名詞
＠みりょうされたも	《魅了された者、アリリオス》	名詞
＠みりょうされたもの	《魅了された者、アリリオス》	名詞
＠みりょうされたもの、	《魅了された者、アリリオス》	名詞
＠みりょうされたもの、あ	《魅了された者、アリリオス》	名詞
＠みりょうされたもの、あり	《魅了された者、アリリオス》	名詞
＠みりょうされたもの、ありり	《魅了された者、アリリオス》	名詞
＠みりょうされたもの、ありりお	《魅了された者、アリリオス》	名詞
＠みりょうされたもの、ありりおす	《魅了された者、アリリオス》	名詞
＠あ	《魅了された者、アリリオス》	名詞
＠あり	《魅了された者、アリリオス》	名詞
＠ありり	《魅了された者、アリリオス》	名詞
＠ありりお	《魅了された者、アリリオス》	名詞
＠ありりおす	《魅了された者、アリリオス》	名詞
＠ぎ	《魚態形成》	名詞
＠ぎょ	《魚態形成》	名詞
＠ぎょた	《魚態形成》	名詞
＠ぎょたい	《魚態形成》	名詞
＠ぎょたいけ	《魚態形成》	名詞
＠ぎょたいけい	《魚態形成》	名詞
＠ぎょたいけいせ	《魚態形成》	名詞
＠ぎょたいけいせい	《魚態形成》	名詞
