＠は	《はぐれ影魔道士、ダブリエル》	名詞
＠はぐ	《はぐれ影魔道士、ダブリエル》	名詞
＠はぐれ	《はぐれ影魔道士、ダブリエル》	名詞
＠はぐれか	《はぐれ影魔道士、ダブリエル》	名詞
＠はぐれかげ	《はぐれ影魔道士、ダブリエル》	名詞
＠はぐれかげま	《はぐれ影魔道士、ダブリエル》	名詞
＠はぐれかげまど	《はぐれ影魔道士、ダブリエル》	名詞
＠はぐれかげまどう	《はぐれ影魔道士、ダブリエル》	名詞
＠はぐれかげまどうし	《はぐれ影魔道士、ダブリエル》	名詞
＠はぐれかげまどうし、	《はぐれ影魔道士、ダブリエル》	名詞
＠はぐれかげまどうし、だ	《はぐれ影魔道士、ダブリエル》	名詞
＠はぐれかげまどうし、だぶ	《はぐれ影魔道士、ダブリエル》	名詞
＠はぐれかげまどうし、だぶり	《はぐれ影魔道士、ダブリエル》	名詞
＠はぐれかげまどうし、だぶりえ	《はぐれ影魔道士、ダブリエル》	名詞
＠はぐれかげまどうし、だぶりえる	《はぐれ影魔道士、ダブリエル》	名詞
＠あ	《アショクの潜伏者》	名詞
＠あし	《アショクの潜伏者》	名詞
＠あしょ	《アショクの潜伏者》	名詞
＠あしょく	《アショクの潜伏者》	名詞
＠あしょくの	《アショクの潜伏者》	名詞
＠あしょくのせ	《アショクの潜伏者》	名詞
＠あしょくのせん	《アショクの潜伏者》	名詞
＠あしょくのせんぷ	《アショクの潜伏者》	名詞
＠あしょくのせんぷく	《アショクの潜伏者》	名詞
＠あしょくのせんぷくし	《アショクの潜伏者》	名詞
＠あしょくのせんぷくしゃ	《アショクの潜伏者》	名詞
＠あ	《アジャニの群れ仲間》	名詞
＠あじ	《アジャニの群れ仲間》	名詞
＠あじゃ	《アジャニの群れ仲間》	名詞
＠あじゃに	《アジャニの群れ仲間》	名詞
＠あじゃにの	《アジャニの群れ仲間》	名詞
＠あじゃにのむ	《アジャニの群れ仲間》	名詞
＠あじゃにのむれ	《アジャニの群れ仲間》	名詞
＠あじゃにのむれな	《アジャニの群れ仲間》	名詞
＠あじゃにのむれなか	《アジャニの群れ仲間》	名詞
＠あじゃにのむれなかま	《アジャニの群れ仲間》	名詞
＠あ	《アングラスの暴力》	名詞
＠あん	《アングラスの暴力》	名詞
＠あんぐ	《アングラスの暴力》	名詞
＠あんぐら	《アングラスの暴力》	名詞
＠あんぐらす	《アングラスの暴力》	名詞
＠あんぐらすの	《アングラスの暴力》	名詞
＠あんぐらすのぼ	《アングラスの暴力》	名詞
＠あんぐらすのぼう	《アングラスの暴力》	名詞
＠あんぐらすのぼうり	《アングラスの暴力》	名詞
＠あんぐらすのぼうりょ	《アングラスの暴力》	名詞
＠あんぐらすのぼうりょく	《アングラスの暴力》	名詞
＠あ	《アン一門の侵略者》	名詞
＠あん	《アン一門の侵略者》	名詞
＠あんい	《アン一門の侵略者》	名詞
＠あんいち	《アン一門の侵略者》	名詞
＠あんいちも	《アン一門の侵略者》	名詞
＠あんいちもん	《アン一門の侵略者》	名詞
＠あんいちもんの	《アン一門の侵略者》	名詞
＠あんいちもんのし	《アン一門の侵略者》	名詞
＠あんいちもんのしん	《アン一門の侵略者》	名詞
＠あんいちもんのしんり	《アン一門の侵略者》	名詞
＠あんいちもんのしんりゃ	《アン一門の侵略者》	名詞
＠あんいちもんのしんりゃく	《アン一門の侵略者》	名詞
＠あんいちもんのしんりゃくし	《アン一門の侵略者》	名詞
＠あんいちもんのしんりゃくしゃ	《アン一門の侵略者》	名詞
＠あ	《アーリンの狼》	名詞
＠あー	《アーリンの狼》	名詞
＠あーり	《アーリンの狼》	名詞
＠あーりん	《アーリンの狼》	名詞
＠あーりんの	《アーリンの狼》	名詞
＠あーりんのお	《アーリンの狼》	名詞
＠あーりんのおお	《アーリンの狼》	名詞
＠あーりんのおおか	《アーリンの狼》	名詞
＠あーりんのおおかみ	《アーリンの狼》	名詞
＠う	《ウギンの召喚体》	名詞
＠うぎ	《ウギンの召喚体》	名詞
＠うぎん	《ウギンの召喚体》	名詞
＠うぎんの	《ウギンの召喚体》	名詞
＠うぎんのし	《ウギンの召喚体》	名詞
＠うぎんのしょ	《ウギンの召喚体》	名詞
＠うぎんのしょう	《ウギンの召喚体》	名詞
＠うぎんのしょうか	《ウギンの召喚体》	名詞
＠うぎんのしょうかん	《ウギンの召喚体》	名詞
＠うぎんのしょうかんか	《ウギンの召喚体》	名詞
＠うぎんのしょうかんから	《ウギンの召喚体》	名詞
＠うぎんのしょうかんからだ	《ウギンの召喚体》	名詞
＠え	《エイヴンの永遠衆》	名詞
＠えい	《エイヴンの永遠衆》	名詞
＠えいヴ	《エイヴンの永遠衆》	名詞
＠えいヴん	《エイヴンの永遠衆》	名詞
＠えいヴんの	《エイヴンの永遠衆》	名詞
＠えいヴんのえ	《エイヴンの永遠衆》	名詞
＠えいヴんのえい	《エイヴンの永遠衆》	名詞
＠えいヴんのえいえ	《エイヴンの永遠衆》	名詞
＠えいヴんのえいえん	《エイヴンの永遠衆》	名詞
＠えいヴんのえいえんし	《エイヴンの永遠衆》	名詞
＠えいヴんのえいえんしゅ	《エイヴンの永遠衆》	名詞
＠えいヴんのえいえんしゅう	《エイヴンの永遠衆》	名詞
＠お	《オブ・ニクシリスの残虐》	名詞
＠おぶ	《オブ・ニクシリスの残虐》	名詞
＠おぶ・	《オブ・ニクシリスの残虐》	名詞
＠おぶ・に	《オブ・ニクシリスの残虐》	名詞
＠おぶ・にく	《オブ・ニクシリスの残虐》	名詞
＠おぶ・にくし	《オブ・ニクシリスの残虐》	名詞
＠おぶ・にくしり	《オブ・ニクシリスの残虐》	名詞
＠おぶ・にくしりす	《オブ・ニクシリスの残虐》	名詞
＠おぶ・にくしりすの	《オブ・ニクシリスの残虐》	名詞
＠おぶ・にくしりすのざ	《オブ・ニクシリスの残虐》	名詞
＠おぶ・にくしりすのざん	《オブ・ニクシリスの残虐》	名詞
＠おぶ・にくしりすのざんぎ	《オブ・ニクシリスの残虐》	名詞
＠おぶ・にくしりすのざんぎゃ	《オブ・ニクシリスの残虐》	名詞
＠おぶ・にくしりすのざんぎゃく	《オブ・ニクシリスの残虐》	名詞
＠お	《オルゾフのギルド門》	名詞
＠おる	《オルゾフのギルド門》	名詞
＠おるぞ	《オルゾフのギルド門》	名詞
＠おるぞふ	《オルゾフのギルド門》	名詞
＠おるぞふの	《オルゾフのギルド門》	名詞
＠おるぞふのぎ	《オルゾフのギルド門》	名詞
＠おるぞふのぎる	《オルゾフのギルド門》	名詞
＠おるぞふのぎるど	《オルゾフのギルド門》	名詞
＠おるぞふのぎるども	《オルゾフのギルド門》	名詞
＠おるぞふのぎるどもん	《オルゾフのギルド門》	名詞
＠か	《カズミナの変成》	名詞
＠かず	《カズミナの変成》	名詞
＠かずみ	《カズミナの変成》	名詞
＠かずみな	《カズミナの変成》	名詞
＠かずみなの	《カズミナの変成》	名詞
＠かずみなのへ	《カズミナの変成》	名詞
＠かずみなのへん	《カズミナの変成》	名詞
＠かずみなのへんせ	《カズミナの変成》	名詞
＠かずみなのへんせい	《カズミナの変成》	名詞
＠か	《カーンの拠点》	名詞
＠かー	《カーンの拠点》	名詞
＠かーん	《カーンの拠点》	名詞
＠かーんの	《カーンの拠点》	名詞
＠かーんのき	《カーンの拠点》	名詞
＠かーんのきょ	《カーンの拠点》	名詞
＠かーんのきょて	《カーンの拠点》	名詞
＠かーんのきょてん	《カーンの拠点》	名詞
＠き	《キオーラの堰破り》	名詞
＠きお	《キオーラの堰破り》	名詞
＠きおー	《キオーラの堰破り》	名詞
＠きおーら	《キオーラの堰破り》	名詞
＠きおーらの	《キオーラの堰破り》	名詞
＠きおーらのせ	《キオーラの堰破り》	名詞
＠きおーらのせき	《キオーラの堰破り》	名詞
＠きおーらのせきや	《キオーラの堰破り》	名詞
＠きおーらのせきやぶ	《キオーラの堰破り》	名詞
＠きおーらのせきやぶり	《キオーラの堰破り》	名詞
＠ぎ	《ギデオンの中隊》	名詞
＠ぎで	《ギデオンの中隊》	名詞
＠ぎでお	《ギデオンの中隊》	名詞
＠ぎでおん	《ギデオンの中隊》	名詞
＠ぎでおんの	《ギデオンの中隊》	名詞
＠ぎでおんのち	《ギデオンの中隊》	名詞
＠ぎでおんのちゅ	《ギデオンの中隊》	名詞
＠ぎでおんのちゅう	《ギデオンの中隊》	名詞
＠ぎでおんのちゅうた	《ギデオンの中隊》	名詞
＠ぎでおんのちゅうたい	《ギデオンの中隊》	名詞
＠ぎ	《ギデオンの勝利》	名詞
＠ぎで	《ギデオンの勝利》	名詞
＠ぎでお	《ギデオンの勝利》	名詞
＠ぎでおん	《ギデオンの勝利》	名詞
＠ぎでおんの	《ギデオンの勝利》	名詞
＠ぎでおんのし	《ギデオンの勝利》	名詞
＠ぎでおんのしょ	《ギデオンの勝利》	名詞
＠ぎでおんのしょう	《ギデオンの勝利》	名詞
＠ぎでおんのしょうり	《ギデオンの勝利》	名詞
＠ぎ	《ギデオンの喊声》	名詞
＠ぎで	《ギデオンの喊声》	名詞
＠ぎでお	《ギデオンの喊声》	名詞
＠ぎでおん	《ギデオンの喊声》	名詞
＠ぎでおんの	《ギデオンの喊声》	名詞
＠ぎでおんのか	《ギデオンの喊声》	名詞
＠ぎでおんのかん	《ギデオンの喊声》	名詞
＠ぎでおんのかんせ	《ギデオンの喊声》	名詞
＠ぎでおんのかんせい	《ギデオンの喊声》	名詞
＠ぎ	《ギデオンの犠牲》	名詞
＠ぎで	《ギデオンの犠牲》	名詞
＠ぎでお	《ギデオンの犠牲》	名詞
＠ぎでおん	《ギデオンの犠牲》	名詞
＠ぎでおんの	《ギデオンの犠牲》	名詞
＠ぎでおんのぎ	《ギデオンの犠牲》	名詞
＠ぎでおんのぎせ	《ギデオンの犠牲》	名詞
＠ぎでおんのぎせい	《ギデオンの犠牲》	名詞
＠ぎ	《ギルドパクトの密通者》	名詞
＠ぎる	《ギルドパクトの密通者》	名詞
＠ぎるど	《ギルドパクトの密通者》	名詞
＠ぎるどぱ	《ギルドパクトの密通者》	名詞
＠ぎるどぱく	《ギルドパクトの密通者》	名詞
＠ぎるどぱくと	《ギルドパクトの密通者》	名詞
＠ぎるどぱくとの	《ギルドパクトの密通者》	名詞
＠ぎるどぱくとのみ	《ギルドパクトの密通者》	名詞
＠ぎるどぱくとのみつ	《ギルドパクトの密通者》	名詞
＠ぎるどぱくとのみつと	《ギルドパクトの密通者》	名詞
＠ぎるどぱくとのみつとお	《ギルドパクトの密通者》	名詞
＠ぎるどぱくとのみつとおり	《ギルドパクトの密通者》	名詞
＠ぎるどぱくとのみつとおりも	《ギルドパクトの密通者》	名詞
＠ぎるどぱくとのみつとおりもの	《ギルドパクトの密通者》	名詞
＠ぎ	《ギルド球》	名詞
＠ぎる	《ギルド球》	名詞
＠ぎるど	《ギルド球》	名詞
＠ぎるどた	《ギルド球》	名詞
＠ぎるどたま	《ギルド球》	名詞
＠ぎ	《ギルド門通りの公有地》	名詞
＠ぎる	《ギルド門通りの公有地》	名詞
＠ぎるど	《ギルド門通りの公有地》	名詞
＠ぎるども	《ギルド門通りの公有地》	名詞
＠ぎるどもん	《ギルド門通りの公有地》	名詞
＠ぎるどもんど	《ギルド門通りの公有地》	名詞
＠ぎるどもんどお	《ギルド門通りの公有地》	名詞
＠ぎるどもんどおり	《ギルド門通りの公有地》	名詞
＠ぎるどもんどおりの	《ギルド門通りの公有地》	名詞
＠ぎるどもんどおりのこ	《ギルド門通りの公有地》	名詞
＠ぎるどもんどおりのこう	《ギルド門通りの公有地》	名詞
＠ぎるどもんどおりのこうゆ	《ギルド門通りの公有地》	名詞
＠ぎるどもんどおりのこうゆう	《ギルド門通りの公有地》	名詞
＠ぎるどもんどおりのこうゆうち	《ギルド門通りの公有地》	名詞
＠く	《クロンチの世話人》	名詞
＠くろ	《クロンチの世話人》	名詞
＠くろん	《クロンチの世話人》	名詞
＠くろんち	《クロンチの世話人》	名詞
＠くろんちの	《クロンチの世話人》	名詞
＠くろんちのせ	《クロンチの世話人》	名詞
＠くろんちのせわ	《クロンチの世話人》	名詞
＠くろんちのせわに	《クロンチの世話人》	名詞
＠くろんちのせわにん	《クロンチの世話人》	名詞
＠く	《クロールのとげ刺し》	名詞
＠くろ	《クロールのとげ刺し》	名詞
＠くろー	《クロールのとげ刺し》	名詞
＠くろーる	《クロールのとげ刺し》	名詞
＠くろーるの	《クロールのとげ刺し》	名詞
＠くろーるのと	《クロールのとげ刺し》	名詞
＠くろーるのとげ	《クロールのとげ刺し》	名詞
＠くろーるのとげさ	《クロールのとげ刺し》	名詞
＠くろーるのとげさし	《クロールのとげ刺し》	名詞
＠け	《ケイヤの誓い》	名詞
＠けい	《ケイヤの誓い》	名詞
＠けいや	《ケイヤの誓い》	名詞
＠けいやの	《ケイヤの誓い》	名詞
＠けいやのち	《ケイヤの誓い》	名詞
＠けいやのちか	《ケイヤの誓い》	名詞
＠けいやのちかい	《ケイヤの誓い》	名詞
＠け	《ケイヤ式幽体化》	名詞
＠けい	《ケイヤ式幽体化》	名詞
＠けいや	《ケイヤ式幽体化》	名詞
＠けいやし	《ケイヤ式幽体化》	名詞
＠けいやしき	《ケイヤ式幽体化》	名詞
＠けいやしきゆ	《ケイヤ式幽体化》	名詞
＠けいやしきゆう	《ケイヤ式幽体化》	名詞
＠けいやしきゆうた	《ケイヤ式幽体化》	名詞
＠けいやしきゆうたい	《ケイヤ式幽体化》	名詞
＠けいやしきゆうたいか	《ケイヤ式幽体化》	名詞
＠け	《ケンタウルスの養育者》	名詞
＠けん	《ケンタウルスの養育者》	名詞
＠けんた	《ケンタウルスの養育者》	名詞
＠けんたう	《ケンタウルスの養育者》	名詞
＠けんたうる	《ケンタウルスの養育者》	名詞
＠けんたうるす	《ケンタウルスの養育者》	名詞
＠けんたうるすの	《ケンタウルスの養育者》	名詞
＠けんたうるすのよ	《ケンタウルスの養育者》	名詞
＠けんたうるすのよう	《ケンタウルスの養育者》	名詞
＠けんたうるすのようい	《ケンタウルスの養育者》	名詞
＠けんたうるすのよういく	《ケンタウルスの養育者》	名詞
＠けんたうるすのよういくし	《ケンタウルスの養育者》	名詞
＠けんたうるすのよういくしゃ	《ケンタウルスの養育者》	名詞
＠ご	《ゴブリンの突撃隊》	名詞
＠ごぶ	《ゴブリンの突撃隊》	名詞
＠ごぶり	《ゴブリンの突撃隊》	名詞
＠ごぶりん	《ゴブリンの突撃隊》	名詞
＠ごぶりんの	《ゴブリンの突撃隊》	名詞
＠ごぶりんのと	《ゴブリンの突撃隊》	名詞
＠ごぶりんのとつ	《ゴブリンの突撃隊》	名詞
＠ごぶりんのとつげ	《ゴブリンの突撃隊》	名詞
＠ごぶりんのとつげき	《ゴブリンの突撃隊》	名詞
＠ごぶりんのとつげきた	《ゴブリンの突撃隊》	名詞
＠ごぶりんのとつげきたい	《ゴブリンの突撃隊》	名詞
＠ご	《ゴブリンの通り魔》	名詞
＠ごぶ	《ゴブリンの通り魔》	名詞
＠ごぶり	《ゴブリンの通り魔》	名詞
＠ごぶりん	《ゴブリンの通り魔》	名詞
＠ごぶりんの	《ゴブリンの通り魔》	名詞
＠ごぶりんのと	《ゴブリンの通り魔》	名詞
＠ごぶりんのとお	《ゴブリンの通り魔》	名詞
＠ごぶりんのとおり	《ゴブリンの通り魔》	名詞
＠ごぶりんのとおりま	《ゴブリンの通り魔》	名詞
＠さ	《サイクロプスの電術師》	名詞
＠さい	《サイクロプスの電術師》	名詞
＠さいく	《サイクロプスの電術師》	名詞
＠さいくろ	《サイクロプスの電術師》	名詞
＠さいくろぷ	《サイクロプスの電術師》	名詞
＠さいくろぷす	《サイクロプスの電術師》	名詞
＠さいくろぷすの	《サイクロプスの電術師》	名詞
＠さいくろぷすので	《サイクロプスの電術師》	名詞
＠さいくろぷすのでん	《サイクロプスの電術師》	名詞
＠さいくろぷすのでんや	《サイクロプスの電術師》	名詞
＠さいくろぷすのでんやす	《サイクロプスの電術師》	名詞
＠さいくろぷすのでんやすし	《サイクロプスの電術師》	名詞
＠さいくろぷすのでんやすしし	《サイクロプスの電術師》	名詞
＠さ	《サヒーリの銀翼》	名詞
＠さひ	《サヒーリの銀翼》	名詞
＠さひー	《サヒーリの銀翼》	名詞
＠さひーり	《サヒーリの銀翼》	名詞
＠さひーりの	《サヒーリの銀翼》	名詞
＠さひーりのぎ	《サヒーリの銀翼》	名詞
＠さひーりのぎん	《サヒーリの銀翼》	名詞
＠さひーりのぎんよ	《サヒーリの銀翼》	名詞
＠さひーりのぎんよく	《サヒーリの銀翼》	名詞
＠さ	《サムトの疾走》	名詞
＠さむ	《サムトの疾走》	名詞
＠さむと	《サムトの疾走》	名詞
＠さむとの	《サムトの疾走》	名詞
＠さむとのし	《サムトの疾走》	名詞
＠さむとのしっ	《サムトの疾走》	名詞
＠さむとのしっそ	《サムトの疾走》	名詞
＠さむとのしっそう	《サムトの疾走》	名詞
＠さ	《サルカンの浄化》	名詞
＠さる	《サルカンの浄化》	名詞
＠さるか	《サルカンの浄化》	名詞
＠さるかん	《サルカンの浄化》	名詞
＠さるかんの	《サルカンの浄化》	名詞
＠さるかんのじ	《サルカンの浄化》	名詞
＠さるかんのじょ	《サルカンの浄化》	名詞
＠さるかんのじょう	《サルカンの浄化》	名詞
＠さるかんのじょうか	《サルカンの浄化》	名詞
＠し	《シミックのギルド門》	名詞
＠しみ	《シミックのギルド門》	名詞
＠しみっ	《シミックのギルド門》	名詞
＠しみっく	《シミックのギルド門》	名詞
＠しみっくの	《シミックのギルド門》	名詞
＠しみっくのぎ	《シミックのギルド門》	名詞
＠しみっくのぎる	《シミックのギルド門》	名詞
＠しみっくのぎるど	《シミックのギルド門》	名詞
＠しみっくのぎるども	《シミックのギルド門》	名詞
＠しみっくのぎるどもん	《シミックのギルド門》	名詞
＠じ	《ジェイスの勝利》	名詞
＠じぇ	《ジェイスの勝利》	名詞
＠じぇい	《ジェイスの勝利》	名詞
＠じぇいす	《ジェイスの勝利》	名詞
＠じぇいすの	《ジェイスの勝利》	名詞
＠じぇいすのし	《ジェイスの勝利》	名詞
＠じぇいすのしょ	《ジェイスの勝利》	名詞
＠じぇいすのしょう	《ジェイスの勝利》	名詞
＠じぇいすのしょうり	《ジェイスの勝利》	名詞
＠じ	《ジェイスの投影》	名詞
＠じぇ	《ジェイスの投影》	名詞
＠じぇい	《ジェイスの投影》	名詞
＠じぇいす	《ジェイスの投影》	名詞
＠じぇいすの	《ジェイスの投影》	名詞
＠じぇいすのと	《ジェイスの投影》	名詞
＠じぇいすのとう	《ジェイスの投影》	名詞
＠じぇいすのとうえ	《ジェイスの投影》	名詞
＠じぇいすのとうえい	《ジェイスの投影》	名詞
＠じ	《ジェイスの策略》	名詞
＠じぇ	《ジェイスの策略》	名詞
＠じぇい	《ジェイスの策略》	名詞
＠じぇいす	《ジェイスの策略》	名詞
＠じぇいすの	《ジェイスの策略》	名詞
＠じぇいすのさ	《ジェイスの策略》	名詞
＠じぇいすのさく	《ジェイスの策略》	名詞
＠じぇいすのさくり	《ジェイスの策略》	名詞
＠じぇいすのさくりゃ	《ジェイスの策略》	名詞
＠じぇいすのさくりゃく	《ジェイスの策略》	名詞
＠そ	《ソリンの渇き》	名詞
＠そり	《ソリンの渇き》	名詞
＠そりん	《ソリンの渇き》	名詞
＠そりんの	《ソリンの渇き》	名詞
＠そりんのか	《ソリンの渇き》	名詞
＠そりんのかわ	《ソリンの渇き》	名詞
＠そりんのかわき	《ソリンの渇き》	名詞
＠た	《タミヨウの天啓》	名詞
＠たみ	《タミヨウの天啓》	名詞
＠たみよ	《タミヨウの天啓》	名詞
＠たみよう	《タミヨウの天啓》	名詞
＠たみようの	《タミヨウの天啓》	名詞
＠たみようのて	《タミヨウの天啓》	名詞
＠たみようのてん	《タミヨウの天啓》	名詞
＠たみようのてんけ	《タミヨウの天啓》	名詞
＠たみようのてんけい	《タミヨウの天啓》	名詞
＠だ	《ダスクマントルの調査員》	名詞
＠だす	《ダスクマントルの調査員》	名詞
＠だすく	《ダスクマントルの調査員》	名詞
＠だすくま	《ダスクマントルの調査員》	名詞
＠だすくまん	《ダスクマントルの調査員》	名詞
＠だすくまんと	《ダスクマントルの調査員》	名詞
＠だすくまんとる	《ダスクマントルの調査員》	名詞
＠だすくまんとるの	《ダスクマントルの調査員》	名詞
＠だすくまんとるのち	《ダスクマントルの調査員》	名詞
＠だすくまんとるのちょ	《ダスクマントルの調査員》	名詞
＠だすくまんとるのちょう	《ダスクマントルの調査員》	名詞
＠だすくまんとるのちょうさ	《ダスクマントルの調査員》	名詞
＠だすくまんとるのちょうさい	《ダスクマントルの調査員》	名詞
＠だすくまんとるのちょうさいん	《ダスクマントルの調査員》	名詞
＠だ	《ダブリエルの影忘》	名詞
＠だぶ	《ダブリエルの影忘》	名詞
＠だぶり	《ダブリエルの影忘》	名詞
＠だぶりえ	《ダブリエルの影忘》	名詞
＠だぶりえる	《ダブリエルの影忘》	名詞
＠だぶりえるの	《ダブリエルの影忘》	名詞
＠だぶりえるのか	《ダブリエルの影忘》	名詞
＠だぶりえるのかげ	《ダブリエルの影忘》	名詞
＠だぶりえるのかげわ	《ダブリエルの影忘》	名詞
＠だぶりえるのかげわす	《ダブリエルの影忘》	名詞
＠だぶりえるのかげわすれ	《ダブリエルの影忘》	名詞
＠ち	《チャンドラの勝利》	名詞
＠ちゃ	《チャンドラの勝利》	名詞
＠ちゃん	《チャンドラの勝利》	名詞
＠ちゃんど	《チャンドラの勝利》	名詞
＠ちゃんどら	《チャンドラの勝利》	名詞
＠ちゃんどらの	《チャンドラの勝利》	名詞
＠ちゃんどらのし	《チャンドラの勝利》	名詞
＠ちゃんどらのしょ	《チャンドラの勝利》	名詞
＠ちゃんどらのしょう	《チャンドラの勝利》	名詞
＠ちゃんどらのしょうり	《チャンドラの勝利》	名詞
＠ち	《チャンドラの螺旋炎》	名詞
＠ちゃ	《チャンドラの螺旋炎》	名詞
＠ちゃん	《チャンドラの螺旋炎》	名詞
＠ちゃんど	《チャンドラの螺旋炎》	名詞
＠ちゃんどら	《チャンドラの螺旋炎》	名詞
＠ちゃんどらの	《チャンドラの螺旋炎》	名詞
＠ちゃんどらのら	《チャンドラの螺旋炎》	名詞
＠ちゃんどらのらせ	《チャンドラの螺旋炎》	名詞
＠ちゃんどらのらせん	《チャンドラの螺旋炎》	名詞
＠ちゃんどらのらせんえ	《チャンドラの螺旋炎》	名詞
＠ちゃんどらのらせんえん	《チャンドラの螺旋炎》	名詞
＠て	《ティボルトの憤怒鬼》	名詞
＠てぃ	《ティボルトの憤怒鬼》	名詞
＠てぃぼ	《ティボルトの憤怒鬼》	名詞
＠てぃぼる	《ティボルトの憤怒鬼》	名詞
＠てぃぼると	《ティボルトの憤怒鬼》	名詞
＠てぃぼるとの	《ティボルトの憤怒鬼》	名詞
＠てぃぼるとのふ	《ティボルトの憤怒鬼》	名詞
＠てぃぼるとのふん	《ティボルトの憤怒鬼》	名詞
＠てぃぼるとのふんぬ	《ティボルトの憤怒鬼》	名詞
＠てぃぼるとのふんぬき	《ティボルトの憤怒鬼》	名詞
＠て	《テフェリーの時間改変》	名詞
＠てふ	《テフェリーの時間改変》	名詞
＠てふぇ	《テフェリーの時間改変》	名詞
＠てふぇり	《テフェリーの時間改変》	名詞
＠てふぇりー	《テフェリーの時間改変》	名詞
＠てふぇりーの	《テフェリーの時間改変》	名詞
＠てふぇりーのじ	《テフェリーの時間改変》	名詞
＠てふぇりーのじか	《テフェリーの時間改変》	名詞
＠てふぇりーのじかん	《テフェリーの時間改変》	名詞
＠てふぇりーのじかんか	《テフェリーの時間改変》	名詞
＠てふぇりーのじかんかい	《テフェリーの時間改変》	名詞
＠てふぇりーのじかんかいへ	《テフェリーの時間改変》	名詞
＠てふぇりーのじかんかいへん	《テフェリーの時間改変》	名詞
＠て	《テヨの光盾》	名詞
＠てよ	《テヨの光盾》	名詞
＠てよの	《テヨの光盾》	名詞
＠てよのひ	《テヨの光盾》	名詞
＠てよのひか	《テヨの光盾》	名詞
＠てよのひかり	《テヨの光盾》	名詞
＠てよのひかりだ	《テヨの光盾》	名詞
＠てよのひかりだて	《テヨの光盾》	名詞
＠で	《デヴカリンのリッチ、ストーレフ》	名詞
＠でヴ	《デヴカリンのリッチ、ストーレフ》	名詞
＠でヴか	《デヴカリンのリッチ、ストーレフ》	名詞
＠でヴかり	《デヴカリンのリッチ、ストーレフ》	名詞
＠でヴかりん	《デヴカリンのリッチ、ストーレフ》	名詞
＠でヴかりんの	《デヴカリンのリッチ、ストーレフ》	名詞
＠でヴかりんのり	《デヴカリンのリッチ、ストーレフ》	名詞
＠でヴかりんのりっ	《デヴカリンのリッチ、ストーレフ》	名詞
＠でヴかりんのりっち	《デヴカリンのリッチ、ストーレフ》	名詞
＠でヴかりんのりっち、	《デヴカリンのリッチ、ストーレフ》	名詞
＠でヴかりんのりっち、す	《デヴカリンのリッチ、ストーレフ》	名詞
＠でヴかりんのりっち、すと	《デヴカリンのリッチ、ストーレフ》	名詞
＠でヴかりんのりっち、すとー	《デヴカリンのリッチ、ストーレフ》	名詞
＠でヴかりんのりっち、すとーれ	《デヴカリンのリッチ、ストーレフ》	名詞
＠でヴかりんのりっち、すとーれふ	《デヴカリンのリッチ、ストーレフ》	名詞
＠ど	《ドビンの拒否権》	名詞
＠どび	《ドビンの拒否権》	名詞
＠どびん	《ドビンの拒否権》	名詞
＠どびんの	《ドビンの拒否権》	名詞
＠どびんのき	《ドビンの拒否権》	名詞
＠どびんのきょ	《ドビンの拒否権》	名詞
＠どびんのきょひ	《ドビンの拒否権》	名詞
＠どびんのきょひけ	《ドビンの拒否権》	名詞
＠どびんのきょひけん	《ドビンの拒否権》	名詞
＠ど	《ドムリの待ち伏せ》	名詞
＠どむ	《ドムリの待ち伏せ》	名詞
＠どむり	《ドムリの待ち伏せ》	名詞
＠どむりの	《ドムリの待ち伏せ》	名詞
＠どむりのま	《ドムリの待ち伏せ》	名詞
＠どむりのまち	《ドムリの待ち伏せ》	名詞
＠どむりのまちぶ	《ドムリの待ち伏せ》	名詞
＠どむりのまちぶせ	《ドムリの待ち伏せ》	名詞
＠な	《ナヒリの石刃》	名詞
＠なひ	《ナヒリの石刃》	名詞
＠なひり	《ナヒリの石刃》	名詞
＠なひりの	《ナヒリの石刃》	名詞
＠なひりのせ	《ナヒリの石刃》	名詞
＠なひりのせき	《ナヒリの石刃》	名詞
＠なひりのせきじ	《ナヒリの石刃》	名詞
＠なひりのせきじん	《ナヒリの石刃》	名詞
＠な	《ナーガの永遠衆》	名詞
＠なー	《ナーガの永遠衆》	名詞
＠なーが	《ナーガの永遠衆》	名詞
＠なーがの	《ナーガの永遠衆》	名詞
＠なーがのえ	《ナーガの永遠衆》	名詞
＠なーがのえい	《ナーガの永遠衆》	名詞
＠なーがのえいえ	《ナーガの永遠衆》	名詞
＠なーがのえいえん	《ナーガの永遠衆》	名詞
＠なーがのえいえんし	《ナーガの永遠衆》	名詞
＠なーがのえいえんしゅ	《ナーガの永遠衆》	名詞
＠なーがのえいえんしゅう	《ナーガの永遠衆》	名詞
＠な	《ナーセットの逆転》	名詞
＠なー	《ナーセットの逆転》	名詞
＠なーせ	《ナーセットの逆転》	名詞
＠なーせっ	《ナーセットの逆転》	名詞
＠なーせっと	《ナーセットの逆転》	名詞
＠なーせっとの	《ナーセットの逆転》	名詞
＠なーせっとのぎ	《ナーセットの逆転》	名詞
＠なーせっとのぎゃ	《ナーセットの逆転》	名詞
＠なーせっとのぎゃく	《ナーセットの逆転》	名詞
＠なーせっとのぎゃくて	《ナーセットの逆転》	名詞
＠なーせっとのぎゃくてん	《ナーセットの逆転》	名詞
＠に	《ニッサの勝利》	名詞
＠にっ	《ニッサの勝利》	名詞
＠にっさ	《ニッサの勝利》	名詞
＠にっさの	《ニッサの勝利》	名詞
＠にっさのし	《ニッサの勝利》	名詞
＠にっさのしょ	《ニッサの勝利》	名詞
＠にっさのしょう	《ニッサの勝利》	名詞
＠にっさのしょうり	《ニッサの勝利》	名詞
＠に	《ニヴ＝ミゼット再誕》	名詞
＠にヴ	《ニヴ＝ミゼット再誕》	名詞
＠にヴ＝	《ニヴ＝ミゼット再誕》	名詞
＠にヴ＝み	《ニヴ＝ミゼット再誕》	名詞
＠にヴ＝みぜ	《ニヴ＝ミゼット再誕》	名詞
＠にヴ＝みぜっ	《ニヴ＝ミゼット再誕》	名詞
＠にヴ＝みぜっと	《ニヴ＝ミゼット再誕》	名詞
＠にヴ＝みぜっとさ	《ニヴ＝ミゼット再誕》	名詞
＠にヴ＝みぜっとさい	《ニヴ＝ミゼット再誕》	名詞
＠にヴ＝みぜっとさいた	《ニヴ＝ミゼット再誕》	名詞
＠にヴ＝みぜっとさいたん	《ニヴ＝ミゼット再誕》	名詞
＠ぱ	《パルヘリオンⅡ》	名詞
＠ぱる	《パルヘリオンⅡ》	名詞
＠ぱるへ	《パルヘリオンⅡ》	名詞
＠ぱるへり	《パルヘリオンⅡ》	名詞
＠ぱるへりお	《パルヘリオンⅡ》	名詞
＠ぱるへりおん	《パルヘリオンⅡ》	名詞
＠ぱるへりおんⅡ	《パルヘリオンⅡ》	名詞
＠び	《ビヒモスを招く者、キオーラ》	名詞
＠びひ	《ビヒモスを招く者、キオーラ》	名詞
＠びひも	《ビヒモスを招く者、キオーラ》	名詞
＠びひもす	《ビヒモスを招く者、キオーラ》	名詞
＠びひもすを	《ビヒモスを招く者、キオーラ》	名詞
＠びひもすをま	《ビヒモスを招く者、キオーラ》	名詞
＠びひもすをまね	《ビヒモスを招く者、キオーラ》	名詞
＠びひもすをまねく	《ビヒモスを招く者、キオーラ》	名詞
＠びひもすをまねくも	《ビヒモスを招く者、キオーラ》	名詞
＠びひもすをまねくもの	《ビヒモスを招く者、キオーラ》	名詞
＠びひもすをまねくもの、	《ビヒモスを招く者、キオーラ》	名詞
＠びひもすをまねくもの、き	《ビヒモスを招く者、キオーラ》	名詞
＠びひもすをまねくもの、きお	《ビヒモスを招く者、キオーラ》	名詞
＠びひもすをまねくもの、きおー	《ビヒモスを招く者、キオーラ》	名詞
＠びひもすをまねくもの、きおーら	《ビヒモスを招く者、キオーラ》	名詞
＠び	《ビビアンのアーク弓》	名詞
＠びび	《ビビアンのアーク弓》	名詞
＠びびあ	《ビビアンのアーク弓》	名詞
＠びびあん	《ビビアンのアーク弓》	名詞
＠びびあんの	《ビビアンのアーク弓》	名詞
＠びびあんのあ	《ビビアンのアーク弓》	名詞
＠びびあんのあー	《ビビアンのアーク弓》	名詞
＠びびあんのあーく	《ビビアンのアーク弓》	名詞
＠びびあんのあーくゆ	《ビビアンのアーク弓》	名詞
＠びびあんのあーくゆみ	《ビビアンのアーク弓》	名詞
＠び	《ビビアンの灰色熊》	名詞
＠びび	《ビビアンの灰色熊》	名詞
＠びびあ	《ビビアンの灰色熊》	名詞
＠びびあん	《ビビアンの灰色熊》	名詞
＠びびあんの	《ビビアンの灰色熊》	名詞
＠びびあんのは	《ビビアンの灰色熊》	名詞
＠びびあんのはい	《ビビアンの灰色熊》	名詞
＠びびあんのはいい	《ビビアンの灰色熊》	名詞
＠びびあんのはいいろ	《ビビアンの灰色熊》	名詞
＠びびあんのはいいろぐ	《ビビアンの灰色熊》	名詞
＠びびあんのはいいろぐま	《ビビアンの灰色熊》	名詞
＠ふ	《ファートリの猛竜》	名詞
＠ふぁ	《ファートリの猛竜》	名詞
＠ふぁー	《ファートリの猛竜》	名詞
＠ふぁーと	《ファートリの猛竜》	名詞
＠ふぁーとり	《ファートリの猛竜》	名詞
＠ふぁーとりの	《ファートリの猛竜》	名詞
＠ふぁーとりのた	《ファートリの猛竜》	名詞
＠ふぁーとりのたけ	《ファートリの猛竜》	名詞
＠ふぁーとりのたけし	《ファートリの猛竜》	名詞
＠ふぁーとりのたけしり	《ファートリの猛竜》	名詞
＠ふぁーとりのたけしりゅ	《ファートリの猛竜》	名詞
＠ふぁーとりのたけしりゅう	《ファートリの猛竜》	名詞
＠ぶ	《ブリキ通りの重鎮、クレンコ》	名詞
＠ぶり	《ブリキ通りの重鎮、クレンコ》	名詞
＠ぶりき	《ブリキ通りの重鎮、クレンコ》	名詞
＠ぶりきど	《ブリキ通りの重鎮、クレンコ》	名詞
＠ぶりきどお	《ブリキ通りの重鎮、クレンコ》	名詞
＠ぶりきどおり	《ブリキ通りの重鎮、クレンコ》	名詞
＠ぶりきどおりの	《ブリキ通りの重鎮、クレンコ》	名詞
＠ぶりきどおりのじ	《ブリキ通りの重鎮、クレンコ》	名詞
＠ぶりきどおりのじゅ	《ブリキ通りの重鎮、クレンコ》	名詞
＠ぶりきどおりのじゅう	《ブリキ通りの重鎮、クレンコ》	名詞
＠ぶりきどおりのじゅうち	《ブリキ通りの重鎮、クレンコ》	名詞
＠ぶりきどおりのじゅうちん	《ブリキ通りの重鎮、クレンコ》	名詞
＠ぶりきどおりのじゅうちん、	《ブリキ通りの重鎮、クレンコ》	名詞
＠ぶりきどおりのじゅうちん、く	《ブリキ通りの重鎮、クレンコ》	名詞
＠ぶりきどおりのじゅうちん、くれ	《ブリキ通りの重鎮、クレンコ》	名詞
＠ぶりきどおりのじゅうちん、くれん	《ブリキ通りの重鎮、クレンコ》	名詞
＠ぶりきどおりのじゅうちん、くれんこ	《ブリキ通りの重鎮、クレンコ》	名詞
＠ぷ	《プリズマイト》	名詞
＠ぷり	《プリズマイト》	名詞
＠ぷりず	《プリズマイト》	名詞
＠ぷりずま	《プリズマイト》	名詞
＠ぷりずまい	《プリズマイト》	名詞
＠ぷりずまいと	《プリズマイト》	名詞
＠ぼ	《ボーラスの占い師》	名詞
＠ぼー	《ボーラスの占い師》	名詞
＠ぼーら	《ボーラスの占い師》	名詞
＠ぼーらす	《ボーラスの占い師》	名詞
＠ぼーらすの	《ボーラスの占い師》	名詞
＠ぼーらすのう	《ボーラスの占い師》	名詞
＠ぼーらすのうら	《ボーラスの占い師》	名詞
＠ぼーらすのうらな	《ボーラスの占い師》	名詞
＠ぼーらすのうらない	《ボーラスの占い師》	名詞
＠ぼーらすのうらないし	《ボーラスの占い師》	名詞
＠ぼ	《ボーラスの城塞》	名詞
＠ぼー	《ボーラスの城塞》	名詞
＠ぼーら	《ボーラスの城塞》	名詞
＠ぼーらす	《ボーラスの城塞》	名詞
＠ぼーらすの	《ボーラスの城塞》	名詞
＠ぼーらすのじ	《ボーラスの城塞》	名詞
＠ぼーらすのじょ	《ボーラスの城塞》	名詞
＠ぼーらすのじょう	《ボーラスの城塞》	名詞
＠ぼーらすのじょうさ	《ボーラスの城塞》	名詞
＠ぼーらすのじょうさい	《ボーラスの城塞》	名詞
＠ぼ	《ボーラスの壊乱者、ドムリ》	名詞
＠ぼー	《ボーラスの壊乱者、ドムリ》	名詞
＠ぼーら	《ボーラスの壊乱者、ドムリ》	名詞
＠ぼーらす	《ボーラスの壊乱者、ドムリ》	名詞
＠ぼーらすの	《ボーラスの壊乱者、ドムリ》	名詞
＠ぼーらすのか	《ボーラスの壊乱者、ドムリ》	名詞
＠ぼーらすのかい	《ボーラスの壊乱者、ドムリ》	名詞
＠ぼーらすのかいら	《ボーラスの壊乱者、ドムリ》	名詞
＠ぼーらすのかいらん	《ボーラスの壊乱者、ドムリ》	名詞
＠ぼーらすのかいらんし	《ボーラスの壊乱者、ドムリ》	名詞
＠ぼーらすのかいらんしゃ	《ボーラスの壊乱者、ドムリ》	名詞
＠ぼーらすのかいらんしゃ、	《ボーラスの壊乱者、ドムリ》	名詞
＠ぼーらすのかいらんしゃ、ど	《ボーラスの壊乱者、ドムリ》	名詞
＠ぼーらすのかいらんしゃ、どむ	《ボーラスの壊乱者、ドムリ》	名詞
＠ぼーらすのかいらんしゃ、どむり	《ボーラスの壊乱者、ドムリ》	名詞
＠ま	《マナ晶洞石》	名詞
＠まな	《マナ晶洞石》	名詞
＠まなし	《マナ晶洞石》	名詞
＠まなしょ	《マナ晶洞石》	名詞
＠まなしょう	《マナ晶洞石》	名詞
＠まなしょうど	《マナ晶洞石》	名詞
＠まなしょうどう	《マナ晶洞石》	名詞
＠まなしょうどうい	《マナ晶洞石》	名詞
＠まなしょうどういし	《マナ晶洞石》	名詞
＠ま	《マーフォークのスカイダイバー》	名詞
＠まー	《マーフォークのスカイダイバー》	名詞
＠まーふ	《マーフォークのスカイダイバー》	名詞
＠まーふぉ	《マーフォークのスカイダイバー》	名詞
＠まーふぉー	《マーフォークのスカイダイバー》	名詞
＠まーふぉーく	《マーフォークのスカイダイバー》	名詞
＠まーふぉーくの	《マーフォークのスカイダイバー》	名詞
＠まーふぉーくのす	《マーフォークのスカイダイバー》	名詞
＠まーふぉーくのすか	《マーフォークのスカイダイバー》	名詞
＠まーふぉーくのすかい	《マーフォークのスカイダイバー》	名詞
＠まーふぉーくのすかいだ	《マーフォークのスカイダイバー》	名詞
＠まーふぉーくのすかいだい	《マーフォークのスカイダイバー》	名詞
＠まーふぉーくのすかいだいば	《マーフォークのスカイダイバー》	名詞
＠まーふぉーくのすかいだいばー	《マーフォークのスカイダイバー》	名詞
＠み	《ミジウムの戦車》	名詞
＠みじ	《ミジウムの戦車》	名詞
＠みじう	《ミジウムの戦車》	名詞
＠みじうむ	《ミジウムの戦車》	名詞
＠みじうむの	《ミジウムの戦車》	名詞
＠みじうむのせ	《ミジウムの戦車》	名詞
＠みじうむのせん	《ミジウムの戦車》	名詞
＠みじうむのせんし	《ミジウムの戦車》	名詞
＠みじうむのせんしゃ	《ミジウムの戦車》	名詞
＠や	《ヤヤの挨拶》	名詞
＠やや	《ヤヤの挨拶》	名詞
＠ややの	《ヤヤの挨拶》	名詞
＠ややのあ	《ヤヤの挨拶》	名詞
＠ややのあい	《ヤヤの挨拶》	名詞
＠ややのあいさ	《ヤヤの挨拶》	名詞
＠ややのあいさつ	《ヤヤの挨拶》	名詞
＠ら	《ラゾテプのビヒモス》	名詞
＠らぞ	《ラゾテプのビヒモス》	名詞
＠らぞて	《ラゾテプのビヒモス》	名詞
＠らぞてぷ	《ラゾテプのビヒモス》	名詞
＠らぞてぷの	《ラゾテプのビヒモス》	名詞
＠らぞてぷのび	《ラゾテプのビヒモス》	名詞
＠らぞてぷのびひ	《ラゾテプのビヒモス》	名詞
＠らぞてぷのびひも	《ラゾテプのビヒモス》	名詞
＠らぞてぷのびひもす	《ラゾテプのビヒモス》	名詞
＠ら	《ラゾテプの板金》	名詞
＠らぞ	《ラゾテプの板金》	名詞
＠らぞて	《ラゾテプの板金》	名詞
＠らぞてぷ	《ラゾテプの板金》	名詞
＠らぞてぷの	《ラゾテプの板金》	名詞
＠らぞてぷのば	《ラゾテプの板金》	名詞
＠らぞてぷのばん	《ラゾテプの板金》	名詞
＠らぞてぷのばんき	《ラゾテプの板金》	名詞
＠らぞてぷのばんきん	《ラゾテプの板金》	名詞
＠ら	《ラゾテプの肉裂き》	名詞
＠らぞ	《ラゾテプの肉裂き》	名詞
＠らぞて	《ラゾテプの肉裂き》	名詞
＠らぞてぷ	《ラゾテプの肉裂き》	名詞
＠らぞてぷの	《ラゾテプの肉裂き》	名詞
＠らぞてぷのに	《ラゾテプの肉裂き》	名詞
＠らぞてぷのにく	《ラゾテプの肉裂き》	名詞
＠らぞてぷのにくさ	《ラゾテプの肉裂き》	名詞
＠らぞてぷのにくさき	《ラゾテプの肉裂き》	名詞
＠ら	《ラルの発露》	名詞
＠らる	《ラルの発露》	名詞
＠らるの	《ラルの発露》	名詞
＠らるのは	《ラルの発露》	名詞
＠らるのはつ	《ラルの発露》	名詞
＠らるのはつろ	《ラルの発露》	名詞
＠り	《リリアナの勝利》	名詞
＠りり	《リリアナの勝利》	名詞
＠りりあ	《リリアナの勝利》	名詞
＠りりあな	《リリアナの勝利》	名詞
＠りりあなの	《リリアナの勝利》	名詞
＠りりあなのし	《リリアナの勝利》	名詞
＠りりあなのしょ	《リリアナの勝利》	名詞
＠りりあなのしょう	《リリアナの勝利》	名詞
＠りりあなのしょうり	《リリアナの勝利》	名詞
＠る	《ルーンの壁》	名詞
＠るー	《ルーンの壁》	名詞
＠るーん	《ルーンの壁》	名詞
＠るーんの	《ルーンの壁》	名詞
＠るーんのか	《ルーンの壁》	名詞
＠るーんのかべ	《ルーンの壁》	名詞
＠ろ	《ロクソドンの軍曹》	名詞
＠ろく	《ロクソドンの軍曹》	名詞
＠ろくそ	《ロクソドンの軍曹》	名詞
＠ろくそど	《ロクソドンの軍曹》	名詞
＠ろくそどん	《ロクソドンの軍曹》	名詞
＠ろくそどんの	《ロクソドンの軍曹》	名詞
＠ろくそどんのぐ	《ロクソドンの軍曹》	名詞
＠ろくそどんのぐん	《ロクソドンの軍曹》	名詞
＠ろくそどんのぐんそ	《ロクソドンの軍曹》	名詞
＠ろくそどんのぐんそう	《ロクソドンの軍曹》	名詞
＠ヴ	《ヴィトゥ＝ガジーの目覚め》	名詞
＠ヴぃ	《ヴィトゥ＝ガジーの目覚め》	名詞
＠ヴぃと	《ヴィトゥ＝ガジーの目覚め》	名詞
＠ヴぃとぅ	《ヴィトゥ＝ガジーの目覚め》	名詞
＠ヴぃとぅ＝	《ヴィトゥ＝ガジーの目覚め》	名詞
＠ヴぃとぅ＝が	《ヴィトゥ＝ガジーの目覚め》	名詞
＠ヴぃとぅ＝がじ	《ヴィトゥ＝ガジーの目覚め》	名詞
＠ヴぃとぅ＝がじー	《ヴィトゥ＝ガジーの目覚め》	名詞
＠ヴぃとぅ＝がじーの	《ヴィトゥ＝ガジーの目覚め》	名詞
＠ヴぃとぅ＝がじーのめ	《ヴィトゥ＝ガジーの目覚め》	名詞
＠ヴぃとぅ＝がじーのめざ	《ヴィトゥ＝ガジーの目覚め》	名詞
＠ヴぃとぅ＝がじーのめざめ	《ヴィトゥ＝ガジーの目覚め》	名詞
＠ヴ	《ヴラスカの懐刀》	名詞
＠ヴら	《ヴラスカの懐刀》	名詞
＠ヴらす	《ヴラスカの懐刀》	名詞
＠ヴらすか	《ヴラスカの懐刀》	名詞
＠ヴらすかの	《ヴラスカの懐刀》	名詞
＠ヴらすかのふ	《ヴラスカの懐刀》	名詞
＠ヴらすかのふと	《ヴラスカの懐刀》	名詞
＠ヴらすかのふとこ	《ヴラスカの懐刀》	名詞
＠ヴらすかのふところ	《ヴラスカの懐刀》	名詞
＠ヴらすかのふところが	《ヴラスカの懐刀》	名詞
＠ヴらすかのふところがた	《ヴラスカの懐刀》	名詞
＠ヴらすかのふところがたな	《ヴラスカの懐刀》	名詞
＠い	《一騎打ち》	名詞
＠いっ	《一騎打ち》	名詞
＠いっき	《一騎打ち》	名詞
＠いっきう	《一騎打ち》	名詞
＠いっきうち	《一騎打ち》	名詞
＠ぶ	《不気味な修練者》	名詞
＠ぶき	《不気味な修練者》	名詞
＠ぶきみ	《不気味な修練者》	名詞
＠ぶきみな	《不気味な修練者》	名詞
＠ぶきみなし	《不気味な修練者》	名詞
＠ぶきみなしゅ	《不気味な修練者》	名詞
＠ぶきみなしゅう	《不気味な修練者》	名詞
＠ぶきみなしゅうれ	《不気味な修練者》	名詞
＠ぶきみなしゅうれん	《不気味な修練者》	名詞
＠ぶきみなしゅうれんし	《不気味な修練者》	名詞
＠ぶきみなしゅうれんしゃ	《不気味な修練者》	名詞
＠せ	《世界を揺るがす者、ニッサ》	名詞
＠せか	《世界を揺るがす者、ニッサ》	名詞
＠せかい	《世界を揺るがす者、ニッサ》	名詞
＠せかいを	《世界を揺るがす者、ニッサ》	名詞
＠せかいをゆ	《世界を揺るがす者、ニッサ》	名詞
＠せかいをゆる	《世界を揺るがす者、ニッサ》	名詞
＠せかいをゆるが	《世界を揺るがす者、ニッサ》	名詞
＠せかいをゆるがす	《世界を揺るがす者、ニッサ》	名詞
＠せかいをゆるがすも	《世界を揺るがす者、ニッサ》	名詞
＠せかいをゆるがすもの	《世界を揺るがす者、ニッサ》	名詞
＠せかいをゆるがすもの、	《世界を揺るがす者、ニッサ》	名詞
＠せかいをゆるがすもの、に	《世界を揺るがす者、ニッサ》	名詞
＠せかいをゆるがすもの、にっ	《世界を揺るがす者、ニッサ》	名詞
＠せかいをゆるがすもの、にっさ	《世界を揺るがす者、ニッサ》	名詞
＠し	《主無き者、サルカン》	名詞
＠しゅ	《主無き者、サルカン》	名詞
＠しゅな	《主無き者、サルカン》	名詞
＠しゅなき	《主無き者、サルカン》	名詞
＠しゅなきも	《主無き者、サルカン》	名詞
＠しゅなきもの	《主無き者、サルカン》	名詞
＠しゅなきもの、	《主無き者、サルカン》	名詞
＠しゅなきもの、さ	《主無き者、サルカン》	名詞
＠しゅなきもの、さる	《主無き者、サルカン》	名詞
＠しゅなきもの、さるか	《主無き者、サルカン》	名詞
＠しゅなきもの、さるかん	《主無き者、サルカン》	名詞
＠よ	《予期せぬ助力》	名詞
＠よき	《予期せぬ助力》	名詞
＠よきせ	《予期せぬ助力》	名詞
＠よきせぬ	《予期せぬ助力》	名詞
＠よきせぬじ	《予期せぬ助力》	名詞
＠よきせぬじょ	《予期せぬ助力》	名詞
＠よきせぬじょり	《予期せぬ助力》	名詞
＠よきせぬじょりょ	《予期せぬ助力》	名詞
＠よきせぬじょりょく	《予期せぬ助力》	名詞
＠じ	《人知を超えるもの、ウギン》	名詞
＠じん	《人知を超えるもの、ウギン》	名詞
＠じんち	《人知を超えるもの、ウギン》	名詞
＠じんちを	《人知を超えるもの、ウギン》	名詞
＠じんちをこ	《人知を超えるもの、ウギン》	名詞
＠じんちをこえ	《人知を超えるもの、ウギン》	名詞
＠じんちをこえる	《人知を超えるもの、ウギン》	名詞
＠じんちをこえるも	《人知を超えるもの、ウギン》	名詞
＠じんちをこえるもの	《人知を超えるもの、ウギン》	名詞
＠じんちをこえるもの、	《人知を超えるもの、ウギン》	名詞
＠じんちをこえるもの、う	《人知を超えるもの、ウギン》	名詞
＠じんちをこえるもの、うぎ	《人知を超えるもの、ウギン》	名詞
＠じんちをこえるもの、うぎん	《人知を超えるもの、ウギン》	名詞
＠で	《伝承の収集者、タミヨウ》	名詞
＠でん	《伝承の収集者、タミヨウ》	名詞
＠でんし	《伝承の収集者、タミヨウ》	名詞
＠でんしょ	《伝承の収集者、タミヨウ》	名詞
＠でんしょう	《伝承の収集者、タミヨウ》	名詞
＠でんしょうの	《伝承の収集者、タミヨウ》	名詞
＠でんしょうのし	《伝承の収集者、タミヨウ》	名詞
＠でんしょうのしゅ	《伝承の収集者、タミヨウ》	名詞
＠でんしょうのしゅう	《伝承の収集者、タミヨウ》	名詞
＠でんしょうのしゅうし	《伝承の収集者、タミヨウ》	名詞
＠でんしょうのしゅうしゅ	《伝承の収集者、タミヨウ》	名詞
＠でんしょうのしゅうしゅう	《伝承の収集者、タミヨウ》	名詞
＠でんしょうのしゅうしゅうし	《伝承の収集者、タミヨウ》	名詞
＠でんしょうのしゅうしゅうしゃ	《伝承の収集者、タミヨウ》	名詞
＠でんしょうのしゅうしゅうしゃ、	《伝承の収集者、タミヨウ》	名詞
＠でんしょうのしゅうしゅうしゃ、た	《伝承の収集者、タミヨウ》	名詞
＠でんしょうのしゅうしゅうしゃ、たみ	《伝承の収集者、タミヨウ》	名詞
＠でんしょうのしゅうしゅうしゃ、たみよ	《伝承の収集者、タミヨウ》	名詞
＠でんしょうのしゅうしゅうしゃ、たみよう	《伝承の収集者、タミヨウ》	名詞
＠し	《侵略するマンティコア》	名詞
＠しん	《侵略するマンティコア》	名詞
＠しんり	《侵略するマンティコア》	名詞
＠しんりゃ	《侵略するマンティコア》	名詞
＠しんりゃく	《侵略するマンティコア》	名詞
＠しんりゃくす	《侵略するマンティコア》	名詞
＠しんりゃくする	《侵略するマンティコア》	名詞
＠しんりゃくするま	《侵略するマンティコア》	名詞
＠しんりゃくするまん	《侵略するマンティコア》	名詞
＠しんりゃくするまんて	《侵略するマンティコア》	名詞
＠しんりゃくするまんてぃ	《侵略するマンティコア》	名詞
＠しんりゃくするまんてぃこ	《侵略するマンティコア》	名詞
＠しんりゃくするまんてぃこあ	《侵略するマンティコア》	名詞
＠し	《侵略の代償》	名詞
＠しん	《侵略の代償》	名詞
＠しんり	《侵略の代償》	名詞
＠しんりゃ	《侵略の代償》	名詞
＠しんりゃく	《侵略の代償》	名詞
＠しんりゃくの	《侵略の代償》	名詞
＠しんりゃくのだ	《侵略の代償》	名詞
＠しんりゃくのだい	《侵略の代償》	名詞
＠しんりゃくのだいし	《侵略の代償》	名詞
＠しんりゃくのだいしょ	《侵略の代償》	名詞
＠しんりゃくのだいしょう	《侵略の代償》	名詞
＠し	《信頼あるペガサス》	名詞
＠しん	《信頼あるペガサス》	名詞
＠しんら	《信頼あるペガサス》	名詞
＠しんらい	《信頼あるペガサス》	名詞
＠しんらいあ	《信頼あるペガサス》	名詞
＠しんらいある	《信頼あるペガサス》	名詞
＠しんらいあるぺ	《信頼あるペガサス》	名詞
＠しんらいあるぺが	《信頼あるペガサス》	名詞
＠しんらいあるぺがさ	《信頼あるペガサス》	名詞
＠しんらいあるぺがさす	《信頼あるペガサス》	名詞
＠し	《出現領域》	名詞
＠しゅ	《出現領域》	名詞
＠しゅつ	《出現領域》	名詞
＠しゅつげ	《出現領域》	名詞
＠しゅつげん	《出現領域》	名詞
＠しゅつげんり	《出現領域》	名詞
＠しゅつげんりょ	《出現領域》	名詞
＠しゅつげんりょう	《出現領域》	名詞
＠しゅつげんりょうい	《出現領域》	名詞
＠しゅつげんりょういき	《出現領域》	名詞
＠り	《力線をうろつくもの》	名詞
＠りょ	《力線をうろつくもの》	名詞
＠りょく	《力線をうろつくもの》	名詞
＠りょくせ	《力線をうろつくもの》	名詞
＠りょくせん	《力線をうろつくもの》	名詞
＠りょくせんを	《力線をうろつくもの》	名詞
＠りょくせんをう	《力線をうろつくもの》	名詞
＠りょくせんをうろ	《力線をうろつくもの》	名詞
＠りょくせんをうろつ	《力線をうろつくもの》	名詞
＠りょくせんをうろつく	《力線をうろつくもの》	名詞
＠りょくせんをうろつくも	《力線をうろつくもの》	名詞
＠りょくせんをうろつくもの	《力線をうろつくもの》	名詞
＠ぼ	《募金取り》	名詞
＠ぼき	《募金取り》	名詞
＠ぼきん	《募金取り》	名詞
＠ぼきんど	《募金取り》	名詞
＠ぼきんどり	《募金取り》	名詞
＠ふ	《古呪》	名詞
＠ふる	《古呪》	名詞
＠ふるの	《古呪》	名詞
＠ふるのろ	《古呪》	名詞
＠ふるのろい	《古呪》	名詞
＠さ	《叫ぶ落下兵》	名詞
＠さけ	《叫ぶ落下兵》	名詞
＠さけぶ	《叫ぶ落下兵》	名詞
＠さけぶら	《叫ぶ落下兵》	名詞
＠さけぶらっ	《叫ぶ落下兵》	名詞
＠さけぶらっか	《叫ぶ落下兵》	名詞
＠さけぶらっかへ	《叫ぶ落下兵》	名詞
＠さけぶらっかへい	《叫ぶ落下兵》	名詞
＠じ	《呪文喰いの奇魔》	名詞
＠じゅ	《呪文喰いの奇魔》	名詞
＠じゅも	《呪文喰いの奇魔》	名詞
＠じゅもん	《呪文喰いの奇魔》	名詞
＠じゅもんく	《呪文喰いの奇魔》	名詞
＠じゅもんくい	《呪文喰いの奇魔》	名詞
＠じゅもんくいの	《呪文喰いの奇魔》	名詞
＠じゅもんくいのき	《呪文喰いの奇魔》	名詞
＠じゅもんくいのきま	《呪文喰いの奇魔》	名詞
＠じ	《呪文持ちの奇魔》	名詞
＠じゅ	《呪文持ちの奇魔》	名詞
＠じゅも	《呪文持ちの奇魔》	名詞
＠じゅもん	《呪文持ちの奇魔》	名詞
＠じゅもんも	《呪文持ちの奇魔》	名詞
＠じゅもんもち	《呪文持ちの奇魔》	名詞
＠じゅもんもちの	《呪文持ちの奇魔》	名詞
＠じゅもんもちのき	《呪文持ちの奇魔》	名詞
＠じゅもんもちのきま	《呪文持ちの奇魔》	名詞
＠け	《啓示の終焉》	名詞
＠けい	《啓示の終焉》	名詞
＠けいじ	《啓示の終焉》	名詞
＠けいじの	《啓示の終焉》	名詞
＠けいじのし	《啓示の終焉》	名詞
＠けいじのしゅ	《啓示の終焉》	名詞
＠けいじのしゅう	《啓示の終焉》	名詞
＠けいじのしゅうえ	《啓示の終焉》	名詞
＠けいじのしゅうえん	《啓示の終焉》	名詞
＠だ	《団結の誓約》	名詞
＠だん	《団結の誓約》	名詞
＠だんけ	《団結の誓約》	名詞
＠だんけつ	《団結の誓約》	名詞
＠だんけつの	《団結の誓約》	名詞
＠だんけつのせ	《団結の誓約》	名詞
＠だんけつのせい	《団結の誓約》	名詞
＠だんけつのせいや	《団結の誓約》	名詞
＠だんけつのせいやく	《団結の誓約》	名詞
＠じ	《城塞への猛攻》	名詞
＠じょ	《城塞への猛攻》	名詞
＠じょう	《城塞への猛攻》	名詞
＠じょうさ	《城塞への猛攻》	名詞
＠じょうさい	《城塞への猛攻》	名詞
＠じょうさいへ	《城塞への猛攻》	名詞
＠じょうさいへの	《城塞への猛攻》	名詞
＠じょうさいへのも	《城塞への猛攻》	名詞
＠じょうさいへのもう	《城塞への猛攻》	名詞
＠じょうさいへのもうこ	《城塞への猛攻》	名詞
＠じょうさいへのもうこう	《城塞への猛攻》	名詞
＠し	《執行官のグリフィン》	名詞
＠しっ	《執行官のグリフィン》	名詞
＠しっこ	《執行官のグリフィン》	名詞
＠しっこう	《執行官のグリフィン》	名詞
＠しっこうか	《執行官のグリフィン》	名詞
＠しっこうかん	《執行官のグリフィン》	名詞
＠しっこうかんの	《執行官のグリフィン》	名詞
＠しっこうかんのぐ	《執行官のグリフィン》	名詞
＠しっこうかんのぐり	《執行官のグリフィン》	名詞
＠しっこうかんのぐりふ	《執行官のグリフィン》	名詞
＠しっこうかんのぐりふぃ	《執行官のグリフィン》	名詞
＠しっこうかんのぐりふぃん	《執行官のグリフィン》	名詞
＠ゆ	《夢を引き裂く者、アショク》	名詞
＠ゆめ	《夢を引き裂く者、アショク》	名詞
＠ゆめを	《夢を引き裂く者、アショク》	名詞
＠ゆめをひ	《夢を引き裂く者、アショク》	名詞
＠ゆめをひき	《夢を引き裂く者、アショク》	名詞
＠ゆめをひきさ	《夢を引き裂く者、アショク》	名詞
＠ゆめをひきさく	《夢を引き裂く者、アショク》	名詞
＠ゆめをひきさくも	《夢を引き裂く者、アショク》	名詞
＠ゆめをひきさくもの	《夢を引き裂く者、アショク》	名詞
＠ゆめをひきさくもの、	《夢を引き裂く者、アショク》	名詞
＠ゆめをひきさくもの、あ	《夢を引き裂く者、アショク》	名詞
＠ゆめをひきさくもの、あし	《夢を引き裂く者、アショク》	名詞
＠ゆめをひきさくもの、あしょ	《夢を引き裂く者、アショク》	名詞
＠ゆめをひきさくもの、あしょく	《夢を引き裂く者、アショク》	名詞
＠お	《大いなる創造者、カーン》	名詞
＠おお	《大いなる創造者、カーン》	名詞
＠おおい	《大いなる創造者、カーン》	名詞
＠おおいな	《大いなる創造者、カーン》	名詞
＠おおいなる	《大いなる創造者、カーン》	名詞
＠おおいなるそ	《大いなる創造者、カーン》	名詞
＠おおいなるそう	《大いなる創造者、カーン》	名詞
＠おおいなるそうぞ	《大いなる創造者、カーン》	名詞
＠おおいなるそうぞう	《大いなる創造者、カーン》	名詞
＠おおいなるそうぞうし	《大いなる創造者、カーン》	名詞
＠おおいなるそうぞうしゃ	《大いなる創造者、カーン》	名詞
＠おおいなるそうぞうしゃ、	《大いなる創造者、カーン》	名詞
＠おおいなるそうぞうしゃ、か	《大いなる創造者、カーン》	名詞
＠おおいなるそうぞうしゃ、かー	《大いなる創造者、カーン》	名詞
＠おおいなるそうぞうしゃ、かーん	《大いなる創造者、カーン》	名詞
＠た	《太陽の義士、ファートリ》	名詞
＠たい	《太陽の義士、ファートリ》	名詞
＠たいよ	《太陽の義士、ファートリ》	名詞
＠たいよう	《太陽の義士、ファートリ》	名詞
＠たいようの	《太陽の義士、ファートリ》	名詞
＠たいようのぎ	《太陽の義士、ファートリ》	名詞
＠たいようのぎし	《太陽の義士、ファートリ》	名詞
＠たいようのぎし、	《太陽の義士、ファートリ》	名詞
＠たいようのぎし、ふ	《太陽の義士、ファートリ》	名詞
＠たいようのぎし、ふぁ	《太陽の義士、ファートリ》	名詞
＠たいようのぎし、ふぁー	《太陽の義士、ファートリ》	名詞
＠たいようのぎし、ふぁーと	《太陽の義士、ファートリ》	名詞
＠たいようのぎし、ふぁーとり	《太陽の義士、ファートリ》	名詞
＠ぽ	《奉謝の亡霊》	名詞
＠ぽん	《奉謝の亡霊》	名詞
＠ぽんし	《奉謝の亡霊》	名詞
＠ぽんしゃ	《奉謝の亡霊》	名詞
＠ぽんしゃの	《奉謝の亡霊》	名詞
＠ぽんしゃのぼ	《奉謝の亡霊》	名詞
＠ぽんしゃのぼう	《奉謝の亡霊》	名詞
＠ぽんしゃのぼうれ	《奉謝の亡霊》	名詞
＠ぽんしゃのぼうれい	《奉謝の亡霊》	名詞
＠は	《始源のワーム》	名詞
＠はじ	《始源のワーム》	名詞
＠はじめ	《始源のワーム》	名詞
＠はじめげ	《始源のワーム》	名詞
＠はじめげん	《始源のワーム》	名詞
＠はじめげんの	《始源のワーム》	名詞
＠はじめげんのわ	《始源のワーム》	名詞
＠はじめげんのわー	《始源のワーム》	名詞
＠はじめげんのわーむ	《始源のワーム》	名詞
＠ひ	《密かな任務》	名詞
＠ひそ	《密かな任務》	名詞
＠ひそか	《密かな任務》	名詞
＠ひそかな	《密かな任務》	名詞
＠ひそかなに	《密かな任務》	名詞
＠ひそかなにん	《密かな任務》	名詞
＠ひそかなにんむ	《密かな任務》	名詞
＠か	《寛大なる者、アジャニ》	名詞
＠かん	《寛大なる者、アジャニ》	名詞
＠かんだ	《寛大なる者、アジャニ》	名詞
＠かんだい	《寛大なる者、アジャニ》	名詞
＠かんだいな	《寛大なる者、アジャニ》	名詞
＠かんだいなる	《寛大なる者、アジャニ》	名詞
＠かんだいなるも	《寛大なる者、アジャニ》	名詞
＠かんだいなるもの	《寛大なる者、アジャニ》	名詞
＠かんだいなるもの、	《寛大なる者、アジャニ》	名詞
＠かんだいなるもの、あ	《寛大なる者、アジャニ》	名詞
＠かんだいなるもの、あじ	《寛大なる者、アジャニ》	名詞
＠かんだいなるもの、あじゃ	《寛大なる者、アジャニ》	名詞
＠かんだいなるもの、あじゃに	《寛大なる者、アジャニ》	名詞
＠や	《山》	名詞
＠やま	《山》	名詞
＠じ	《島》	名詞
＠じま	《島》	名詞
＠す	《崇高な工匠、サヒーリ》	名詞
＠すう	《崇高な工匠、サヒーリ》	名詞
＠すうこ	《崇高な工匠、サヒーリ》	名詞
＠すうこう	《崇高な工匠、サヒーリ》	名詞
＠すうこうな	《崇高な工匠、サヒーリ》	名詞
＠すうこうなこ	《崇高な工匠、サヒーリ》	名詞
＠すうこうなこう	《崇高な工匠、サヒーリ》	名詞
＠すうこうなこうし	《崇高な工匠、サヒーリ》	名詞
＠すうこうなこうしょ	《崇高な工匠、サヒーリ》	名詞
＠すうこうなこうしょう	《崇高な工匠、サヒーリ》	名詞
＠すうこうなこうしょう、	《崇高な工匠、サヒーリ》	名詞
＠すうこうなこうしょう、さ	《崇高な工匠、サヒーリ》	名詞
＠すうこうなこうしょう、さひ	《崇高な工匠、サヒーリ》	名詞
＠すうこうなこうしょう、さひー	《崇高な工匠、サヒーリ》	名詞
＠すうこうなこうしょう、さひーり	《崇高な工匠、サヒーリ》	名詞
＠あ	《嵐の伝導者、ラル》	名詞
＠あら	《嵐の伝導者、ラル》	名詞
＠あらし	《嵐の伝導者、ラル》	名詞
＠あらしの	《嵐の伝導者、ラル》	名詞
＠あらしので	《嵐の伝導者、ラル》	名詞
＠あらしのでん	《嵐の伝導者、ラル》	名詞
＠あらしのでんど	《嵐の伝導者、ラル》	名詞
＠あらしのでんどう	《嵐の伝導者、ラル》	名詞
＠あらしのでんどうし	《嵐の伝導者、ラル》	名詞
＠あらしのでんどうしゃ	《嵐の伝導者、ラル》	名詞
＠あらしのでんどうしゃ、	《嵐の伝導者、ラル》	名詞
＠あらしのでんどうしゃ、ら	《嵐の伝導者、ラル》	名詞
＠あらしのでんどうしゃ、らる	《嵐の伝導者、ラル》	名詞
＠き	《巨大化》	名詞
＠きょ	《巨大化》	名詞
＠きょだ	《巨大化》	名詞
＠きょだい	《巨大化》	名詞
＠きょだいか	《巨大化》	名詞
＠へ	《平地》	名詞
＠へい	《平地》	名詞
＠へいち	《平地》	名詞
＠こ	《幸運な野良猫》	名詞
＠こう	《幸運な野良猫》	名詞
＠こうう	《幸運な野良猫》	名詞
＠こううん	《幸運な野良猫》	名詞
＠こううんな	《幸運な野良猫》	名詞
＠こううんなの	《幸運な野良猫》	名詞
＠こううんなのら	《幸運な野良猫》	名詞
＠こううんなのらね	《幸運な野良猫》	名詞
＠こううんなのらねこ	《幸運な野良猫》	名詞
＠き	《強制着陸》	名詞
＠きょ	《強制着陸》	名詞
＠きょう	《強制着陸》	名詞
＠きょうせ	《強制着陸》	名詞
＠きょうせい	《強制着陸》	名詞
＠きょうせいち	《強制着陸》	名詞
＠きょうせいちゃ	《強制着陸》	名詞
＠きょうせいちゃく	《強制着陸》	名詞
＠きょうせいちゃくり	《強制着陸》	名詞
＠きょうせいちゃくりく	《強制着陸》	名詞
＠や	《役割交代》	名詞
＠やく	《役割交代》	名詞
＠やくわ	《役割交代》	名詞
＠やくわり	《役割交代》	名詞
＠やくわりこ	《役割交代》	名詞
＠やくわりこう	《役割交代》	名詞
＠やくわりこうた	《役割交代》	名詞
＠やくわりこうたい	《役割交代》	名詞
＠ふ	《復讐に燃えた血王、ソリン》	名詞
＠ふく	《復讐に燃えた血王、ソリン》	名詞
＠ふくし	《復讐に燃えた血王、ソリン》	名詞
＠ふくしゅ	《復讐に燃えた血王、ソリン》	名詞
＠ふくしゅう	《復讐に燃えた血王、ソリン》	名詞
＠ふくしゅうに	《復讐に燃えた血王、ソリン》	名詞
＠ふくしゅうにも	《復讐に燃えた血王、ソリン》	名詞
＠ふくしゅうにもえ	《復讐に燃えた血王、ソリン》	名詞
＠ふくしゅうにもえた	《復讐に燃えた血王、ソリン》	名詞
＠ふくしゅうにもえたち	《復讐に燃えた血王、ソリン》	名詞
＠ふくしゅうにもえたちお	《復讐に燃えた血王、ソリン》	名詞
＠ふくしゅうにもえたちおう	《復讐に燃えた血王、ソリン》	名詞
＠ふくしゅうにもえたちおう、	《復讐に燃えた血王、ソリン》	名詞
＠ふくしゅうにもえたちおう、そ	《復讐に燃えた血王、ソリン》	名詞
＠ふくしゅうにもえたちおう、そり	《復讐に燃えた血王、ソリン》	名詞
＠ふくしゅうにもえたちおう、そりん	《復讐に燃えた血王、ソリン》	名詞
＠こ	《心温まる贖罪》	名詞
＠ここ	《心温まる贖罪》	名詞
＠こころ	《心温まる贖罪》	名詞
＠こころあ	《心温まる贖罪》	名詞
＠こころあた	《心温まる贖罪》	名詞
＠こころあたた	《心温まる贖罪》	名詞
＠こころあたたま	《心温まる贖罪》	名詞
＠こころあたたまる	《心温まる贖罪》	名詞
＠こころあたたまるし	《心温まる贖罪》	名詞
＠こころあたたまるしょ	《心温まる贖罪》	名詞
＠こころあたたまるしょく	《心温まる贖罪》	名詞
＠こころあたたまるしょくざ	《心温まる贖罪》	名詞
＠こころあたたまるしょくざい	《心温まる贖罪》	名詞
＠し	《心火》	名詞
＠しん	《心火》	名詞
＠しんか	《心火》	名詞
＠ち	《忠実な相棒、モーウー》	名詞
＠ちゅ	《忠実な相棒、モーウー》	名詞
＠ちゅう	《忠実な相棒、モーウー》	名詞
＠ちゅうじ	《忠実な相棒、モーウー》	名詞
＠ちゅうじつ	《忠実な相棒、モーウー》	名詞
＠ちゅうじつな	《忠実な相棒、モーウー》	名詞
＠ちゅうじつなあ	《忠実な相棒、モーウー》	名詞
＠ちゅうじつなあい	《忠実な相棒、モーウー》	名詞
＠ちゅうじつなあいぼ	《忠実な相棒、モーウー》	名詞
＠ちゅうじつなあいぼう	《忠実な相棒、モーウー》	名詞
＠ちゅうじつなあいぼう、	《忠実な相棒、モーウー》	名詞
＠ちゅうじつなあいぼう、も	《忠実な相棒、モーウー》	名詞
＠ちゅうじつなあいぼう、もー	《忠実な相棒、モーウー》	名詞
＠ちゅうじつなあいぼう、もーう	《忠実な相棒、モーウー》	名詞
＠ちゅうじつなあいぼう、もーうー	《忠実な相棒、モーウー》	名詞
＠い	《怒り狂うクロンチ》	名詞
＠いか	《怒り狂うクロンチ》	名詞
＠いかり	《怒り狂うクロンチ》	名詞
＠いかりく	《怒り狂うクロンチ》	名詞
＠いかりくる	《怒り狂うクロンチ》	名詞
＠いかりくるう	《怒り狂うクロンチ》	名詞
＠いかりくるうく	《怒り狂うクロンチ》	名詞
＠いかりくるうくろ	《怒り狂うクロンチ》	名詞
＠いかりくるうくろん	《怒り狂うクロンチ》	名詞
＠いかりくるうくろんち	《怒り狂うクロンチ》	名詞
＠あ	《悪への引き渡し》	名詞
＠あく	《悪への引き渡し》	名詞
＠あくへ	《悪への引き渡し》	名詞
＠あくへの	《悪への引き渡し》	名詞
＠あくへのひ	《悪への引き渡し》	名詞
＠あくへのひき	《悪への引き渡し》	名詞
＠あくへのひきわ	《悪への引き渡し》	名詞
＠あくへのひきわた	《悪への引き渡し》	名詞
＠あくへのひきわたし	《悪への引き渡し》	名詞
＠ぞ	《憎悪に歪む者、オブ・ニクシリス》	名詞
＠ぞう	《憎悪に歪む者、オブ・ニクシリス》	名詞
＠ぞうお	《憎悪に歪む者、オブ・ニクシリス》	名詞
＠ぞうおに	《憎悪に歪む者、オブ・ニクシリス》	名詞
＠ぞうおにゆ	《憎悪に歪む者、オブ・ニクシリス》	名詞
＠ぞうおにゆが	《憎悪に歪む者、オブ・ニクシリス》	名詞
＠ぞうおにゆがむ	《憎悪に歪む者、オブ・ニクシリス》	名詞
＠ぞうおにゆがむも	《憎悪に歪む者、オブ・ニクシリス》	名詞
＠ぞうおにゆがむもの	《憎悪に歪む者、オブ・ニクシリス》	名詞
＠ぞうおにゆがむもの、	《憎悪に歪む者、オブ・ニクシリス》	名詞
＠ぞうおにゆがむもの、お	《憎悪に歪む者、オブ・ニクシリス》	名詞
＠ぞうおにゆがむもの、おぶ	《憎悪に歪む者、オブ・ニクシリス》	名詞
＠ぞうおにゆがむもの、おぶ・	《憎悪に歪む者、オブ・ニクシリス》	名詞
＠ぞうおにゆがむもの、おぶ・に	《憎悪に歪む者、オブ・ニクシリス》	名詞
＠ぞうおにゆがむもの、おぶ・にく	《憎悪に歪む者、オブ・ニクシリス》	名詞
＠ぞうおにゆがむもの、おぶ・にくし	《憎悪に歪む者、オブ・ニクシリス》	名詞
＠ぞうおにゆがむもの、おぶ・にくしり	《憎悪に歪む者、オブ・ニクシリス》	名詞
＠ぞうおにゆがむもの、おぶ・にくしりす	《憎悪に歪む者、オブ・ニクシリス》	名詞
＠せ	《戦乱のラヴニカ》	名詞
＠せん	《戦乱のラヴニカ》	名詞
＠せんら	《戦乱のラヴニカ》	名詞
＠せんらん	《戦乱のラヴニカ》	名詞
＠せんらんの	《戦乱のラヴニカ》	名詞
＠せんらんのら	《戦乱のラヴニカ》	名詞
＠せんらんのらヴ	《戦乱のラヴニカ》	名詞
＠せんらんのらヴに	《戦乱のラヴニカ》	名詞
＠せんらんのらヴにか	《戦乱のラヴニカ》	名詞
＠せ	《戦争の犠牲》	名詞
＠せん	《戦争の犠牲》	名詞
＠せんそ	《戦争の犠牲》	名詞
＠せんそう	《戦争の犠牲》	名詞
＠せんそうの	《戦争の犠牲》	名詞
＠せんそうのぎ	《戦争の犠牲》	名詞
＠せんそうのぎせ	《戦争の犠牲》	名詞
＠せんそうのぎせい	《戦争の犠牲》	名詞
＠せ	《戦地の金切り声上げ》	名詞
＠せん	《戦地の金切り声上げ》	名詞
＠せんち	《戦地の金切り声上げ》	名詞
＠せんちの	《戦地の金切り声上げ》	名詞
＠せんちのか	《戦地の金切り声上げ》	名詞
＠せんちのかな	《戦地の金切り声上げ》	名詞
＠せんちのかなき	《戦地の金切り声上げ》	名詞
＠せんちのかなきり	《戦地の金切り声上げ》	名詞
＠せんちのかなきりご	《戦地の金切り声上げ》	名詞
＠せんちのかなきりごえ	《戦地の金切り声上げ》	名詞
＠せんちのかなきりごえあ	《戦地の金切り声上げ》	名詞
＠せんちのかなきりごえあげ	《戦地の金切り声上げ》	名詞
＠せ	《戦地昇進》	名詞
＠せん	《戦地昇進》	名詞
＠せんち	《戦地昇進》	名詞
＠せんちし	《戦地昇進》	名詞
＠せんちしょ	《戦地昇進》	名詞
＠せんちしょう	《戦地昇進》	名詞
＠せんちしょうし	《戦地昇進》	名詞
＠せんちしょうしん	《戦地昇進》	名詞
＠わ	《戦慄猫》	名詞
＠わな	《戦慄猫》	名詞
＠わなな	《戦慄猫》	名詞
＠わななき	《戦慄猫》	名詞
＠わななきね	《戦慄猫》	名詞
＠わななきねこ	《戦慄猫》	名詞
＠わ	《戦慄衆の侵略》	名詞
＠わな	《戦慄衆の侵略》	名詞
＠わなな	《戦慄衆の侵略》	名詞
＠わななき	《戦慄衆の侵略》	名詞
＠わななきし	《戦慄衆の侵略》	名詞
＠わななきしゅ	《戦慄衆の侵略》	名詞
＠わななきしゅう	《戦慄衆の侵略》	名詞
＠わななきしゅうの	《戦慄衆の侵略》	名詞
＠わななきしゅうのし	《戦慄衆の侵略》	名詞
＠わななきしゅうのしん	《戦慄衆の侵略》	名詞
＠わななきしゅうのしんり	《戦慄衆の侵略》	名詞
＠わななきしゅうのしんりゃ	《戦慄衆の侵略》	名詞
＠わななきしゅうのしんりゃく	《戦慄衆の侵略》	名詞
＠わ	《戦慄衆の先駆け》	名詞
＠わな	《戦慄衆の先駆け》	名詞
＠わなな	《戦慄衆の先駆け》	名詞
＠わななき	《戦慄衆の先駆け》	名詞
＠わななきし	《戦慄衆の先駆け》	名詞
＠わななきしゅ	《戦慄衆の先駆け》	名詞
＠わななきしゅう	《戦慄衆の先駆け》	名詞
＠わななきしゅうの	《戦慄衆の先駆け》	名詞
＠わななきしゅうのさ	《戦慄衆の先駆け》	名詞
＠わななきしゅうのさき	《戦慄衆の先駆け》	名詞
＠わななきしゅうのさきが	《戦慄衆の先駆け》	名詞
＠わななきしゅうのさきがけ	《戦慄衆の先駆け》	名詞
＠わ	《戦慄衆の勇者、ネヘブ》	名詞
＠わな	《戦慄衆の勇者、ネヘブ》	名詞
＠わなな	《戦慄衆の勇者、ネヘブ》	名詞
＠わななき	《戦慄衆の勇者、ネヘブ》	名詞
＠わななきし	《戦慄衆の勇者、ネヘブ》	名詞
＠わななきしゅ	《戦慄衆の勇者、ネヘブ》	名詞
＠わななきしゅう	《戦慄衆の勇者、ネヘブ》	名詞
＠わななきしゅうの	《戦慄衆の勇者、ネヘブ》	名詞
＠わななきしゅうのゆ	《戦慄衆の勇者、ネヘブ》	名詞
＠わななきしゅうのゆう	《戦慄衆の勇者、ネヘブ》	名詞
＠わななきしゅうのゆうし	《戦慄衆の勇者、ネヘブ》	名詞
＠わななきしゅうのゆうしゃ	《戦慄衆の勇者、ネヘブ》	名詞
＠わななきしゅうのゆうしゃ、	《戦慄衆の勇者、ネヘブ》	名詞
＠わななきしゅうのゆうしゃ、ね	《戦慄衆の勇者、ネヘブ》	名詞
＠わななきしゅうのゆうしゃ、ねへ	《戦慄衆の勇者、ネヘブ》	名詞
＠わななきしゅうのゆうしゃ、ねへぶ	《戦慄衆の勇者、ネヘブ》	名詞
＠わ	《戦慄衆の双子》	名詞
＠わな	《戦慄衆の双子》	名詞
＠わなな	《戦慄衆の双子》	名詞
＠わななき	《戦慄衆の双子》	名詞
＠わななきし	《戦慄衆の双子》	名詞
＠わななきしゅ	《戦慄衆の双子》	名詞
＠わななきしゅう	《戦慄衆の双子》	名詞
＠わななきしゅうの	《戦慄衆の双子》	名詞
＠わななきしゅうのふ	《戦慄衆の双子》	名詞
＠わななきしゅうのふた	《戦慄衆の双子》	名詞
＠わななきしゅうのふたご	《戦慄衆の双子》	名詞
＠わ	《戦慄衆の将軍、リリアナ》	名詞
＠わな	《戦慄衆の将軍、リリアナ》	名詞
＠わなな	《戦慄衆の将軍、リリアナ》	名詞
＠わななき	《戦慄衆の将軍、リリアナ》	名詞
＠わななきし	《戦慄衆の将軍、リリアナ》	名詞
＠わななきしゅ	《戦慄衆の将軍、リリアナ》	名詞
＠わななきしゅう	《戦慄衆の将軍、リリアナ》	名詞
＠わななきしゅうの	《戦慄衆の将軍、リリアナ》	名詞
＠わななきしゅうのし	《戦慄衆の将軍、リリアナ》	名詞
＠わななきしゅうのしょ	《戦慄衆の将軍、リリアナ》	名詞
＠わななきしゅうのしょう	《戦慄衆の将軍、リリアナ》	名詞
＠わななきしゅうのしょうぐ	《戦慄衆の将軍、リリアナ》	名詞
＠わななきしゅうのしょうぐん	《戦慄衆の将軍、リリアナ》	名詞
＠わななきしゅうのしょうぐん、	《戦慄衆の将軍、リリアナ》	名詞
＠わななきしゅうのしょうぐん、り	《戦慄衆の将軍、リリアナ》	名詞
＠わななきしゅうのしょうぐん、りり	《戦慄衆の将軍、リリアナ》	名詞
＠わななきしゅうのしょうぐん、りりあ	《戦慄衆の将軍、リリアナ》	名詞
＠わななきしゅうのしょうぐん、りりあな	《戦慄衆の将軍、リリアナ》	名詞
＠わ	《戦慄衆の指揮》	名詞
＠わな	《戦慄衆の指揮》	名詞
＠わなな	《戦慄衆の指揮》	名詞
＠わななき	《戦慄衆の指揮》	名詞
＠わななきし	《戦慄衆の指揮》	名詞
＠わななきしゅ	《戦慄衆の指揮》	名詞
＠わななきしゅう	《戦慄衆の指揮》	名詞
＠わななきしゅうの	《戦慄衆の指揮》	名詞
＠わななきしゅうのし	《戦慄衆の指揮》	名詞
＠わななきしゅうのしき	《戦慄衆の指揮》	名詞
＠わ	《戦慄衆の秘儀術師》	名詞
＠わな	《戦慄衆の秘儀術師》	名詞
＠わなな	《戦慄衆の秘儀術師》	名詞
＠わななき	《戦慄衆の秘儀術師》	名詞
＠わななきし	《戦慄衆の秘儀術師》	名詞
＠わななきしゅ	《戦慄衆の秘儀術師》	名詞
＠わななきしゅう	《戦慄衆の秘儀術師》	名詞
＠わななきしゅうの	《戦慄衆の秘儀術師》	名詞
＠わななきしゅうのひ	《戦慄衆の秘儀術師》	名詞
＠わななきしゅうのひぎ	《戦慄衆の秘儀術師》	名詞
＠わななきしゅうのひぎじ	《戦慄衆の秘儀術師》	名詞
＠わななきしゅうのひぎじゅ	《戦慄衆の秘儀術師》	名詞
＠わななきしゅうのひぎじゅつ	《戦慄衆の秘儀術師》	名詞
＠わななきしゅうのひぎじゅつし	《戦慄衆の秘儀術師》	名詞
＠わ	《戦慄衆の解体者》	名詞
＠わな	《戦慄衆の解体者》	名詞
＠わなな	《戦慄衆の解体者》	名詞
＠わななき	《戦慄衆の解体者》	名詞
＠わななきし	《戦慄衆の解体者》	名詞
＠わななきしゅ	《戦慄衆の解体者》	名詞
＠わななきしゅう	《戦慄衆の解体者》	名詞
＠わななきしゅうの	《戦慄衆の解体者》	名詞
＠わななきしゅうのか	《戦慄衆の解体者》	名詞
＠わななきしゅうのかい	《戦慄衆の解体者》	名詞
＠わななきしゅうのかいた	《戦慄衆の解体者》	名詞
＠わななきしゅうのかいたい	《戦慄衆の解体者》	名詞
＠わななきしゅうのかいたいし	《戦慄衆の解体者》	名詞
＠わななきしゅうのかいたいしゃ	《戦慄衆の解体者》	名詞
＠ち	《挑戦するトロール》	名詞
＠ちょ	《挑戦するトロール》	名詞
＠ちょう	《挑戦するトロール》	名詞
＠ちょうせ	《挑戦するトロール》	名詞
＠ちょうせん	《挑戦するトロール》	名詞
＠ちょうせんす	《挑戦するトロール》	名詞
＠ちょうせんする	《挑戦するトロール》	名詞
＠ちょうせんすると	《挑戦するトロール》	名詞
＠ちょうせんするとろ	《挑戦するトロール》	名詞
＠ちょうせんするとろー	《挑戦するトロール》	名詞
＠ちょうせんするとろーる	《挑戦するトロール》	名詞
＠す	《捨て身の突進》	名詞
＠すて	《捨て身の突進》	名詞
＠すてみ	《捨て身の突進》	名詞
＠すてみの	《捨て身の突進》	名詞
＠すてみのと	《捨て身の突進》	名詞
＠すてみのとっ	《捨て身の突進》	名詞
＠すてみのとっし	《捨て身の突進》	名詞
＠すてみのとっしん	《捨て身の突進》	名詞
＠ゆ	《揺るぎない狙い》	名詞
＠ゆる	《揺るぎない狙い》	名詞
＠ゆるぎ	《揺るぎない狙い》	名詞
＠ゆるぎな	《揺るぎない狙い》	名詞
＠ゆるぎない	《揺るぎない狙い》	名詞
＠ゆるぎないね	《揺るぎない狙い》	名詞
＠ゆるぎないねら	《揺るぎない狙い》	名詞
＠ゆるぎないねらい	《揺るぎない狙い》	名詞
＠し	《支配の片腕、ドビン》	名詞
＠しは	《支配の片腕、ドビン》	名詞
＠しはい	《支配の片腕、ドビン》	名詞
＠しはいの	《支配の片腕、ドビン》	名詞
＠しはいのか	《支配の片腕、ドビン》	名詞
＠しはいのかた	《支配の片腕、ドビン》	名詞
＠しはいのかたう	《支配の片腕、ドビン》	名詞
＠しはいのかたうで	《支配の片腕、ドビン》	名詞
＠しはいのかたうで、	《支配の片腕、ドビン》	名詞
＠しはいのかたうで、ど	《支配の片腕、ドビン》	名詞
＠しはいのかたうで、どび	《支配の片腕、ドビン》	名詞
＠しはいのかたうで、どびん	《支配の片腕、ドビン》	名詞
＠ほ	《放浪者》	名詞
＠ほう	《放浪者》	名詞
＠ほうろ	《放浪者》	名詞
＠ほうろう	《放浪者》	名詞
＠ほうろうし	《放浪者》	名詞
＠ほうろうしゃ	《放浪者》	名詞
＠ほ	《放浪者の一撃》	名詞
＠ほう	《放浪者の一撃》	名詞
＠ほうろ	《放浪者の一撃》	名詞
＠ほうろう	《放浪者の一撃》	名詞
＠ほうろうし	《放浪者の一撃》	名詞
＠ほうろうしゃ	《放浪者の一撃》	名詞
＠ほうろうしゃの	《放浪者の一撃》	名詞
＠ほうろうしゃのい	《放浪者の一撃》	名詞
＠ほうろうしゃのいち	《放浪者の一撃》	名詞
＠ほうろうしゃのいちげ	《放浪者の一撃》	名詞
＠ほうろうしゃのいちげき	《放浪者の一撃》	名詞
＠き	《救出のスフィンクス》	名詞
＠きゅ	《救出のスフィンクス》	名詞
＠きゅう	《救出のスフィンクス》	名詞
＠きゅうし	《救出のスフィンクス》	名詞
＠きゅうしゅ	《救出のスフィンクス》	名詞
＠きゅうしゅつ	《救出のスフィンクス》	名詞
＠きゅうしゅつの	《救出のスフィンクス》	名詞
＠きゅうしゅつのす	《救出のスフィンクス》	名詞
＠きゅうしゅつのすふ	《救出のスフィンクス》	名詞
＠きゅうしゅつのすふぃ	《救出のスフィンクス》	名詞
＠きゅうしゅつのすふぃん	《救出のスフィンクス》	名詞
＠きゅうしゅつのすふぃんく	《救出のスフィンクス》	名詞
＠きゅうしゅつのすふぃんくす	《救出のスフィンクス》	名詞
＠け	《敬慕される炎魔道士、ヤヤ》	名詞
＠けい	《敬慕される炎魔道士、ヤヤ》	名詞
＠けいぼ	《敬慕される炎魔道士、ヤヤ》	名詞
＠けいぼさ	《敬慕される炎魔道士、ヤヤ》	名詞
＠けいぼされ	《敬慕される炎魔道士、ヤヤ》	名詞
＠けいぼされる	《敬慕される炎魔道士、ヤヤ》	名詞
＠けいぼされるほ	《敬慕される炎魔道士、ヤヤ》	名詞
＠けいぼされるほの	《敬慕される炎魔道士、ヤヤ》	名詞
＠けいぼされるほのお	《敬慕される炎魔道士、ヤヤ》	名詞
＠けいぼされるほのおま	《敬慕される炎魔道士、ヤヤ》	名詞
＠けいぼされるほのおまど	《敬慕される炎魔道士、ヤヤ》	名詞
＠けいぼされるほのおまどう	《敬慕される炎魔道士、ヤヤ》	名詞
＠けいぼされるほのおまどうし	《敬慕される炎魔道士、ヤヤ》	名詞
＠けいぼされるほのおまどうし、	《敬慕される炎魔道士、ヤヤ》	名詞
＠けいぼされるほのおまどうし、や	《敬慕される炎魔道士、ヤヤ》	名詞
＠けいぼされるほのおまどうし、やや	《敬慕される炎魔道士、ヤヤ》	名詞
＠あ	《新たな地平》	名詞
＠あら	《新たな地平》	名詞
＠あらた	《新たな地平》	名詞
＠あらたな	《新たな地平》	名詞
＠あらたなち	《新たな地平》	名詞
＠あらたなちへ	《新たな地平》	名詞
＠あらたなちへい	《新たな地平》	名詞
＠し	《新生化》	名詞
＠しん	《新生化》	名詞
＠しんせ	《新生化》	名詞
＠しんせい	《新生化》	名詞
＠しんせいか	《新生化》	名詞
＠ひ	《日和見吸血鬼》	名詞
＠ひよ	《日和見吸血鬼》	名詞
＠ひより	《日和見吸血鬼》	名詞
＠ひよりみ	《日和見吸血鬼》	名詞
＠ひよりみき	《日和見吸血鬼》	名詞
＠ひよりみきゅ	《日和見吸血鬼》	名詞
＠ひよりみきゅう	《日和見吸血鬼》	名詞
＠ひよりみきゅうけ	《日和見吸血鬼》	名詞
＠ひよりみきゅうけつ	《日和見吸血鬼》	名詞
＠ひよりみきゅうけつき	《日和見吸血鬼》	名詞
＠じ	《時の一掃》	名詞
＠じの	《時の一掃》	名詞
＠じのい	《時の一掃》	名詞
＠じのいっ	《時の一掃》	名詞
＠じのいっそ	《時の一掃》	名詞
＠じのいっそう	《時の一掃》	名詞
＠じ	《時を解す者、テフェリー》	名詞
＠じを	《時を解す者、テフェリー》	名詞
＠じをほ	《時を解す者、テフェリー》	名詞
＠じをほぐ	《時を解す者、テフェリー》	名詞
＠じをほぐす	《時を解す者、テフェリー》	名詞
＠じをほぐすも	《時を解す者、テフェリー》	名詞
＠じをほぐすもの	《時を解す者、テフェリー》	名詞
＠じをほぐすもの、	《時を解す者、テフェリー》	名詞
＠じをほぐすもの、て	《時を解す者、テフェリー》	名詞
＠じをほぐすもの、てふ	《時を解す者、テフェリー》	名詞
＠じをほぐすもの、てふぇ	《時を解す者、テフェリー》	名詞
＠じをほぐすもの、てふぇり	《時を解す者、テフェリー》	名詞
＠じをほぐすもの、てふぇりー	《時を解す者、テフェリー》	名詞
＠ぼ	《暴君の嘲笑》	名詞
＠ぼう	《暴君の嘲笑》	名詞
＠ぼうく	《暴君の嘲笑》	名詞
＠ぼうくん	《暴君の嘲笑》	名詞
＠ぼうくんの	《暴君の嘲笑》	名詞
＠ぼうくんのち	《暴君の嘲笑》	名詞
＠ぼうくんのちょ	《暴君の嘲笑》	名詞
＠ぼうくんのちょう	《暴君の嘲笑》	名詞
＠ぼうくんのちょうし	《暴君の嘲笑》	名詞
＠ぼうくんのちょうしょ	《暴君の嘲笑》	名詞
＠ぼうくんのちょうしょう	《暴君の嘲笑》	名詞
＠ぼ	《暴君潰し、サムト》	名詞
＠ぼう	《暴君潰し、サムト》	名詞
＠ぼうく	《暴君潰し、サムト》	名詞
＠ぼうくん	《暴君潰し、サムト》	名詞
＠ぼうくんつ	《暴君潰し、サムト》	名詞
＠ぼうくんつぶ	《暴君潰し、サムト》	名詞
＠ぼうくんつぶし	《暴君潰し、サムト》	名詞
＠ぼうくんつぶし、	《暴君潰し、サムト》	名詞
＠ぼうくんつぶし、さ	《暴君潰し、サムト》	名詞
＠ぼうくんつぶし、さむ	《暴君潰し、サムト》	名詞
＠ぼうくんつぶし、さむと	《暴君潰し、サムト》	名詞
＠か	《果敢な一撃》	名詞
＠かか	《果敢な一撃》	名詞
＠かかん	《果敢な一撃》	名詞
＠かかんな	《果敢な一撃》	名詞
＠かかんない	《果敢な一撃》	名詞
＠かかんないち	《果敢な一撃》	名詞
＠かかんないちげ	《果敢な一撃》	名詞
＠かかんないちげき	《果敢な一撃》	名詞
＠え	《栄光の終焉》	名詞
＠えい	《栄光の終焉》	名詞
＠えいこ	《栄光の終焉》	名詞
＠えいこう	《栄光の終焉》	名詞
＠えいこうの	《栄光の終焉》	名詞
＠えいこうのし	《栄光の終焉》	名詞
＠えいこうのしゅ	《栄光の終焉》	名詞
＠えいこうのしゅう	《栄光の終焉》	名詞
＠えいこうのしゅうえ	《栄光の終焉》	名詞
＠えいこうのしゅうえん	《栄光の終焉》	名詞
＠も	《森》	名詞
＠もり	《森》	名詞
＠ら	《楽園のドルイド》	名詞
＠らく	《楽園のドルイド》	名詞
＠らくえ	《楽園のドルイド》	名詞
＠らくえん	《楽園のドルイド》	名詞
＠らくえんの	《楽園のドルイド》	名詞
＠らくえんのど	《楽園のドルイド》	名詞
＠らくえんのどる	《楽園のドルイド》	名詞
＠らくえんのどるい	《楽園のドルイド》	名詞
＠らくえんのどるいど	《楽園のドルイド》	名詞
＠じ	《樹上の草食獣》	名詞
＠じゅ	《樹上の草食獣》	名詞
＠じゅじ	《樹上の草食獣》	名詞
＠じゅじょ	《樹上の草食獣》	名詞
＠じゅじょう	《樹上の草食獣》	名詞
＠じゅじょうの	《樹上の草食獣》	名詞
＠じゅじょうのそ	《樹上の草食獣》	名詞
＠じゅじょうのそう	《樹上の草食獣》	名詞
＠じゅじょうのそうし	《樹上の草食獣》	名詞
＠じゅじょうのそうしょ	《樹上の草食獣》	名詞
＠じゅじょうのそうしょく	《樹上の草食獣》	名詞
＠じゅじょうのそうしょくじ	《樹上の草食獣》	名詞
＠じゅじょうのそうしょくじゅ	《樹上の草食獣》	名詞
＠じゅじょうのそうしょくじゅう	《樹上の草食獣》	名詞
＠ば	《橋の主、テゼレット》	名詞
＠ばし	《橋の主、テゼレット》	名詞
＠ばしの	《橋の主、テゼレット》	名詞
＠ばしのあ	《橋の主、テゼレット》	名詞
＠ばしのある	《橋の主、テゼレット》	名詞
＠ばしのあるじ	《橋の主、テゼレット》	名詞
＠ばしのあるじ、	《橋の主、テゼレット》	名詞
＠ばしのあるじ、て	《橋の主、テゼレット》	名詞
＠ばしのあるじ、てぜ	《橋の主、テゼレット》	名詞
＠ばしのあるじ、てぜれ	《橋の主、テゼレット》	名詞
＠ばしのあるじ、てぜれっ	《橋の主、テゼレット》	名詞
＠ばしのあるじ、てぜれっと	《橋の主、テゼレット》	名詞
＠じ	《次元を挙げた祝賀》	名詞
＠じげ	《次元を挙げた祝賀》	名詞
＠じげん	《次元を挙げた祝賀》	名詞
＠じげんを	《次元を挙げた祝賀》	名詞
＠じげんをあ	《次元を挙げた祝賀》	名詞
＠じげんをあげ	《次元を挙げた祝賀》	名詞
＠じげんをあげた	《次元を挙げた祝賀》	名詞
＠じげんをあげたし	《次元を挙げた祝賀》	名詞
＠じげんをあげたしゅ	《次元を挙げた祝賀》	名詞
＠じげんをあげたしゅく	《次元を挙げた祝賀》	名詞
＠じげんをあげたしゅくが	《次元を挙げた祝賀》	名詞
＠じ	《次元間の標》	名詞
＠じげ	《次元間の標》	名詞
＠じげん	《次元間の標》	名詞
＠じげんか	《次元間の標》	名詞
＠じげんかん	《次元間の標》	名詞
＠じげんかんの	《次元間の標》	名詞
＠じげんかんのし	《次元間の標》	名詞
＠じげんかんのしめ	《次元間の標》	名詞
＠し	《死の芽吹き》	名詞
＠しの	《死の芽吹き》	名詞
＠しのめ	《死の芽吹き》	名詞
＠しのめぶ	《死の芽吹き》	名詞
＠しのめぶき	《死の芽吹き》	名詞
＠し	《死者の災厄、ケイヤ》	名詞
＠しし	《死者の災厄、ケイヤ》	名詞
＠ししゃ	《死者の災厄、ケイヤ》	名詞
＠ししゃの	《死者の災厄、ケイヤ》	名詞
＠ししゃのさ	《死者の災厄、ケイヤ》	名詞
＠ししゃのさい	《死者の災厄、ケイヤ》	名詞
＠ししゃのさいや	《死者の災厄、ケイヤ》	名詞
＠ししゃのさいやく	《死者の災厄、ケイヤ》	名詞
＠ししゃのさいやく、	《死者の災厄、ケイヤ》	名詞
＠ししゃのさいやく、け	《死者の災厄、ケイヤ》	名詞
＠ししゃのさいやく、けい	《死者の災厄、ケイヤ》	名詞
＠ししゃのさいやく、けいや	《死者の災厄、ケイヤ》	名詞
＠ざ	《残酷な祝賀者》	名詞
＠ざん	《残酷な祝賀者》	名詞
＠ざんこ	《残酷な祝賀者》	名詞
＠ざんこく	《残酷な祝賀者》	名詞
＠ざんこくな	《残酷な祝賀者》	名詞
＠ざんこくなし	《残酷な祝賀者》	名詞
＠ざんこくなしゅ	《残酷な祝賀者》	名詞
＠ざんこくなしゅく	《残酷な祝賀者》	名詞
＠ざんこくなしゅくが	《残酷な祝賀者》	名詞
＠ざんこくなしゅくがし	《残酷な祝賀者》	名詞
＠ざんこくなしゅくがしゃ	《残酷な祝賀者》	名詞
＠え	《永遠の終焉》	名詞
＠えい	《永遠の終焉》	名詞
＠えいえ	《永遠の終焉》	名詞
＠えいえん	《永遠の終焉》	名詞
＠えいえんの	《永遠の終焉》	名詞
＠えいえんのし	《永遠の終焉》	名詞
＠えいえんのしゅ	《永遠の終焉》	名詞
＠えいえんのしゅう	《永遠の終焉》	名詞
＠えいえんのしゅうえ	《永遠の終焉》	名詞
＠えいえんのしゅうえん	《永遠の終焉》	名詞
＠え	《永遠神の投入》	名詞
＠えい	《永遠神の投入》	名詞
＠えいえ	《永遠神の投入》	名詞
＠えいえん	《永遠神の投入》	名詞
＠えいえんか	《永遠神の投入》	名詞
＠えいえんかみ	《永遠神の投入》	名詞
＠えいえんかみの	《永遠神の投入》	名詞
＠えいえんかみのと	《永遠神の投入》	名詞
＠えいえんかみのとう	《永遠神の投入》	名詞
＠えいえんかみのとうに	《永遠神の投入》	名詞
＠えいえんかみのとうにゅ	《永遠神の投入》	名詞
＠えいえんかみのとうにゅう	《永遠神の投入》	名詞
＠え	《永遠神オケチラ》	名詞
＠えい	《永遠神オケチラ》	名詞
＠えいえ	《永遠神オケチラ》	名詞
＠えいえん	《永遠神オケチラ》	名詞
＠えいえんか	《永遠神オケチラ》	名詞
＠えいえんかみ	《永遠神オケチラ》	名詞
＠えいえんかみお	《永遠神オケチラ》	名詞
＠えいえんかみおけ	《永遠神オケチラ》	名詞
＠えいえんかみおけち	《永遠神オケチラ》	名詞
＠えいえんかみおけちら	《永遠神オケチラ》	名詞
＠え	《永遠神ケフネト》	名詞
＠えい	《永遠神ケフネト》	名詞
＠えいえ	《永遠神ケフネト》	名詞
＠えいえん	《永遠神ケフネト》	名詞
＠えいえんか	《永遠神ケフネト》	名詞
＠えいえんかみ	《永遠神ケフネト》	名詞
＠えいえんかみけ	《永遠神ケフネト》	名詞
＠えいえんかみけふ	《永遠神ケフネト》	名詞
＠えいえんかみけふね	《永遠神ケフネト》	名詞
＠えいえんかみけふねと	《永遠神ケフネト》	名詞
＠え	《永遠神バントゥ》	名詞
＠えい	《永遠神バントゥ》	名詞
＠えいえ	《永遠神バントゥ》	名詞
＠えいえん	《永遠神バントゥ》	名詞
＠えいえんか	《永遠神バントゥ》	名詞
＠えいえんかみ	《永遠神バントゥ》	名詞
＠えいえんかみば	《永遠神バントゥ》	名詞
＠えいえんかみばん	《永遠神バントゥ》	名詞
＠えいえんかみばんと	《永遠神バントゥ》	名詞
＠えいえんかみばんとぅ	《永遠神バントゥ》	名詞
＠え	《永遠神ロナス》	名詞
＠えい	《永遠神ロナス》	名詞
＠えいえ	《永遠神ロナス》	名詞
＠えいえん	《永遠神ロナス》	名詞
＠えいえんか	《永遠神ロナス》	名詞
＠えいえんかみ	《永遠神ロナス》	名詞
＠えいえんかみろ	《永遠神ロナス》	名詞
＠えいえんかみろな	《永遠神ロナス》	名詞
＠えいえんかみろなす	《永遠神ロナス》	名詞
＠え	《永遠衆の天空王》	名詞
＠えい	《永遠衆の天空王》	名詞
＠えいえ	《永遠衆の天空王》	名詞
＠えいえん	《永遠衆の天空王》	名詞
＠えいえんし	《永遠衆の天空王》	名詞
＠えいえんしゅ	《永遠衆の天空王》	名詞
＠えいえんしゅう	《永遠衆の天空王》	名詞
＠えいえんしゅうの	《永遠衆の天空王》	名詞
＠えいえんしゅうのて	《永遠衆の天空王》	名詞
＠えいえんしゅうのてん	《永遠衆の天空王》	名詞
＠えいえんしゅうのてんく	《永遠衆の天空王》	名詞
＠えいえんしゅうのてんくう	《永遠衆の天空王》	名詞
＠えいえんしゅうのてんくうお	《永遠衆の天空王》	名詞
＠えいえんしゅうのてんくうおう	《永遠衆の天空王》	名詞
＠え	《永遠衆の監督官》	名詞
＠えい	《永遠衆の監督官》	名詞
＠えいえ	《永遠衆の監督官》	名詞
＠えいえん	《永遠衆の監督官》	名詞
＠えいえんし	《永遠衆の監督官》	名詞
＠えいえんしゅ	《永遠衆の監督官》	名詞
＠えいえんしゅう	《永遠衆の監督官》	名詞
＠えいえんしゅうの	《永遠衆の監督官》	名詞
＠えいえんしゅうのか	《永遠衆の監督官》	名詞
＠えいえんしゅうのかん	《永遠衆の監督官》	名詞
＠えいえんしゅうのかんと	《永遠衆の監督官》	名詞
＠えいえんしゅうのかんとく	《永遠衆の監督官》	名詞
＠えいえんしゅうのかんとくか	《永遠衆の監督官》	名詞
＠えいえんしゅうのかんとくかん	《永遠衆の監督官》	名詞
＠ぬ	《沼》	名詞
＠ぬま	《沼》	名詞
＠ほ	《法ルーンの執行官》	名詞
＠ほう	《法ルーンの執行官》	名詞
＠ほうる	《法ルーンの執行官》	名詞
＠ほうるー	《法ルーンの執行官》	名詞
＠ほうるーん	《法ルーンの執行官》	名詞
＠ほうるーんの	《法ルーンの執行官》	名詞
＠ほうるーんのし	《法ルーンの執行官》	名詞
＠ほうるーんのしっ	《法ルーンの執行官》	名詞
＠ほうるーんのしっこ	《法ルーンの執行官》	名詞
＠ほうるーんのしっこう	《法ルーンの執行官》	名詞
＠ほうるーんのしっこうか	《法ルーンの執行官》	名詞
＠ほうるーんのしっこうかん	《法ルーンの執行官》	名詞
＠は	《波乱の悪魔》	名詞
＠はら	《波乱の悪魔》	名詞
＠はらん	《波乱の悪魔》	名詞
＠はらんの	《波乱の悪魔》	名詞
＠はらんのあ	《波乱の悪魔》	名詞
＠はらんのあく	《波乱の悪魔》	名詞
＠はらんのあくま	《波乱の悪魔》	名詞
＠ど	《洞察の絆》	名詞
＠どう	《洞察の絆》	名詞
＠どうさ	《洞察の絆》	名詞
＠どうさつ	《洞察の絆》	名詞
＠どうさつの	《洞察の絆》	名詞
＠どうさつのき	《洞察の絆》	名詞
＠どうさつのきず	《洞察の絆》	名詞
＠どうさつのきずな	《洞察の絆》	名詞
＠な	《流束の媒介者》	名詞
＠なが	《流束の媒介者》	名詞
＠ながれ	《流束の媒介者》	名詞
＠ながれた	《流束の媒介者》	名詞
＠ながれたば	《流束の媒介者》	名詞
＠ながれたばの	《流束の媒介者》	名詞
＠ながれたばのば	《流束の媒介者》	名詞
＠ながれたばのばい	《流束の媒介者》	名詞
＠ながれたばのばいか	《流束の媒介者》	名詞
＠ながれたばのばいかい	《流束の媒介者》	名詞
＠ながれたばのばいかいし	《流束の媒介者》	名詞
＠ながれたばのばいかいしゃ	《流束の媒介者》	名詞
＠こ	《混沌の船長、アングラス》	名詞
＠こん	《混沌の船長、アングラス》	名詞
＠こんと	《混沌の船長、アングラス》	名詞
＠こんとん	《混沌の船長、アングラス》	名詞
＠こんとんの	《混沌の船長、アングラス》	名詞
＠こんとんのせ	《混沌の船長、アングラス》	名詞
＠こんとんのせん	《混沌の船長、アングラス》	名詞
＠こんとんのせんち	《混沌の船長、アングラス》	名詞
＠こんとんのせんちょ	《混沌の船長、アングラス》	名詞
＠こんとんのせんちょう	《混沌の船長、アングラス》	名詞
＠こんとんのせんちょう、	《混沌の船長、アングラス》	名詞
＠こんとんのせんちょう、あ	《混沌の船長、アングラス》	名詞
＠こんとんのせんちょう、あん	《混沌の船長、アングラス》	名詞
＠こんとんのせんちょう、あんぐ	《混沌の船長、アングラス》	名詞
＠こんとんのせんちょう、あんぐら	《混沌の船長、アングラス》	名詞
＠こんとんのせんちょう、あんぐらす	《混沌の船長、アングラス》	名詞
＠ま	《混種の頂点、ロアレスク》	名詞
＠まじ	《混種の頂点、ロアレスク》	名詞
＠まじり	《混種の頂点、ロアレスク》	名詞
＠まじりた	《混種の頂点、ロアレスク》	名詞
＠まじりたね	《混種の頂点、ロアレスク》	名詞
＠まじりたねの	《混種の頂点、ロアレスク》	名詞
＠まじりたねのち	《混種の頂点、ロアレスク》	名詞
＠まじりたねのちょ	《混種の頂点、ロアレスク》	名詞
＠まじりたねのちょう	《混種の頂点、ロアレスク》	名詞
＠まじりたねのちょうて	《混種の頂点、ロアレスク》	名詞
＠まじりたねのちょうてん	《混種の頂点、ロアレスク》	名詞
＠まじりたねのちょうてん、	《混種の頂点、ロアレスク》	名詞
＠まじりたねのちょうてん、ろ	《混種の頂点、ロアレスク》	名詞
＠まじりたねのちょうてん、ろあ	《混種の頂点、ロアレスク》	名詞
＠まじりたねのちょうてん、ろあれ	《混種の頂点、ロアレスク》	名詞
＠まじりたねのちょうてん、ろあれす	《混種の頂点、ロアレスク》	名詞
＠まじりたねのちょうてん、ろあれすく	《混種の頂点、ロアレスク》	名詞
＠げ	《激情の絆》	名詞
＠げき	《激情の絆》	名詞
＠げきじ	《激情の絆》	名詞
＠げきじょ	《激情の絆》	名詞
＠げきじょう	《激情の絆》	名詞
＠げきじょうの	《激情の絆》	名詞
＠げきじょうのき	《激情の絆》	名詞
＠げきじょうのきず	《激情の絆》	名詞
＠げきじょうのきずな	《激情の絆》	名詞
＠せ	《瀬戸際の勇気》	名詞
＠せと	《瀬戸際の勇気》	名詞
＠せとぎ	《瀬戸際の勇気》	名詞
＠せとぎわ	《瀬戸際の勇気》	名詞
＠せとぎわの	《瀬戸際の勇気》	名詞
＠せとぎわのゆ	《瀬戸際の勇気》	名詞
＠せとぎわのゆう	《瀬戸際の勇気》	名詞
＠せとぎわのゆうき	《瀬戸際の勇気》	名詞
＠ひ	《火想者の器》	名詞
＠ひそ	《火想者の器》	名詞
＠ひそう	《火想者の器》	名詞
＠ひそうし	《火想者の器》	名詞
＠ひそうしゃ	《火想者の器》	名詞
＠ひそうしゃの	《火想者の器》	名詞
＠ひそうしゃのう	《火想者の器》	名詞
＠ひそうしゃのうつ	《火想者の器》	名詞
＠ひそうしゃのうつわ	《火想者の器》	名詞
＠と	《灯の分身》	名詞
＠とう	《灯の分身》	名詞
＠とうの	《灯の分身》	名詞
＠とうのぶ	《灯の分身》	名詞
＠とうのぶん	《灯の分身》	名詞
＠とうのぶんし	《灯の分身》	名詞
＠とうのぶんしん	《灯の分身》	名詞
＠と	《灯の収穫》	名詞
＠とう	《灯の収穫》	名詞
＠とうの	《灯の収穫》	名詞
＠とうのし	《灯の収穫》	名詞
＠とうのしゅ	《灯の収穫》	名詞
＠とうのしゅう	《灯の収穫》	名詞
＠とうのしゅうか	《灯の収穫》	名詞
＠とうのしゅうかく	《灯の収穫》	名詞
＠と	《灯の燼滅》	名詞
＠とう	《灯の燼滅》	名詞
＠とうの	《灯の燼滅》	名詞
＠とうのほ	《灯の燼滅》	名詞
＠とうのほそ	《灯の燼滅》	名詞
＠とうのほそく	《灯の燼滅》	名詞
＠とうのほそくず	《灯の燼滅》	名詞
＠とうのほそくずめ	《灯の燼滅》	名詞
＠とうのほそくずめつ	《灯の燼滅》	名詞
＠と	《灯を刈り取る者》	名詞
＠とう	《灯を刈り取る者》	名詞
＠とうを	《灯を刈り取る者》	名詞
＠とうをか	《灯を刈り取る者》	名詞
＠とうをかり	《灯を刈り取る者》	名詞
＠とうをかりと	《灯を刈り取る者》	名詞
＠とうをかりとる	《灯を刈り取る者》	名詞
＠とうをかりとるも	《灯を刈り取る者》	名詞
＠とうをかりとるもの	《灯を刈り取る者》	名詞
＠え	《炎の職工、チャンドラ》	名詞
＠えん	《炎の職工、チャンドラ》	名詞
＠えんの	《炎の職工、チャンドラ》	名詞
＠えんのし	《炎の職工、チャンドラ》	名詞
＠えんのしょ	《炎の職工、チャンドラ》	名詞
＠えんのしょっ	《炎の職工、チャンドラ》	名詞
＠えんのしょっこ	《炎の職工、チャンドラ》	名詞
＠えんのしょっこう	《炎の職工、チャンドラ》	名詞
＠えんのしょっこう、	《炎の職工、チャンドラ》	名詞
＠えんのしょっこう、ち	《炎の職工、チャンドラ》	名詞
＠えんのしょっこう、ちゃ	《炎の職工、チャンドラ》	名詞
＠えんのしょっこう、ちゃん	《炎の職工、チャンドラ》	名詞
＠えんのしょっこう、ちゃんど	《炎の職工、チャンドラ》	名詞
＠えんのしょっこう、ちゃんどら	《炎の職工、チャンドラ》	名詞
＠む	《無情な前進》	名詞
＠むじ	《無情な前進》	名詞
＠むじょ	《無情な前進》	名詞
＠むじょう	《無情な前進》	名詞
＠むじょうな	《無情な前進》	名詞
＠むじょうなぜ	《無情な前進》	名詞
＠むじょうなぜん	《無情な前進》	名詞
＠むじょうなぜんし	《無情な前進》	名詞
＠むじょうなぜんしん	《無情な前進》	名詞
＠む	《無神経な放逐》	名詞
＠むし	《無神経な放逐》	名詞
＠むしん	《無神経な放逐》	名詞
＠むしんけ	《無神経な放逐》	名詞
＠むしんけい	《無神経な放逐》	名詞
＠むしんけいな	《無神経な放逐》	名詞
＠むしんけいなほ	《無神経な放逐》	名詞
＠むしんけいなほう	《無神経な放逐》	名詞
＠むしんけいなほうち	《無神経な放逐》	名詞
＠むしんけいなほうちく	《無神経な放逐》	名詞
＠ぶ	《無頼な扇動者、ティボルト》	名詞
＠ぶら	《無頼な扇動者、ティボルト》	名詞
＠ぶらい	《無頼な扇動者、ティボルト》	名詞
＠ぶらいな	《無頼な扇動者、ティボルト》	名詞
＠ぶらいなせ	《無頼な扇動者、ティボルト》	名詞
＠ぶらいなせん	《無頼な扇動者、ティボルト》	名詞
＠ぶらいなせんど	《無頼な扇動者、ティボルト》	名詞
＠ぶらいなせんどう	《無頼な扇動者、ティボルト》	名詞
＠ぶらいなせんどうし	《無頼な扇動者、ティボルト》	名詞
＠ぶらいなせんどうしゃ	《無頼な扇動者、ティボルト》	名詞
＠ぶらいなせんどうしゃ、	《無頼な扇動者、ティボルト》	名詞
＠ぶらいなせんどうしゃ、て	《無頼な扇動者、ティボルト》	名詞
＠ぶらいなせんどうしゃ、てぃ	《無頼な扇動者、ティボルト》	名詞
＠ぶらいなせんどうしゃ、てぃぼ	《無頼な扇動者、ティボルト》	名詞
＠ぶらいなせんどうしゃ、てぃぼる	《無頼な扇動者、ティボルト》	名詞
＠ぶらいなせんどうしゃ、てぃぼると	《無頼な扇動者、ティボルト》	名詞
＠き	《煌めく監視者》	名詞
＠きら	《煌めく監視者》	名詞
＠きらめ	《煌めく監視者》	名詞
＠きらめく	《煌めく監視者》	名詞
＠きらめくか	《煌めく監視者》	名詞
＠きらめくかん	《煌めく監視者》	名詞
＠きらめくかんし	《煌めく監視者》	名詞
＠きらめくかんしし	《煌めく監視者》	名詞
＠きらめくかんししゃ	《煌めく監視者》	名詞
＠も	《燃え立つ預言者》	名詞
＠もえ	《燃え立つ預言者》	名詞
＠もえた	《燃え立つ預言者》	名詞
＠もえたつ	《燃え立つ預言者》	名詞
＠もえたつよ	《燃え立つ預言者》	名詞
＠もえたつよげ	《燃え立つ預言者》	名詞
＠もえたつよげん	《燃え立つ預言者》	名詞
＠もえたつよげんし	《燃え立つ預言者》	名詞
＠もえたつよげんしゃ	《燃え立つ預言者》	名詞
＠ば	《爆発域》	名詞
＠ばく	《爆発域》	名詞
＠ばくは	《爆発域》	名詞
＠ばくはつ	《爆発域》	名詞
＠ばくはつい	《爆発域》	名詞
＠ばくはついき	《爆発域》	名詞
＠ろ	《牢獄領域》	名詞
＠ろう	《牢獄領域》	名詞
＠ろうご	《牢獄領域》	名詞
＠ろうごく	《牢獄領域》	名詞
＠ろうごくり	《牢獄領域》	名詞
＠ろうごくりょ	《牢獄領域》	名詞
＠ろうごくりょう	《牢獄領域》	名詞
＠ろうごくりょうい	《牢獄領域》	名詞
＠ろうごくりょういき	《牢獄領域》	名詞
＠お	《狼の友、トルシミール》	名詞
＠おお	《狼の友、トルシミール》	名詞
＠おおか	《狼の友、トルシミール》	名詞
＠おおかみ	《狼の友、トルシミール》	名詞
＠おおかみの	《狼の友、トルシミール》	名詞
＠おおかみのと	《狼の友、トルシミール》	名詞
＠おおかみのとも	《狼の友、トルシミール》	名詞
＠おおかみのとも、	《狼の友、トルシミール》	名詞
＠おおかみのとも、と	《狼の友、トルシミール》	名詞
＠おおかみのとも、とる	《狼の友、トルシミール》	名詞
＠おおかみのとも、とるし	《狼の友、トルシミール》	名詞
＠おおかみのとも、とるしみ	《狼の友、トルシミール》	名詞
＠おおかみのとも、とるしみー	《狼の友、トルシミール》	名詞
＠おおかみのとも、とるしみーる	《狼の友、トルシミール》	名詞
＠の	《狼煙上げ》	名詞
＠のろ	《狼煙上げ》	名詞
＠のろし	《狼煙上げ》	名詞
＠のろしあ	《狼煙上げ》	名詞
＠のろしあげ	《狼煙上げ》	名詞
＠い	《猪の祟神、イルハグ》	名詞
＠いの	《猪の祟神、イルハグ》	名詞
＠いのし	《猪の祟神、イルハグ》	名詞
＠いのしし	《猪の祟神、イルハグ》	名詞
＠いのししの	《猪の祟神、イルハグ》	名詞
＠いのししのた	《猪の祟神、イルハグ》	名詞
＠いのししのたた	《猪の祟神、イルハグ》	名詞
＠いのししのたたり	《猪の祟神、イルハグ》	名詞
＠いのししのたたりか	《猪の祟神、イルハグ》	名詞
＠いのししのたたりかみ	《猪の祟神、イルハグ》	名詞
＠いのししのたたりかみ、	《猪の祟神、イルハグ》	名詞
＠いのししのたたりかみ、い	《猪の祟神、イルハグ》	名詞
＠いのししのたたりかみ、いる	《猪の祟神、イルハグ》	名詞
＠いのししのたたりかみ、いるは	《猪の祟神、イルハグ》	名詞
＠いのししのたたりかみ、いるはぐ	《猪の祟神、イルハグ》	名詞
＠お	《王神の立像》	名詞
＠おう	《王神の立像》	名詞
＠おうか	《王神の立像》	名詞
＠おうかみ	《王神の立像》	名詞
＠おうかみの	《王神の立像》	名詞
＠おうかみのり	《王神の立像》	名詞
＠おうかみのりつ	《王神の立像》	名詞
＠おうかみのりつぞ	《王神の立像》	名詞
＠おうかみのりつぞう	《王神の立像》	名詞
＠お	《王神への敬意》	名詞
＠おう	《王神への敬意》	名詞
＠おうか	《王神への敬意》	名詞
＠おうかみ	《王神への敬意》	名詞
＠おうかみへ	《王神への敬意》	名詞
＠おうかみへの	《王神への敬意》	名詞
＠おうかみへのけ	《王神への敬意》	名詞
＠おうかみへのけい	《王神への敬意》	名詞
＠おうかみへのけいい	《王神への敬意》	名詞
＠が	《瓦礫帯の暴動者》	名詞
＠がれ	《瓦礫帯の暴動者》	名詞
＠がれき	《瓦礫帯の暴動者》	名詞
＠がれきお	《瓦礫帯の暴動者》	名詞
＠がれきおび	《瓦礫帯の暴動者》	名詞
＠がれきおびの	《瓦礫帯の暴動者》	名詞
＠がれきおびのぼ	《瓦礫帯の暴動者》	名詞
＠がれきおびのぼう	《瓦礫帯の暴動者》	名詞
＠がれきおびのぼうど	《瓦礫帯の暴動者》	名詞
＠がれきおびのぼうどう	《瓦礫帯の暴動者》	名詞
＠がれきおびのぼうどうし	《瓦礫帯の暴動者》	名詞
＠がれきおびのぼうどうしゃ	《瓦礫帯の暴動者》	名詞
＠い	《生ける竜巻》	名詞
＠いけ	《生ける竜巻》	名詞
＠いける	《生ける竜巻》	名詞
＠いけるた	《生ける竜巻》	名詞
＠いけるたつ	《生ける竜巻》	名詞
＠いけるたつま	《生ける竜巻》	名詞
＠いけるたつまき	《生ける竜巻》	名詞
＠せ	《生命素ハイドラ》	名詞
＠せい	《生命素ハイドラ》	名詞
＠せいめ	《生命素ハイドラ》	名詞
＠せいめい	《生命素ハイドラ》	名詞
＠せいめいも	《生命素ハイドラ》	名詞
＠せいめいもと	《生命素ハイドラ》	名詞
＠せいめいもとは	《生命素ハイドラ》	名詞
＠せいめいもとはい	《生命素ハイドラ》	名詞
＠せいめいもとはいど	《生命素ハイドラ》	名詞
＠せいめいもとはいどら	《生命素ハイドラ》	名詞
＠も	《目的のための殉教者》	名詞
＠もく	《目的のための殉教者》	名詞
＠もくて	《目的のための殉教者》	名詞
＠もくてき	《目的のための殉教者》	名詞
＠もくてきの	《目的のための殉教者》	名詞
＠もくてきのた	《目的のための殉教者》	名詞
＠もくてきのため	《目的のための殉教者》	名詞
＠もくてきのための	《目的のための殉教者》	名詞
＠もくてきのためのじ	《目的のための殉教者》	名詞
＠もくてきのためのじゅ	《目的のための殉教者》	名詞
＠もくてきのためのじゅん	《目的のための殉教者》	名詞
＠もくてきのためのじゅんき	《目的のための殉教者》	名詞
＠もくてきのためのじゅんきょ	《目的のための殉教者》	名詞
＠もくてきのためのじゅんきょう	《目的のための殉教者》	名詞
＠もくてきのためのじゅんきょうし	《目的のための殉教者》	名詞
＠もくてきのためのじゅんきょうしゃ	《目的のための殉教者》	名詞
＠だ	《盾魔道士、テヨ》	名詞
＠だて	《盾魔道士、テヨ》	名詞
＠だてま	《盾魔道士、テヨ》	名詞
＠だてまど	《盾魔道士、テヨ》	名詞
＠だてまどう	《盾魔道士、テヨ》	名詞
＠だてまどうし	《盾魔道士、テヨ》	名詞
＠だてまどうし、	《盾魔道士、テヨ》	名詞
＠だてまどうし、て	《盾魔道士、テヨ》	名詞
＠だてまどうし、てよ	《盾魔道士、テヨ》	名詞
＠げ	《眩光破》	名詞
＠げん	《眩光破》	名詞
＠げんひ	《眩光破》	名詞
＠げんひか	《眩光破》	名詞
＠げんひかり	《眩光破》	名詞
＠げんひかりは	《眩光破》	名詞
＠い	《石の嵐、ナヒリ》	名詞
＠いし	《石の嵐、ナヒリ》	名詞
＠いしの	《石の嵐、ナヒリ》	名詞
＠いしのあ	《石の嵐、ナヒリ》	名詞
＠いしのあら	《石の嵐、ナヒリ》	名詞
＠いしのあらし	《石の嵐、ナヒリ》	名詞
＠いしのあらし、	《石の嵐、ナヒリ》	名詞
＠いしのあらし、な	《石の嵐、ナヒリ》	名詞
＠いしのあらし、なひ	《石の嵐、ナヒリ》	名詞
＠いしのあらし、なひり	《石の嵐、ナヒリ》	名詞
＠ほ	《砲塔のオーガ》	名詞
＠ほう	《砲塔のオーガ》	名詞
＠ほうと	《砲塔のオーガ》	名詞
＠ほうとう	《砲塔のオーガ》	名詞
＠ほうとうの	《砲塔のオーガ》	名詞
＠ほうとうのお	《砲塔のオーガ》	名詞
＠ほうとうのおー	《砲塔のオーガ》	名詞
＠ほうとうのおーが	《砲塔のオーガ》	名詞
＠は	《破滅の終焉》	名詞
＠はめ	《破滅の終焉》	名詞
＠はめつ	《破滅の終焉》	名詞
＠はめつの	《破滅の終焉》	名詞
＠はめつのし	《破滅の終焉》	名詞
＠はめつのしゅ	《破滅の終焉》	名詞
＠はめつのしゅう	《破滅の終焉》	名詞
＠はめつのしゅうえ	《破滅の終焉》	名詞
＠はめつのしゅうえん	《破滅の終焉》	名詞
＠は	《破滅犬》	名詞
＠はめ	《破滅犬》	名詞
＠はめつ	《破滅犬》	名詞
＠はめつい	《破滅犬》	名詞
＠はめついぬ	《破滅犬》	名詞
＠は	《破砕》	名詞
＠はさ	《破砕》	名詞
＠はさい	《破砕》	名詞
＠し	《神秘を操る者、ジェイス》	名詞
＠しん	《神秘を操る者、ジェイス》	名詞
＠しんぴ	《神秘を操る者、ジェイス》	名詞
＠しんぴを	《神秘を操る者、ジェイス》	名詞
＠しんぴをあ	《神秘を操る者、ジェイス》	名詞
＠しんぴをあや	《神秘を操る者、ジェイス》	名詞
＠しんぴをあやつ	《神秘を操る者、ジェイス》	名詞
＠しんぴをあやつる	《神秘を操る者、ジェイス》	名詞
＠しんぴをあやつるも	《神秘を操る者、ジェイス》	名詞
＠しんぴをあやつるもの	《神秘を操る者、ジェイス》	名詞
＠しんぴをあやつるもの、	《神秘を操る者、ジェイス》	名詞
＠しんぴをあやつるもの、じ	《神秘を操る者、ジェイス》	名詞
＠しんぴをあやつるもの、じぇ	《神秘を操る者、ジェイス》	名詞
＠しんぴをあやつるもの、じぇい	《神秘を操る者、ジェイス》	名詞
＠しんぴをあやつるもの、じぇいす	《神秘を操る者、ジェイス》	名詞
＠し	《神聖なる矢》	名詞
＠しん	《神聖なる矢》	名詞
＠しんせ	《神聖なる矢》	名詞
＠しんせい	《神聖なる矢》	名詞
＠しんせいな	《神聖なる矢》	名詞
＠しんせいなる	《神聖なる矢》	名詞
＠しんせいなるや	《神聖なる矢》	名詞
＠ひ	《秘儀の策士、ジェイス》	名詞
＠ひぎ	《秘儀の策士、ジェイス》	名詞
＠ひぎの	《秘儀の策士、ジェイス》	名詞
＠ひぎのさ	《秘儀の策士、ジェイス》	名詞
＠ひぎのさく	《秘儀の策士、ジェイス》	名詞
＠ひぎのさくし	《秘儀の策士、ジェイス》	名詞
＠ひぎのさくし、	《秘儀の策士、ジェイス》	名詞
＠ひぎのさくし、じ	《秘儀の策士、ジェイス》	名詞
＠ひぎのさくし、じぇ	《秘儀の策士、ジェイス》	名詞
＠ひぎのさくし、じぇい	《秘儀の策士、ジェイス》	名詞
＠ひぎのさくし、じぇいす	《秘儀の策士、ジェイス》	名詞
＠ぜ	《税収運びの巨人》	名詞
＠ぜい	《税収運びの巨人》	名詞
＠ぜいし	《税収運びの巨人》	名詞
＠ぜいしゅ	《税収運びの巨人》	名詞
＠ぜいしゅう	《税収運びの巨人》	名詞
＠ぜいしゅうは	《税収運びの巨人》	名詞
＠ぜいしゅうはこ	《税収運びの巨人》	名詞
＠ぜいしゅうはこび	《税収運びの巨人》	名詞
＠ぜいしゅうはこびの	《税収運びの巨人》	名詞
＠ぜいしゅうはこびのき	《税収運びの巨人》	名詞
＠ぜいしゅうはこびのきょ	《税収運びの巨人》	名詞
＠ぜいしゅうはこびのきょじ	《税収運びの巨人》	名詞
＠ぜいしゅうはこびのきょじん	《税収運びの巨人》	名詞
＠い	《稲妻曲げ》	名詞
＠いな	《稲妻曲げ》	名詞
＠いなず	《稲妻曲げ》	名詞
＠いなずま	《稲妻曲げ》	名詞
＠いなずまま	《稲妻曲げ》	名詞
＠いなずままげ	《稲妻曲げ》	名詞
＠そ	《空戦域の大梟》	名詞
＠そら	《空戦域の大梟》	名詞
＠そらせ	《空戦域の大梟》	名詞
＠そらせん	《空戦域の大梟》	名詞
＠そらせんい	《空戦域の大梟》	名詞
＠そらせんいき	《空戦域の大梟》	名詞
＠そらせんいきの	《空戦域の大梟》	名詞
＠そらせんいきのだ	《空戦域の大梟》	名詞
＠そらせんいきのだい	《空戦域の大梟》	名詞
＠そらせんいきのだいふ	《空戦域の大梟》	名詞
＠そらせんいきのだいふく	《空戦域の大梟》	名詞
＠そらせんいきのだいふくろ	《空戦域の大梟》	名詞
＠そらせんいきのだいふくろう	《空戦域の大梟》	名詞
＠と	《突飛な幻想家》	名詞
＠とっ	《突飛な幻想家》	名詞
＠とっぴ	《突飛な幻想家》	名詞
＠とっぴな	《突飛な幻想家》	名詞
＠とっぴなげ	《突飛な幻想家》	名詞
＠とっぴなげん	《突飛な幻想家》	名詞
＠とっぴなげんそ	《突飛な幻想家》	名詞
＠とっぴなげんそう	《突飛な幻想家》	名詞
＠とっぴなげんそうい	《突飛な幻想家》	名詞
＠とっぴなげんそういえ	《突飛な幻想家》	名詞
＠た	《立ち上がる民衆》	名詞
＠たち	《立ち上がる民衆》	名詞
＠たちあ	《立ち上がる民衆》	名詞
＠たちあが	《立ち上がる民衆》	名詞
＠たちあがる	《立ち上がる民衆》	名詞
＠たちあがるみ	《立ち上がる民衆》	名詞
＠たちあがるみん	《立ち上がる民衆》	名詞
＠たちあがるみんし	《立ち上がる民衆》	名詞
＠たちあがるみんしゅ	《立ち上がる民衆》	名詞
＠たちあがるみんしゅう	《立ち上がる民衆》	名詞
＠り	《立像崩し》	名詞
＠りつ	《立像崩し》	名詞
＠りつぞ	《立像崩し》	名詞
＠りつぞう	《立像崩し》	名詞
＠りつぞうく	《立像崩し》	名詞
＠りつぞうくず	《立像崩し》	名詞
＠りつぞうくずし	《立像崩し》	名詞
＠だ	《第10管区の軍団兵》	名詞
＠だい	《第10管区の軍団兵》	名詞
＠だい1	《第10管区の軍団兵》	名詞
＠だい10	《第10管区の軍団兵》	名詞
＠だい10か	《第10管区の軍団兵》	名詞
＠だい10かん	《第10管区の軍団兵》	名詞
＠だい10かんく	《第10管区の軍団兵》	名詞
＠だい10かんくの	《第10管区の軍団兵》	名詞
＠だい10かんくのぐ	《第10管区の軍団兵》	名詞
＠だい10かんくのぐん	《第10管区の軍団兵》	名詞
＠だい10かんくのぐんだ	《第10管区の軍団兵》	名詞
＠だい10かんくのぐんだん	《第10管区の軍団兵》	名詞
＠だい10かんくのぐんだんへ	《第10管区の軍団兵》	名詞
＠だい10かんくのぐんだんへい	《第10管区の軍団兵》	名詞
＠せ	《精鋭護衛魔道士》	名詞
＠せい	《精鋭護衛魔道士》	名詞
＠せいえ	《精鋭護衛魔道士》	名詞
＠せいえい	《精鋭護衛魔道士》	名詞
＠せいえいご	《精鋭護衛魔道士》	名詞
＠せいえいごえ	《精鋭護衛魔道士》	名詞
＠せいえいごえい	《精鋭護衛魔道士》	名詞
＠せいえいごえいま	《精鋭護衛魔道士》	名詞
＠せいえいごえいまど	《精鋭護衛魔道士》	名詞
＠せいえいごえいまどう	《精鋭護衛魔道士》	名詞
＠せいえいごえいまどうし	《精鋭護衛魔道士》	名詞
＠や	《約束の終焉》	名詞
＠やく	《約束の終焉》	名詞
＠やくそ	《約束の終焉》	名詞
＠やくそく	《約束の終焉》	名詞
＠やくそくの	《約束の終焉》	名詞
＠やくそくのし	《約束の終焉》	名詞
＠やくそくのしゅ	《約束の終焉》	名詞
＠やくそくのしゅう	《約束の終焉》	名詞
＠やくそくのしゅうえ	《約束の終焉》	名詞
＠やくそくのしゅうえん	《約束の終焉》	名詞
＠し	《終局の始まり》	名詞
＠しゅ	《終局の始まり》	名詞
＠しゅう	《終局の始まり》	名詞
＠しゅうき	《終局の始まり》	名詞
＠しゅうきょ	《終局の始まり》	名詞
＠しゅうきょく	《終局の始まり》	名詞
＠しゅうきょくの	《終局の始まり》	名詞
＠しゅうきょくのは	《終局の始まり》	名詞
＠しゅうきょくのはじ	《終局の始まり》	名詞
＠しゅうきょくのはじま	《終局の始まり》	名詞
＠しゅうきょくのはじまり	《終局の始まり》	名詞
＠そ	《総動員地区》	名詞
＠そう	《総動員地区》	名詞
＠そうど	《総動員地区》	名詞
＠そうどう	《総動員地区》	名詞
＠そうどうい	《総動員地区》	名詞
＠そうどういん	《総動員地区》	名詞
＠そうどういんち	《総動員地区》	名詞
＠そうどういんちく	《総動員地区》	名詞
＠は	《繁茂の絆》	名詞
＠はん	《繁茂の絆》	名詞
＠はんも	《繁茂の絆》	名詞
＠はんもの	《繁茂の絆》	名詞
＠はんものき	《繁茂の絆》	名詞
＠はんものきず	《繁茂の絆》	名詞
＠はんものきずな	《繁茂の絆》	名詞
＠わ	《罠紡ぎ》	名詞
＠わな	《罠紡ぎ》	名詞
＠わなつ	《罠紡ぎ》	名詞
＠わなつむ	《罠紡ぎ》	名詞
＠わなつむぎ	《罠紡ぎ》	名詞
＠む	《群れの声、アーリン》	名詞
＠むれ	《群れの声、アーリン》	名詞
＠むれの	《群れの声、アーリン》	名詞
＠むれのこ	《群れの声、アーリン》	名詞
＠むれのこえ	《群れの声、アーリン》	名詞
＠むれのこえ、	《群れの声、アーリン》	名詞
＠むれのこえ、あ	《群れの声、アーリン》	名詞
＠むれのこえ、あー	《群れの声、アーリン》	名詞
＠むれのこえ、あーり	《群れの声、アーリン》	名詞
＠むれのこえ、あーりん	《群れの声、アーリン》	名詞
＠ぐ	《群集の威光、ヴラスカ》	名詞
＠ぐん	《群集の威光、ヴラスカ》	名詞
＠ぐんし	《群集の威光、ヴラスカ》	名詞
＠ぐんしゅ	《群集の威光、ヴラスカ》	名詞
＠ぐんしゅう	《群集の威光、ヴラスカ》	名詞
＠ぐんしゅうの	《群集の威光、ヴラスカ》	名詞
＠ぐんしゅうのい	《群集の威光、ヴラスカ》	名詞
＠ぐんしゅうのいこ	《群集の威光、ヴラスカ》	名詞
＠ぐんしゅうのいこう	《群集の威光、ヴラスカ》	名詞
＠ぐんしゅうのいこう、	《群集の威光、ヴラスカ》	名詞
＠ぐんしゅうのいこう、ヴ	《群集の威光、ヴラスカ》	名詞
＠ぐんしゅうのいこう、ヴら	《群集の威光、ヴラスカ》	名詞
＠ぐんしゅうのいこう、ヴらす	《群集の威光、ヴラスカ》	名詞
＠ぐんしゅうのいこう、ヴらすか	《群集の威光、ヴラスカ》	名詞
＠つ	《翼の結集》	名詞
＠つば	《翼の結集》	名詞
＠つばさ	《翼の結集》	名詞
＠つばさの	《翼の結集》	名詞
＠つばさのけ	《翼の結集》	名詞
＠つばさのけっ	《翼の結集》	名詞
＠つばさのけっし	《翼の結集》	名詞
＠つばさのけっしゅ	《翼の結集》	名詞
＠つばさのけっしゅう	《翼の結集》	名詞
＠し	《自然への回帰》	名詞
＠しぜ	《自然への回帰》	名詞
＠しぜん	《自然への回帰》	名詞
＠しぜんへ	《自然への回帰》	名詞
＠しぜんへの	《自然への回帰》	名詞
＠しぜんへのか	《自然への回帰》	名詞
＠しぜんへのかい	《自然への回帰》	名詞
＠しぜんへのかいき	《自然への回帰》	名詞
＠か	《花粉光のドルイド》	名詞
＠かふ	《花粉光のドルイド》	名詞
＠かふん	《花粉光のドルイド》	名詞
＠かふんひ	《花粉光のドルイド》	名詞
＠かふんひか	《花粉光のドルイド》	名詞
＠かふんひかり	《花粉光のドルイド》	名詞
＠かふんひかりの	《花粉光のドルイド》	名詞
＠かふんひかりのど	《花粉光のドルイド》	名詞
＠かふんひかりのどる	《花粉光のドルイド》	名詞
＠かふんひかりのどるい	《花粉光のドルイド》	名詞
＠かふんひかりのどるいど	《花粉光のドルイド》	名詞
＠ま	《蔓延する蛮行》	名詞
＠まん	《蔓延する蛮行》	名詞
＠まんえ	《蔓延する蛮行》	名詞
＠まんえん	《蔓延する蛮行》	名詞
＠まんえんす	《蔓延する蛮行》	名詞
＠まんえんする	《蔓延する蛮行》	名詞
＠まんえんするば	《蔓延する蛮行》	名詞
＠まんえんするばん	《蔓延する蛮行》	名詞
＠まんえんするばんこ	《蔓延する蛮行》	名詞
＠まんえんするばんこう	《蔓延する蛮行》	名詞
＠そ	《蘇生の絆》	名詞
＠そせ	《蘇生の絆》	名詞
＠そせい	《蘇生の絆》	名詞
＠そせいの	《蘇生の絆》	名詞
＠そせいのき	《蘇生の絆》	名詞
＠そせいのきず	《蘇生の絆》	名詞
＠そせいのきずな	《蘇生の絆》	名詞
＠ぎ	《虐殺少女》	名詞
＠ぎゃ	《虐殺少女》	名詞
＠ぎゃく	《虐殺少女》	名詞
＠ぎゃくさ	《虐殺少女》	名詞
＠ぎゃくさつ	《虐殺少女》	名詞
＠ぎゃくさつし	《虐殺少女》	名詞
＠ぎゃくさつしょ	《虐殺少女》	名詞
＠ぎゃくさつしょう	《虐殺少女》	名詞
＠ぎゃくさつしょうじ	《虐殺少女》	名詞
＠ぎゃくさつしょうじょ	《虐殺少女》	名詞
＠さ	《蠍の侍臣》	名詞
＠さそ	《蠍の侍臣》	名詞
＠さそり	《蠍の侍臣》	名詞
＠さそりの	《蠍の侍臣》	名詞
＠さそりのじ	《蠍の侍臣》	名詞
＠さそりのじし	《蠍の侍臣》	名詞
＠さそりのじしん	《蠍の侍臣》	名詞
＠う	《裏切りの対価》	名詞
＠うら	《裏切りの対価》	名詞
＠うらぎ	《裏切りの対価》	名詞
＠うらぎり	《裏切りの対価》	名詞
＠うらぎりの	《裏切りの対価》	名詞
＠うらぎりのた	《裏切りの対価》	名詞
＠うらぎりのたい	《裏切りの対価》	名詞
＠うらぎりのたいか	《裏切りの対価》	名詞
＠お	《覆いを割く者、ナーセット》	名詞
＠おお	《覆いを割く者、ナーセット》	名詞
＠おおい	《覆いを割く者、ナーセット》	名詞
＠おおいを	《覆いを割く者、ナーセット》	名詞
＠おおいをさ	《覆いを割く者、ナーセット》	名詞
＠おおいをさく	《覆いを割く者、ナーセット》	名詞
＠おおいをさくも	《覆いを割く者、ナーセット》	名詞
＠おおいをさくもの	《覆いを割く者、ナーセット》	名詞
＠おおいをさくもの、	《覆いを割く者、ナーセット》	名詞
＠おおいをさくもの、な	《覆いを割く者、ナーセット》	名詞
＠おおいをさくもの、なー	《覆いを割く者、ナーセット》	名詞
＠おおいをさくもの、なーせ	《覆いを割く者、ナーセット》	名詞
＠おおいをさくもの、なーせっ	《覆いを割く者、ナーセット》	名詞
＠おおいをさくもの、なーせっと	《覆いを割く者、ナーセット》	名詞
＠き	《規律の絆》	名詞
＠きり	《規律の絆》	名詞
＠きりつ	《規律の絆》	名詞
＠きりつの	《規律の絆》	名詞
＠きりつのき	《規律の絆》	名詞
＠きりつのきず	《規律の絆》	名詞
＠きりつのきずな	《規律の絆》	名詞
＠ち	《誓いを立てた者、ギデオン》	名詞
＠ちか	《誓いを立てた者、ギデオン》	名詞
＠ちかい	《誓いを立てた者、ギデオン》	名詞
＠ちかいを	《誓いを立てた者、ギデオン》	名詞
＠ちかいをた	《誓いを立てた者、ギデオン》	名詞
＠ちかいをたて	《誓いを立てた者、ギデオン》	名詞
＠ちかいをたてた	《誓いを立てた者、ギデオン》	名詞
＠ちかいをたてたも	《誓いを立てた者、ギデオン》	名詞
＠ちかいをたてたもの	《誓いを立てた者、ギデオン》	名詞
＠ちかいをたてたもの、	《誓いを立てた者、ギデオン》	名詞
＠ちかいをたてたもの、ぎ	《誓いを立てた者、ギデオン》	名詞
＠ちかいをたてたもの、ぎで	《誓いを立てた者、ギデオン》	名詞
＠ちかいをたてたもの、ぎでお	《誓いを立てた者、ギデオン》	名詞
＠ちかいをたてたもの、ぎでおん	《誓いを立てた者、ギデオン》	名詞
＠ろ	《論議を呼ぶ計画》	名詞
＠ろん	《論議を呼ぶ計画》	名詞
＠ろんぎ	《論議を呼ぶ計画》	名詞
＠ろんぎを	《論議を呼ぶ計画》	名詞
＠ろんぎをよ	《論議を呼ぶ計画》	名詞
＠ろんぎをよぶ	《論議を呼ぶ計画》	名詞
＠ろんぎをよぶけ	《論議を呼ぶ計画》	名詞
＠ろんぎをよぶけい	《論議を呼ぶ計画》	名詞
＠ろんぎをよぶけいか	《論議を呼ぶ計画》	名詞
＠ろんぎをよぶけいかく	《論議を呼ぶ計画》	名詞
＠な	《謎めいた指導者、カズミナ》	名詞
＠なぞ	《謎めいた指導者、カズミナ》	名詞
＠なぞめ	《謎めいた指導者、カズミナ》	名詞
＠なぞめい	《謎めいた指導者、カズミナ》	名詞
＠なぞめいた	《謎めいた指導者、カズミナ》	名詞
＠なぞめいたし	《謎めいた指導者、カズミナ》	名詞
＠なぞめいたしど	《謎めいた指導者、カズミナ》	名詞
＠なぞめいたしどう	《謎めいた指導者、カズミナ》	名詞
＠なぞめいたしどうし	《謎めいた指導者、カズミナ》	名詞
＠なぞめいたしどうしゃ	《謎めいた指導者、カズミナ》	名詞
＠なぞめいたしどうしゃ、	《謎めいた指導者、カズミナ》	名詞
＠なぞめいたしどうしゃ、か	《謎めいた指導者、カズミナ》	名詞
＠なぞめいたしどうしゃ、かず	《謎めいた指導者、カズミナ》	名詞
＠なぞめいたしどうしゃ、かずみ	《謎めいた指導者、カズミナ》	名詞
＠なぞめいたしどうしゃ、かずみな	《謎めいた指導者、カズミナ》	名詞
＠ご	《護法鱗のクロコダイル》	名詞
＠ごほ	《護法鱗のクロコダイル》	名詞
＠ごほう	《護法鱗のクロコダイル》	名詞
＠ごほうう	《護法鱗のクロコダイル》	名詞
＠ごほううろ	《護法鱗のクロコダイル》	名詞
＠ごほううろこ	《護法鱗のクロコダイル》	名詞
＠ごほううろこの	《護法鱗のクロコダイル》	名詞
＠ごほううろこのく	《護法鱗のクロコダイル》	名詞
＠ごほううろこのくろ	《護法鱗のクロコダイル》	名詞
＠ごほううろこのくろこ	《護法鱗のクロコダイル》	名詞
＠ごほううろこのくろこだ	《護法鱗のクロコダイル》	名詞
＠ごほううろこのくろこだい	《護法鱗のクロコダイル》	名詞
＠ごほううろこのくろこだいる	《護法鱗のクロコダイル》	名詞
＠ふ	《負傷者の手当て》	名詞
＠ふし	《負傷者の手当て》	名詞
＠ふしょ	《負傷者の手当て》	名詞
＠ふしょう	《負傷者の手当て》	名詞
＠ふしょうし	《負傷者の手当て》	名詞
＠ふしょうしゃ	《負傷者の手当て》	名詞
＠ふしょうしゃの	《負傷者の手当て》	名詞
＠ふしょうしゃのて	《負傷者の手当て》	名詞
＠ふしょうしゃのてあ	《負傷者の手当て》	名詞
＠ふしょうしゃのてあて	《負傷者の手当て》	名詞
＠む	《貪るヘリオン》	名詞
＠むさ	《貪るヘリオン》	名詞
＠むさぼ	《貪るヘリオン》	名詞
＠むさぼる	《貪るヘリオン》	名詞
＠むさぼるへ	《貪るヘリオン》	名詞
＠むさぼるへり	《貪るヘリオン》	名詞
＠むさぼるへりお	《貪るヘリオン》	名詞
＠むさぼるへりおん	《貪るヘリオン》	名詞
＠あ	《贖いし者、フェザー》	名詞
＠あが	《贖いし者、フェザー》	名詞
＠あがな	《贖いし者、フェザー》	名詞
＠あがない	《贖いし者、フェザー》	名詞
＠あがないし	《贖いし者、フェザー》	名詞
＠あがないしし	《贖いし者、フェザー》	名詞
＠あがないししゃ	《贖いし者、フェザー》	名詞
＠あがないししゃ、	《贖いし者、フェザー》	名詞
＠あがないししゃ、ふ	《贖いし者、フェザー》	名詞
＠あがないししゃ、ふぇ	《贖いし者、フェザー》	名詞
＠あがないししゃ、ふぇざ	《贖いし者、フェザー》	名詞
＠あがないししゃ、ふぇざー	《贖いし者、フェザー》	名詞
＠と	《轟く角獣》	名詞
＠とど	《轟く角獣》	名詞
＠とどろ	《轟く角獣》	名詞
＠とどろく	《轟く角獣》	名詞
＠とどろくか	《轟く角獣》	名詞
＠とどろくかく	《轟く角獣》	名詞
＠とどろくかくけ	《轟く角獣》	名詞
＠とどろくかくけも	《轟く角獣》	名詞
＠とどろくかくけもの	《轟く角獣》	名詞
＠ま	《迷い子、フブルスプ》	名詞
＠まよ	《迷い子、フブルスプ》	名詞
＠まよい	《迷い子、フブルスプ》	名詞
＠まよいご	《迷い子、フブルスプ》	名詞
＠まよいご、	《迷い子、フブルスプ》	名詞
＠まよいご、ふ	《迷い子、フブルスプ》	名詞
＠まよいご、ふぶ	《迷い子、フブルスプ》	名詞
＠まよいご、ふぶる	《迷い子、フブルスプ》	名詞
＠まよいご、ふぶるす	《迷い子、フブルスプ》	名詞
＠まよいご、ふぶるすぷ	《迷い子、フブルスプ》	名詞
＠た	《退路無し》	名詞
＠たい	《退路無し》	名詞
＠たいろ	《退路無し》	名詞
＠たいろな	《退路無し》	名詞
＠たいろなし	《退路無し》	名詞
＠ぞ	《造反者潰し》	名詞
＠ぞう	《造反者潰し》	名詞
＠ぞうは	《造反者潰し》	名詞
＠ぞうはん	《造反者潰し》	名詞
＠ぞうはんし	《造反者潰し》	名詞
＠ぞうはんしゃ	《造反者潰し》	名詞
＠ぞうはんしゃつ	《造反者潰し》	名詞
＠ぞうはんしゃつぶ	《造反者潰し》	名詞
＠ぞうはんしゃつぶし	《造反者潰し》	名詞
＠れ	《連帯》	名詞
＠れん	《連帯》	名詞
＠れんた	《連帯》	名詞
＠れんたい	《連帯》	名詞
＠し	《進化の賢者》	名詞
＠しん	《進化の賢者》	名詞
＠しんか	《進化の賢者》	名詞
＠しんかの	《進化の賢者》	名詞
＠しんかのけ	《進化の賢者》	名詞
＠しんかのけん	《進化の賢者》	名詞
＠しんかのけんじ	《進化の賢者》	名詞
＠しんかのけんじゃ	《進化の賢者》	名詞
＠み	《道迷い》	名詞
＠みち	《道迷い》	名詞
＠みちま	《道迷い》	名詞
＠みちまよ	《道迷い》	名詞
＠みちまよい	《道迷い》	名詞
＠と	《都市侵略》	名詞
＠とし	《都市侵略》	名詞
＠としし	《都市侵略》	名詞
＠とししん	《都市侵略》	名詞
＠とししんり	《都市侵略》	名詞
＠とししんりゃ	《都市侵略》	名詞
＠とししんりゃく	《都市侵略》	名詞
＠や	《野獣の擁護者、ビビアン》	名詞
＠やじ	《野獣の擁護者、ビビアン》	名詞
＠やじゅ	《野獣の擁護者、ビビアン》	名詞
＠やじゅう	《野獣の擁護者、ビビアン》	名詞
＠やじゅうの	《野獣の擁護者、ビビアン》	名詞
＠やじゅうのよ	《野獣の擁護者、ビビアン》	名詞
＠やじゅうのよう	《野獣の擁護者、ビビアン》	名詞
＠やじゅうのようご	《野獣の擁護者、ビビアン》	名詞
＠やじゅうのようごし	《野獣の擁護者、ビビアン》	名詞
＠やじゅうのようごしゃ	《野獣の擁護者、ビビアン》	名詞
＠やじゅうのようごしゃ、	《野獣の擁護者、ビビアン》	名詞
＠やじゅうのようごしゃ、び	《野獣の擁護者、ビビアン》	名詞
＠やじゅうのようごしゃ、びび	《野獣の擁護者、ビビアン》	名詞
＠やじゅうのようごしゃ、びびあ	《野獣の擁護者、ビビアン》	名詞
＠やじゅうのようごしゃ、びびあん	《野獣の擁護者、ビビアン》	名詞
＠や	《野生造り、ジアン・ヤングー》	名詞
＠やせ	《野生造り、ジアン・ヤングー》	名詞
＠やせい	《野生造り、ジアン・ヤングー》	名詞
＠やせいつ	《野生造り、ジアン・ヤングー》	名詞
＠やせいつく	《野生造り、ジアン・ヤングー》	名詞
＠やせいつくり	《野生造り、ジアン・ヤングー》	名詞
＠やせいつくり、	《野生造り、ジアン・ヤングー》	名詞
＠やせいつくり、じ	《野生造り、ジアン・ヤングー》	名詞
＠やせいつくり、じあ	《野生造り、ジアン・ヤングー》	名詞
＠やせいつくり、じあん	《野生造り、ジアン・ヤングー》	名詞
＠やせいつくり、じあん・	《野生造り、ジアン・ヤングー》	名詞
＠やせいつくり、じあん・や	《野生造り、ジアン・ヤングー》	名詞
＠やせいつくり、じあん・やん	《野生造り、ジアン・ヤングー》	名詞
＠やせいつくり、じあん・やんぐ	《野生造り、ジアン・ヤングー》	名詞
＠やせいつくり、じあん・やんぐー	《野生造り、ジアン・ヤングー》	名詞
＠て	《鉄の暴漢》	名詞
＠てつ	《鉄の暴漢》	名詞
＠てつの	《鉄の暴漢》	名詞
＠てつのぼ	《鉄の暴漢》	名詞
＠てつのぼう	《鉄の暴漢》	名詞
＠てつのぼうか	《鉄の暴漢》	名詞
＠てつのぼうかん	《鉄の暴漢》	名詞
＠て	《鉄覆いのクロヴァド》	名詞
＠てつ	《鉄覆いのクロヴァド》	名詞
＠てつお	《鉄覆いのクロヴァド》	名詞
＠てつおお	《鉄覆いのクロヴァド》	名詞
＠てつおおい	《鉄覆いのクロヴァド》	名詞
＠てつおおいの	《鉄覆いのクロヴァド》	名詞
＠てつおおいのく	《鉄覆いのクロヴァド》	名詞
＠てつおおいのくろ	《鉄覆いのクロヴァド》	名詞
＠てつおおいのくろヴ	《鉄覆いのクロヴァド》	名詞
＠てつおおいのくろヴぁ	《鉄覆いのクロヴァド》	名詞
＠てつおおいのくろヴぁど	《鉄覆いのクロヴァド》	名詞
＠く	《鎖鞭のサイクロプス》	名詞
＠くさ	《鎖鞭のサイクロプス》	名詞
＠くさり	《鎖鞭のサイクロプス》	名詞
＠くさりむ	《鎖鞭のサイクロプス》	名詞
＠くさりむち	《鎖鞭のサイクロプス》	名詞
＠くさりむちの	《鎖鞭のサイクロプス》	名詞
＠くさりむちのさ	《鎖鞭のサイクロプス》	名詞
＠くさりむちのさい	《鎖鞭のサイクロプス》	名詞
＠くさりむちのさいく	《鎖鞭のサイクロプス》	名詞
＠くさりむちのさいくろ	《鎖鞭のサイクロプス》	名詞
＠くさりむちのさいくろぷ	《鎖鞭のサイクロプス》	名詞
＠くさりむちのさいくろぷす	《鎖鞭のサイクロプス》	名詞
＠か	《開花の巨体》	名詞
＠かい	《開花の巨体》	名詞
＠かいか	《開花の巨体》	名詞
＠かいかの	《開花の巨体》	名詞
＠かいかのき	《開花の巨体》	名詞
＠かいかのきょ	《開花の巨体》	名詞
＠かいかのきょた	《開花の巨体》	名詞
＠かいかのきょたい	《開花の巨体》	名詞
＠ま	《間に合わせの大隊》	名詞
＠まに	《間に合わせの大隊》	名詞
＠まにあ	《間に合わせの大隊》	名詞
＠まにあわ	《間に合わせの大隊》	名詞
＠まにあわせ	《間に合わせの大隊》	名詞
＠まにあわせの	《間に合わせの大隊》	名詞
＠まにあわせのだ	《間に合わせの大隊》	名詞
＠まにあわせのだい	《間に合わせの大隊》	名詞
＠まにあわせのだいた	《間に合わせの大隊》	名詞
＠まにあわせのだいたい	《間に合わせの大隊》	名詞
＠ぼ	《防壁の巨人》	名詞
＠ぼう	《防壁の巨人》	名詞
＠ぼうへ	《防壁の巨人》	名詞
＠ぼうへき	《防壁の巨人》	名詞
＠ぼうへきの	《防壁の巨人》	名詞
＠ぼうへきのき	《防壁の巨人》	名詞
＠ぼうへきのきょ	《防壁の巨人》	名詞
＠ぼうへきのきょじ	《防壁の巨人》	名詞
＠ぼうへきのきょじん	《防壁の巨人》	名詞
＠よ	《陽光の輝き》	名詞
＠よう	《陽光の輝き》	名詞
＠ようこ	《陽光の輝き》	名詞
＠ようこう	《陽光の輝き》	名詞
＠ようこうの	《陽光の輝き》	名詞
＠ようこうのか	《陽光の輝き》	名詞
＠ようこうのかが	《陽光の輝き》	名詞
＠ようこうのかがや	《陽光の輝き》	名詞
＠ようこうのかがやき	《陽光の輝き》	名詞
＠ひ	《陽刃の天使》	名詞
＠ひは	《陽刃の天使》	名詞
＠ひはの	《陽刃の天使》	名詞
＠ひはのて	《陽刃の天使》	名詞
＠ひはのてん	《陽刃の天使》	名詞
＠ひはのてんし	《陽刃の天使》	名詞
＠か	《雷のドレイク》	名詞
＠かみ	《雷のドレイク》	名詞
＠かみな	《雷のドレイク》	名詞
＠かみなり	《雷のドレイク》	名詞
＠かみなりの	《雷のドレイク》	名詞
＠かみなりのど	《雷のドレイク》	名詞
＠かみなりのどれ	《雷のドレイク》	名詞
＠かみなりのどれい	《雷のドレイク》	名詞
＠かみなりのどれいく	《雷のドレイク》	名詞
＠し	《静かな潜水艇》	名詞
＠しず	《静かな潜水艇》	名詞
＠しずか	《静かな潜水艇》	名詞
＠しずかな	《静かな潜水艇》	名詞
＠しずかなせ	《静かな潜水艇》	名詞
＠しずかなせん	《静かな潜水艇》	名詞
＠しずかなせんす	《静かな潜水艇》	名詞
＠しずかなせんすい	《静かな潜水艇》	名詞
＠しずかなせんすいて	《静かな潜水艇》	名詞
＠しずかなせんすいてい	《静かな潜水艇》	名詞
＠と	《飛びかかるオオヤマネコ》	名詞
＠とび	《飛びかかるオオヤマネコ》	名詞
＠とびか	《飛びかかるオオヤマネコ》	名詞
＠とびかか	《飛びかかるオオヤマネコ》	名詞
＠とびかかる	《飛びかかるオオヤマネコ》	名詞
＠とびかかるお	《飛びかかるオオヤマネコ》	名詞
＠とびかかるおお	《飛びかかるオオヤマネコ》	名詞
＠とびかかるおおや	《飛びかかるオオヤマネコ》	名詞
＠とびかかるおおやま	《飛びかかるオオヤマネコ》	名詞
＠とびかかるおおやまね	《飛びかかるオオヤマネコ》	名詞
＠とびかかるおおやまねこ	《飛びかかるオオヤマネコ》	名詞
＠こ	《高名な弁護士、トミク》	名詞
＠こう	《高名な弁護士、トミク》	名詞
＠こうめ	《高名な弁護士、トミク》	名詞
＠こうめい	《高名な弁護士、トミク》	名詞
＠こうめいな	《高名な弁護士、トミク》	名詞
＠こうめいなべ	《高名な弁護士、トミク》	名詞
＠こうめいなべん	《高名な弁護士、トミク》	名詞
＠こうめいなべんご	《高名な弁護士、トミク》	名詞
＠こうめいなべんごし	《高名な弁護士、トミク》	名詞
＠こうめいなべんごし、	《高名な弁護士、トミク》	名詞
＠こうめいなべんごし、と	《高名な弁護士、トミク》	名詞
＠こうめいなべんごし、とみ	《高名な弁護士、トミク》	名詞
＠こうめいなべんごし、とみく	《高名な弁護士、トミク》	名詞
＠た	《魂の占者》	名詞
＠たま	《魂の占者》	名詞
＠たまし	《魂の占者》	名詞
＠たましい	《魂の占者》	名詞
＠たましいの	《魂の占者》	名詞
＠たましいのう	《魂の占者》	名詞
＠たましいのうら	《魂の占者》	名詞
＠たましいのうらな	《魂の占者》	名詞
＠たましいのうらない	《魂の占者》	名詞
＠たましいのうらないし	《魂の占者》	名詞
＠たましいのうらないしゃ	《魂の占者》	名詞
＠せ	《鮮血の刃先》	名詞
＠せん	《鮮血の刃先》	名詞
＠せんけ	《鮮血の刃先》	名詞
＠せんけつ	《鮮血の刃先》	名詞
＠せんけつの	《鮮血の刃先》	名詞
＠せんけつのは	《鮮血の刃先》	名詞
＠せんけつのはさ	《鮮血の刃先》	名詞
＠せんけつのはさき	《鮮血の刃先》	名詞
＠く	《黒き剣のギデオン》	名詞
＠くろ	《黒き剣のギデオン》	名詞
＠くろき	《黒き剣のギデオン》	名詞
＠くろきけ	《黒き剣のギデオン》	名詞
＠くろきけん	《黒き剣のギデオン》	名詞
＠くろきけんの	《黒き剣のギデオン》	名詞
＠くろきけんのぎ	《黒き剣のギデオン》	名詞
＠くろきけんのぎで	《黒き剣のギデオン》	名詞
＠くろきけんのぎでお	《黒き剣のギデオン》	名詞
＠くろきけんのぎでおん	《黒き剣のギデオン》	名詞
＠り	《龍神、ニコル・ボーラス》	名詞
＠りゅ	《龍神、ニコル・ボーラス》	名詞
＠りゅう	《龍神、ニコル・ボーラス》	名詞
＠りゅうじ	《龍神、ニコル・ボーラス》	名詞
＠りゅうじん	《龍神、ニコル・ボーラス》	名詞
＠りゅうじん、	《龍神、ニコル・ボーラス》	名詞
＠りゅうじん、に	《龍神、ニコル・ボーラス》	名詞
＠りゅうじん、にこ	《龍神、ニコル・ボーラス》	名詞
＠りゅうじん、にこる	《龍神、ニコル・ボーラス》	名詞
＠りゅうじん、にこる・	《龍神、ニコル・ボーラス》	名詞
＠りゅうじん、にこる・ぼ	《龍神、ニコル・ボーラス》	名詞
＠りゅうじん、にこる・ぼー	《龍神、ニコル・ボーラス》	名詞
＠りゅうじん、にこる・ぼーら	《龍神、ニコル・ボーラス》	名詞
＠りゅうじん、にこる・ぼーらす	《龍神、ニコル・ボーラス》	名詞
