＠う	《うたた寝するティラノドン》	名詞
＠うた	《うたた寝するティラノドン》	名詞
＠うたた	《うたた寝するティラノドン》	名詞
＠うたたね	《うたた寝するティラノドン》	名詞
＠うたたねす	《うたた寝するティラノドン》	名詞
＠うたたねする	《うたた寝するティラノドン》	名詞
＠うたたねするて	《うたた寝するティラノドン》	名詞
＠うたたねするてぃ	《うたた寝するティラノドン》	名詞
＠うたたねするてぃら	《うたた寝するティラノドン》	名詞
＠うたたねするてぃらの	《うたた寝するティラノドン》	名詞
＠うたたねするてぃらのど	《うたた寝するティラノドン》	名詞
＠うたたねするてぃらのどん	《うたた寝するティラノドン》	名詞
＠う	《うろつく光霊》	名詞
＠うろ	《うろつく光霊》	名詞
＠うろつ	《うろつく光霊》	名詞
＠うろつく	《うろつく光霊》	名詞
＠うろつくひ	《うろつく光霊》	名詞
＠うろつくひか	《うろつく光霊》	名詞
＠うろつくひかり	《うろつく光霊》	名詞
＠うろつくひかりれ	《うろつく光霊》	名詞
＠うろつくひかりれい	《うろつく光霊》	名詞
＠と	《とどめの一撃》	名詞
＠とど	《とどめの一撃》	名詞
＠とどめ	《とどめの一撃》	名詞
＠とどめの	《とどめの一撃》	名詞
＠とどめのい	《とどめの一撃》	名詞
＠とどめのいち	《とどめの一撃》	名詞
＠とどめのいちげ	《とどめの一撃》	名詞
＠とどめのいちげき	《とどめの一撃》	名詞
＠や	《やんちゃな犬》	名詞
＠やん	《やんちゃな犬》	名詞
＠やんち	《やんちゃな犬》	名詞
＠やんちゃ	《やんちゃな犬》	名詞
＠やんちゃな	《やんちゃな犬》	名詞
＠やんちゃない	《やんちゃな犬》	名詞
＠やんちゃないぬ	《やんちゃな犬》	名詞
＠あ	《アーティファクト》	名詞
＠あー	《アーティファクト》	名詞
＠あーて	《アーティファクト》	名詞
＠あーてぃ	《アーティファクト》	名詞
＠あーてぃふ	《アーティファクト》	名詞
＠あーてぃふぁ	《アーティファクト》	名詞
＠あーてぃふぁく	《アーティファクト》	名詞
＠あーてぃふぁくと	《アーティファクト》	名詞
＠え	《エイヴンの鳥群使い》	名詞
＠えい	《エイヴンの鳥群使い》	名詞
＠えいヴ	《エイヴンの鳥群使い》	名詞
＠えいヴん	《エイヴンの鳥群使い》	名詞
＠えいヴんの	《エイヴンの鳥群使い》	名詞
＠えいヴんのと	《エイヴンの鳥群使い》	名詞
＠えいヴんのとり	《エイヴンの鳥群使い》	名詞
＠えいヴんのとりぐ	《エイヴンの鳥群使い》	名詞
＠えいヴんのとりぐん	《エイヴンの鳥群使い》	名詞
＠えいヴんのとりぐんつ	《エイヴンの鳥群使い》	名詞
＠えいヴんのとりぐんつか	《エイヴンの鳥群使い》	名詞
＠えいヴんのとりぐんつかい	《エイヴンの鳥群使い》	名詞
＠お	《オナッケのオーガ》	名詞
＠おな	《オナッケのオーガ》	名詞
＠おなっ	《オナッケのオーガ》	名詞
＠おなっけ	《オナッケのオーガ》	名詞
＠おなっけの	《オナッケのオーガ》	名詞
＠おなっけのお	《オナッケのオーガ》	名詞
＠おなっけのおー	《オナッケのオーガ》	名詞
＠おなっけのおーが	《オナッケのオーガ》	名詞
＠が	《ガラクの先触れ》	名詞
＠がら	《ガラクの先触れ》	名詞
＠がらく	《ガラクの先触れ》	名詞
＠がらくの	《ガラクの先触れ》	名詞
＠がらくのさ	《ガラクの先触れ》	名詞
＠がらくのさき	《ガラクの先触れ》	名詞
＠がらくのさきぶ	《ガラクの先触れ》	名詞
＠がらくのさきぶれ	《ガラクの先触れ》	名詞
＠が	《ガラクの蜂起》	名詞
＠がら	《ガラクの蜂起》	名詞
＠がらく	《ガラクの蜂起》	名詞
＠がらくの	《ガラクの蜂起》	名詞
＠がらくのほ	《ガラクの蜂起》	名詞
＠がらくのほう	《ガラクの蜂起》	名詞
＠がらくのほうき	《ガラクの蜂起》	名詞
＠が	《ガラクの血まみれ角》	名詞
＠がら	《ガラクの血まみれ角》	名詞
＠がらく	《ガラクの血まみれ角》	名詞
＠がらくの	《ガラクの血まみれ角》	名詞
＠がらくのち	《ガラクの血まみれ角》	名詞
＠がらくのちま	《ガラクの血まみれ角》	名詞
＠がらくのちまみ	《ガラクの血まみれ角》	名詞
＠がらくのちまみれ	《ガラクの血まみれ角》	名詞
＠がらくのちまみれか	《ガラクの血まみれ角》	名詞
＠がらくのちまみれかく	《ガラクの血まみれ角》	名詞
＠く	《クウィリーオンのドライアド》	名詞
＠くう	《クウィリーオンのドライアド》	名詞
＠くうぃ	《クウィリーオンのドライアド》	名詞
＠くうぃり	《クウィリーオンのドライアド》	名詞
＠くうぃりー	《クウィリーオンのドライアド》	名詞
＠くうぃりーお	《クウィリーオンのドライアド》	名詞
＠くうぃりーおん	《クウィリーオンのドライアド》	名詞
＠くうぃりーおんの	《クウィリーオンのドライアド》	名詞
＠くうぃりーおんのど	《クウィリーオンのドライアド》	名詞
＠くうぃりーおんのどら	《クウィリーオンのドライアド》	名詞
＠くうぃりーおんのどらい	《クウィリーオンのドライアド》	名詞
＠くうぃりーおんのどらいあ	《クウィリーオンのドライアド》	名詞
＠くうぃりーおんのどらいあど	《クウィリーオンのドライアド》	名詞
＠ぐ	《グリフィンの高楼》	名詞
＠ぐり	《グリフィンの高楼》	名詞
＠ぐりふ	《グリフィンの高楼》	名詞
＠ぐりふぃ	《グリフィンの高楼》	名詞
＠ぐりふぃん	《グリフィンの高楼》	名詞
＠ぐりふぃんの	《グリフィンの高楼》	名詞
＠ぐりふぃんのこ	《グリフィンの高楼》	名詞
＠ぐりふぃんのこう	《グリフィンの高楼》	名詞
＠ぐりふぃんのこうろ	《グリフィンの高楼》	名詞
＠ぐりふぃんのこうろう	《グリフィンの高楼》	名詞
＠け	《ケルドの心胆、ラーダ》	名詞
＠ける	《ケルドの心胆、ラーダ》	名詞
＠けるど	《ケルドの心胆、ラーダ》	名詞
＠けるどの	《ケルドの心胆、ラーダ》	名詞
＠けるどのし	《ケルドの心胆、ラーダ》	名詞
＠けるどのしん	《ケルドの心胆、ラーダ》	名詞
＠けるどのしんた	《ケルドの心胆、ラーダ》	名詞
＠けるどのしんたん	《ケルドの心胆、ラーダ》	名詞
＠けるどのしんたん、	《ケルドの心胆、ラーダ》	名詞
＠けるどのしんたん、ら	《ケルドの心胆、ラーダ》	名詞
＠けるどのしんたん、らー	《ケルドの心胆、ラーダ》	名詞
＠けるどのしんたん、らーだ	《ケルドの心胆、ラーダ》	名詞
＠ご	《ゴブリンの付け火屋》	名詞
＠ごぶ	《ゴブリンの付け火屋》	名詞
＠ごぶり	《ゴブリンの付け火屋》	名詞
＠ごぶりん	《ゴブリンの付け火屋》	名詞
＠ごぶりんの	《ゴブリンの付け火屋》	名詞
＠ごぶりんのつ	《ゴブリンの付け火屋》	名詞
＠ごぶりんのつけ	《ゴブリンの付け火屋》	名詞
＠ごぶりんのつけび	《ゴブリンの付け火屋》	名詞
＠ごぶりんのつけびや	《ゴブリンの付け火屋》	名詞
＠ご	《ゴブリンの魔術》	名詞
＠ごぶ	《ゴブリンの魔術》	名詞
＠ごぶり	《ゴブリンの魔術》	名詞
＠ごぶりん	《ゴブリンの魔術》	名詞
＠ごぶりんの	《ゴブリンの魔術》	名詞
＠ごぶりんのま	《ゴブリンの魔術》	名詞
＠ごぶりんのまじ	《ゴブリンの魔術》	名詞
＠ごぶりんのまじゅ	《ゴブリンの魔術》	名詞
＠ごぶりんのまじゅつ	《ゴブリンの魔術》	名詞
＠し	《ショック》	名詞
＠しょ	《ショック》	名詞
＠しょっ	《ショック》	名詞
＠しょっく	《ショック》	名詞
＠じ	《ジェスカイの長老》	名詞
＠じぇ	《ジェスカイの長老》	名詞
＠じぇす	《ジェスカイの長老》	名詞
＠じぇすか	《ジェスカイの長老》	名詞
＠じぇすかい	《ジェスカイの長老》	名詞
＠じぇすかいの	《ジェスカイの長老》	名詞
＠じぇすかいのち	《ジェスカイの長老》	名詞
＠じぇすかいのちょ	《ジェスカイの長老》	名詞
＠じぇすかいのちょう	《ジェスカイの長老》	名詞
＠じぇすかいのちょうろ	《ジェスカイの長老》	名詞
＠じぇすかいのちょうろう	《ジェスカイの長老》	名詞
＠じ	《ジャングルのうろ穴》	名詞
＠じゃ	《ジャングルのうろ穴》	名詞
＠じゃん	《ジャングルのうろ穴》	名詞
＠じゃんぐ	《ジャングルのうろ穴》	名詞
＠じゃんぐる	《ジャングルのうろ穴》	名詞
＠じゃんぐるの	《ジャングルのうろ穴》	名詞
＠じゃんぐるのう	《ジャングルのうろ穴》	名詞
＠じゃんぐるのうろ	《ジャングルのうろ穴》	名詞
＠じゃんぐるのうろあ	《ジャングルのうろ穴》	名詞
＠じゃんぐるのうろあな	《ジャングルのうろ穴》	名詞
＠す	《スカイウェイの狙撃者》	名詞
＠すか	《スカイウェイの狙撃者》	名詞
＠すかい	《スカイウェイの狙撃者》	名詞
＠すかいう	《スカイウェイの狙撃者》	名詞
＠すかいうぇ	《スカイウェイの狙撃者》	名詞
＠すかいうぇい	《スカイウェイの狙撃者》	名詞
＠すかいうぇいの	《スカイウェイの狙撃者》	名詞
＠すかいうぇいのそ	《スカイウェイの狙撃者》	名詞
＠すかいうぇいのそげ	《スカイウェイの狙撃者》	名詞
＠すかいうぇいのそげき	《スカイウェイの狙撃者》	名詞
＠すかいうぇいのそげきし	《スカイウェイの狙撃者》	名詞
＠すかいうぇいのそげきしゃ	《スカイウェイの狙撃者》	名詞
＠せ	《セテッサ式訓練》	名詞
＠せて	《セテッサ式訓練》	名詞
＠せてっ	《セテッサ式訓練》	名詞
＠せてっさ	《セテッサ式訓練》	名詞
＠せてっさし	《セテッサ式訓練》	名詞
＠せてっさしき	《セテッサ式訓練》	名詞
＠せてっさしきく	《セテッサ式訓練》	名詞
＠せてっさしきくん	《セテッサ式訓練》	名詞
＠せてっさしきくんれ	《セテッサ式訓練》	名詞
＠せてっさしきくんれん	《セテッサ式訓練》	名詞
＠た	《タルジーディの隊商、スビラ》	名詞
＠たる	《タルジーディの隊商、スビラ》	名詞
＠たるじ	《タルジーディの隊商、スビラ》	名詞
＠たるじー	《タルジーディの隊商、スビラ》	名詞
＠たるじーで	《タルジーディの隊商、スビラ》	名詞
＠たるじーでぃ	《タルジーディの隊商、スビラ》	名詞
＠たるじーでぃの	《タルジーディの隊商、スビラ》	名詞
＠たるじーでぃのた	《タルジーディの隊商、スビラ》	名詞
＠たるじーでぃのたい	《タルジーディの隊商、スビラ》	名詞
＠たるじーでぃのたいし	《タルジーディの隊商、スビラ》	名詞
＠たるじーでぃのたいしょ	《タルジーディの隊商、スビラ》	名詞
＠たるじーでぃのたいしょう	《タルジーディの隊商、スビラ》	名詞
＠たるじーでぃのたいしょう、	《タルジーディの隊商、スビラ》	名詞
＠たるじーでぃのたいしょう、す	《タルジーディの隊商、スビラ》	名詞
＠たるじーでぃのたいしょう、すび	《タルジーディの隊商、スビラ》	名詞
＠たるじーでぃのたいしょう、すびら	《タルジーディの隊商、スビラ》	名詞
＠ち	《チャンドラのマグムット》	名詞
＠ちゃ	《チャンドラのマグムット》	名詞
＠ちゃん	《チャンドラのマグムット》	名詞
＠ちゃんど	《チャンドラのマグムット》	名詞
＠ちゃんどら	《チャンドラのマグムット》	名詞
＠ちゃんどらの	《チャンドラのマグムット》	名詞
＠ちゃんどらのま	《チャンドラのマグムット》	名詞
＠ちゃんどらのまぐ	《チャンドラのマグムット》	名詞
＠ちゃんどらのまぐむ	《チャンドラのマグムット》	名詞
＠ちゃんどらのまぐむっ	《チャンドラのマグムット》	名詞
＠ちゃんどらのまぐむっと	《チャンドラのマグムット》	名詞
＠ち	《チャンドラの焼却者》	名詞
＠ちゃ	《チャンドラの焼却者》	名詞
＠ちゃん	《チャンドラの焼却者》	名詞
＠ちゃんど	《チャンドラの焼却者》	名詞
＠ちゃんどら	《チャンドラの焼却者》	名詞
＠ちゃんどらの	《チャンドラの焼却者》	名詞
＠ちゃんどらのし	《チャンドラの焼却者》	名詞
＠ちゃんどらのしょ	《チャンドラの焼却者》	名詞
＠ちゃんどらのしょう	《チャンドラの焼却者》	名詞
＠ちゃんどらのしょうき	《チャンドラの焼却者》	名詞
＠ちゃんどらのしょうきゃ	《チャンドラの焼却者》	名詞
＠ちゃんどらのしょうきゃく	《チャンドラの焼却者》	名詞
＠ちゃんどらのしょうきゃくし	《チャンドラの焼却者》	名詞
＠ちゃんどらのしょうきゃくしゃ	《チャンドラの焼却者》	名詞
＠ち	《チャンドラの紅蓮獣》	名詞
＠ちゃ	《チャンドラの紅蓮獣》	名詞
＠ちゃん	《チャンドラの紅蓮獣》	名詞
＠ちゃんど	《チャンドラの紅蓮獣》	名詞
＠ちゃんどら	《チャンドラの紅蓮獣》	名詞
＠ちゃんどらの	《チャンドラの紅蓮獣》	名詞
＠ちゃんどらのぐ	《チャンドラの紅蓮獣》	名詞
＠ちゃんどらのぐれ	《チャンドラの紅蓮獣》	名詞
＠ちゃんどらのぐれん	《チャンドラの紅蓮獣》	名詞
＠ちゃんどらのぐれんけ	《チャンドラの紅蓮獣》	名詞
＠ちゃんどらのぐれんけも	《チャンドラの紅蓮獣》	名詞
＠ちゃんどらのぐれんけもの	《チャンドラの紅蓮獣》	名詞
＠て	《テフェリーの後見》	名詞
＠てふ	《テフェリーの後見》	名詞
＠てふぇ	《テフェリーの後見》	名詞
＠てふぇり	《テフェリーの後見》	名詞
＠てふぇりー	《テフェリーの後見》	名詞
＠てふぇりーの	《テフェリーの後見》	名詞
＠てふぇりーのこ	《テフェリーの後見》	名詞
＠てふぇりーのこう	《テフェリーの後見》	名詞
＠てふぇりーのこうけ	《テフェリーの後見》	名詞
＠てふぇりーのこうけん	《テフェリーの後見》	名詞
＠て	《テフェリーの徒弟》	名詞
＠てふ	《テフェリーの徒弟》	名詞
＠てふぇ	《テフェリーの徒弟》	名詞
＠てふぇり	《テフェリーの徒弟》	名詞
＠てふぇりー	《テフェリーの徒弟》	名詞
＠てふぇりーの	《テフェリーの徒弟》	名詞
＠てふぇりーのと	《テフェリーの徒弟》	名詞
＠てふぇりーのとて	《テフェリーの徒弟》	名詞
＠てふぇりーのとてい	《テフェリーの徒弟》	名詞
＠て	《テフェリーの永遠の洞察》	名詞
＠てふ	《テフェリーの永遠の洞察》	名詞
＠てふぇ	《テフェリーの永遠の洞察》	名詞
＠てふぇり	《テフェリーの永遠の洞察》	名詞
＠てふぇりー	《テフェリーの永遠の洞察》	名詞
＠てふぇりーの	《テフェリーの永遠の洞察》	名詞
＠てふぇりーのえ	《テフェリーの永遠の洞察》	名詞
＠てふぇりーのえい	《テフェリーの永遠の洞察》	名詞
＠てふぇりーのえいえ	《テフェリーの永遠の洞察》	名詞
＠てふぇりーのえいえん	《テフェリーの永遠の洞察》	名詞
＠てふぇりーのえいえんの	《テフェリーの永遠の洞察》	名詞
＠てふぇりーのえいえんのど	《テフェリーの永遠の洞察》	名詞
＠てふぇりーのえいえんのどう	《テフェリーの永遠の洞察》	名詞
＠てふぇりーのえいえんのどうさ	《テフェリーの永遠の洞察》	名詞
＠てふぇりーのえいえんのどうさつ	《テフェリーの永遠の洞察》	名詞
＠と	《トリュフ嗅ぎ》	名詞
＠とり	《トリュフ嗅ぎ》	名詞
＠とりゅ	《トリュフ嗅ぎ》	名詞
＠とりゅふ	《トリュフ嗅ぎ》	名詞
＠とりゅふか	《トリュフ嗅ぎ》	名詞
＠とりゅふかぎ	《トリュフ嗅ぎ》	名詞
＠と	《トレイリアのクラーケン》	名詞
＠とれ	《トレイリアのクラーケン》	名詞
＠とれい	《トレイリアのクラーケン》	名詞
＠とれいり	《トレイリアのクラーケン》	名詞
＠とれいりあ	《トレイリアのクラーケン》	名詞
＠とれいりあの	《トレイリアのクラーケン》	名詞
＠とれいりあのく	《トレイリアのクラーケン》	名詞
＠とれいりあのくら	《トレイリアのクラーケン》	名詞
＠とれいりあのくらー	《トレイリアのクラーケン》	名詞
＠とれいりあのくらーけ	《トレイリアのクラーケン》	名詞
＠とれいりあのくらーけん	《トレイリアのクラーケン》	名詞
＠と	《トレイリアの大魔導師、バリン》	名詞
＠とれ	《トレイリアの大魔導師、バリン》	名詞
＠とれい	《トレイリアの大魔導師、バリン》	名詞
＠とれいり	《トレイリアの大魔導師、バリン》	名詞
＠とれいりあ	《トレイリアの大魔導師、バリン》	名詞
＠とれいりあの	《トレイリアの大魔導師、バリン》	名詞
＠とれいりあのだ	《トレイリアの大魔導師、バリン》	名詞
＠とれいりあのだい	《トレイリアの大魔導師、バリン》	名詞
＠とれいりあのだいま	《トレイリアの大魔導師、バリン》	名詞
＠とれいりあのだいまど	《トレイリアの大魔導師、バリン》	名詞
＠とれいりあのだいまどう	《トレイリアの大魔導師、バリン》	名詞
＠とれいりあのだいまどうし	《トレイリアの大魔導師、バリン》	名詞
＠とれいりあのだいまどうし、	《トレイリアの大魔導師、バリン》	名詞
＠とれいりあのだいまどうし、ば	《トレイリアの大魔導師、バリン》	名詞
＠とれいりあのだいまどうし、ばり	《トレイリアの大魔導師、バリン》	名詞
＠とれいりあのだいまどうし、ばりん	《トレイリアの大魔導師、バリン》	名詞
＠と	《トーモッドの墓所》	名詞
＠とー	《トーモッドの墓所》	名詞
＠とーも	《トーモッドの墓所》	名詞
＠とーもっ	《トーモッドの墓所》	名詞
＠とーもっど	《トーモッドの墓所》	名詞
＠とーもっどの	《トーモッドの墓所》	名詞
＠とーもっどのぼ	《トーモッドの墓所》	名詞
＠とーもっどのぼし	《トーモッドの墓所》	名詞
＠とーもっどのぼしょ	《トーモッドの墓所》	名詞
＠ば	《バスリの侍祭》	名詞
＠ばす	《バスリの侍祭》	名詞
＠ばすり	《バスリの侍祭》	名詞
＠ばすりの	《バスリの侍祭》	名詞
＠ばすりのさ	《バスリの侍祭》	名詞
＠ばすりのさむ	《バスリの侍祭》	名詞
＠ばすりのさむら	《バスリの侍祭》	名詞
＠ばすりのさむらい	《バスリの侍祭》	名詞
＠ばすりのさむらいさ	《バスリの侍祭》	名詞
＠ばすりのさむらいさい	《バスリの侍祭》	名詞
＠ば	《バスリの副官》	名詞
＠ばす	《バスリの副官》	名詞
＠ばすり	《バスリの副官》	名詞
＠ばすりの	《バスリの副官》	名詞
＠ばすりのふ	《バスリの副官》	名詞
＠ばすりのふく	《バスリの副官》	名詞
＠ばすりのふくか	《バスリの副官》	名詞
＠ばすりのふくかん	《バスリの副官》	名詞
＠ば	《バスリの結束》	名詞
＠ばす	《バスリの結束》	名詞
＠ばすり	《バスリの結束》	名詞
＠ばすりの	《バスリの結束》	名詞
＠ばすりのけ	《バスリの結束》	名詞
＠ばすりのけっ	《バスリの結束》	名詞
＠ばすりのけっそ	《バスリの結束》	名詞
＠ばすりのけっそく	《バスリの結束》	名詞
＠ば	《バスリ・ケト》	名詞
＠ばす	《バスリ・ケト》	名詞
＠ばすり	《バスリ・ケト》	名詞
＠ばすり・	《バスリ・ケト》	名詞
＠ばすり・け	《バスリ・ケト》	名詞
＠ばすり・けと	《バスリ・ケト》	名詞
＠ぱ	《パラジウムのマイア》	名詞
＠ぱら	《パラジウムのマイア》	名詞
＠ぱらじ	《パラジウムのマイア》	名詞
＠ぱらじう	《パラジウムのマイア》	名詞
＠ぱらじうむ	《パラジウムのマイア》	名詞
＠ぱらじうむの	《パラジウムのマイア》	名詞
＠ぱらじうむのま	《パラジウムのマイア》	名詞
＠ぱらじうむのまい	《パラジウムのマイア》	名詞
＠ぱらじうむのまいあ	《パラジウムのマイア》	名詞
＠ぷ	《プリズマイト》	名詞
＠ぷり	《プリズマイト》	名詞
＠ぷりず	《プリズマイト》	名詞
＠ぷりずま	《プリズマイト》	名詞
＠ぷりずまい	《プリズマイト》	名詞
＠ぷりずまいと	《プリズマイト》	名詞
＠へ	《ヘルカイトの懲罰者》	名詞
＠へる	《ヘルカイトの懲罰者》	名詞
＠へるか	《ヘルカイトの懲罰者》	名詞
＠へるかい	《ヘルカイトの懲罰者》	名詞
＠へるかいと	《ヘルカイトの懲罰者》	名詞
＠へるかいとの	《ヘルカイトの懲罰者》	名詞
＠へるかいとのち	《ヘルカイトの懲罰者》	名詞
＠へるかいとのちょ	《ヘルカイトの懲罰者》	名詞
＠へるかいとのちょう	《ヘルカイトの懲罰者》	名詞
＠へるかいとのちょうば	《ヘルカイトの懲罰者》	名詞
＠へるかいとのちょうばつ	《ヘルカイトの懲罰者》	名詞
＠へるかいとのちょうばつし	《ヘルカイトの懲罰者》	名詞
＠へるかいとのちょうばつしゃ	《ヘルカイトの懲罰者》	名詞
＠む	《ムウォンヴーリーの世捨て人、ジョルレイル》	名詞
＠むう	《ムウォンヴーリーの世捨て人、ジョルレイル》	名詞
＠むうぉ	《ムウォンヴーリーの世捨て人、ジョルレイル》	名詞
＠むうぉん	《ムウォンヴーリーの世捨て人、ジョルレイル》	名詞
＠むうぉんヴ	《ムウォンヴーリーの世捨て人、ジョルレイル》	名詞
＠むうぉんヴー	《ムウォンヴーリーの世捨て人、ジョルレイル》	名詞
＠むうぉんヴーり	《ムウォンヴーリーの世捨て人、ジョルレイル》	名詞
＠むうぉんヴーりー	《ムウォンヴーリーの世捨て人、ジョルレイル》	名詞
＠むうぉんヴーりーの	《ムウォンヴーリーの世捨て人、ジョルレイル》	名詞
＠むうぉんヴーりーのよ	《ムウォンヴーリーの世捨て人、ジョルレイル》	名詞
＠むうぉんヴーりーのよす	《ムウォンヴーリーの世捨て人、ジョルレイル》	名詞
＠むうぉんヴーりーのよすて	《ムウォンヴーリーの世捨て人、ジョルレイル》	名詞
＠むうぉんヴーりーのよすてび	《ムウォンヴーリーの世捨て人、ジョルレイル》	名詞
＠むうぉんヴーりーのよすてびと	《ムウォンヴーリーの世捨て人、ジョルレイル》	名詞
＠むうぉんヴーりーのよすてびと、	《ムウォンヴーリーの世捨て人、ジョルレイル》	名詞
＠むうぉんヴーりーのよすてびと、じ	《ムウォンヴーリーの世捨て人、ジョルレイル》	名詞
＠むうぉんヴーりーのよすてびと、じょ	《ムウォンヴーリーの世捨て人、ジョルレイル》	名詞
＠むうぉんヴーりーのよすてびと、じょる	《ムウォンヴーリーの世捨て人、ジョルレイル》	名詞
＠むうぉんヴーりーのよすてびと、じょるれ	《ムウォンヴーリーの世捨て人、ジョルレイル》	名詞
＠むうぉんヴーりーのよすてびと、じょるれい	《ムウォンヴーリーの世捨て人、ジョルレイル》	名詞
＠むうぉんヴーりーのよすてびと、じょるれいる	《ムウォンヴーリーの世捨て人、ジョルレイル》	名詞
＠ら	《ラノワールの幻想家》	名詞
＠らの	《ラノワールの幻想家》	名詞
＠らのわ	《ラノワールの幻想家》	名詞
＠らのわー	《ラノワールの幻想家》	名詞
＠らのわーる	《ラノワールの幻想家》	名詞
＠らのわーるの	《ラノワールの幻想家》	名詞
＠らのわーるのげ	《ラノワールの幻想家》	名詞
＠らのわーるのげん	《ラノワールの幻想家》	名詞
＠らのわーるのげんそ	《ラノワールの幻想家》	名詞
＠らのわーるのげんそう	《ラノワールの幻想家》	名詞
＠らのわーるのげんそうい	《ラノワールの幻想家》	名詞
＠らのわーるのげんそういえ	《ラノワールの幻想家》	名詞
＠り	《リリアナの使用人》	名詞
＠りり	《リリアナの使用人》	名詞
＠りりあ	《リリアナの使用人》	名詞
＠りりあな	《リリアナの使用人》	名詞
＠りりあなの	《リリアナの使用人》	名詞
＠りりあなのし	《リリアナの使用人》	名詞
＠りりあなのしよ	《リリアナの使用人》	名詞
＠りりあなのしよう	《リリアナの使用人》	名詞
＠りりあなのしように	《リリアナの使用人》	名詞
＠りりあなのしようにん	《リリアナの使用人》	名詞
＠り	《リリアナの信奉者》	名詞
＠りり	《リリアナの信奉者》	名詞
＠りりあ	《リリアナの信奉者》	名詞
＠りりあな	《リリアナの信奉者》	名詞
＠りりあなの	《リリアナの信奉者》	名詞
＠りりあなのし	《リリアナの信奉者》	名詞
＠りりあなのしん	《リリアナの信奉者》	名詞
＠りりあなのしんぽ	《リリアナの信奉者》	名詞
＠りりあなのしんぽう	《リリアナの信奉者》	名詞
＠りりあなのしんぽうし	《リリアナの信奉者》	名詞
＠りりあなのしんぽうしゃ	《リリアナの信奉者》	名詞
＠り	《リリアナの軍旗手》	名詞
＠りり	《リリアナの軍旗手》	名詞
＠りりあ	《リリアナの軍旗手》	名詞
＠りりあな	《リリアナの軍旗手》	名詞
＠りりあなの	《リリアナの軍旗手》	名詞
＠りりあなのぐ	《リリアナの軍旗手》	名詞
＠りりあなのぐん	《リリアナの軍旗手》	名詞
＠りりあなのぐんき	《リリアナの軍旗手》	名詞
＠りりあなのぐんきて	《リリアナの軍旗手》	名詞
＠る	《ルーンの光輪》	名詞
＠るー	《ルーンの光輪》	名詞
＠るーん	《ルーンの光輪》	名詞
＠るーんの	《ルーンの光輪》	名詞
＠るーんのこ	《ルーンの光輪》	名詞
＠るーんのこう	《ルーンの光輪》	名詞
＠るーんのこうり	《ルーンの光輪》	名詞
＠るーんのこうりん	《ルーンの光輪》	名詞
＠る	《ルーンの壁》	名詞
＠るー	《ルーンの壁》	名詞
＠るーん	《ルーンの壁》	名詞
＠るーんの	《ルーンの壁》	名詞
＠るーんのか	《ルーンの壁》	名詞
＠るーんのかべ	《ルーンの壁》	名詞
＠れ	《レインジャーの悪知恵》	名詞
＠れい	《レインジャーの悪知恵》	名詞
＠れいん	《レインジャーの悪知恵》	名詞
＠れいんじ	《レインジャーの悪知恵》	名詞
＠れいんじゃ	《レインジャーの悪知恵》	名詞
＠れいんじゃー	《レインジャーの悪知恵》	名詞
＠れいんじゃーの	《レインジャーの悪知恵》	名詞
＠れいんじゃーのわ	《レインジャーの悪知恵》	名詞
＠れいんじゃーのわる	《レインジャーの悪知恵》	名詞
＠れいんじゃーのわるぢ	《レインジャーの悪知恵》	名詞
＠れいんじゃーのわるぢえ	《レインジャーの悪知恵》	名詞
＠ヴ	《ヴォーデイリアの秘儀術師》	名詞
＠ヴぉ	《ヴォーデイリアの秘儀術師》	名詞
＠ヴぉー	《ヴォーデイリアの秘儀術師》	名詞
＠ヴぉーで	《ヴォーデイリアの秘儀術師》	名詞
＠ヴぉーでい	《ヴォーデイリアの秘儀術師》	名詞
＠ヴぉーでいり	《ヴォーデイリアの秘儀術師》	名詞
＠ヴぉーでいりあ	《ヴォーデイリアの秘儀術師》	名詞
＠ヴぉーでいりあの	《ヴォーデイリアの秘儀術師》	名詞
＠ヴぉーでいりあのひ	《ヴォーデイリアの秘儀術師》	名詞
＠ヴぉーでいりあのひぎ	《ヴォーデイリアの秘儀術師》	名詞
＠ヴぉーでいりあのひぎじ	《ヴォーデイリアの秘儀術師》	名詞
＠ヴぉーでいりあのひぎじゅ	《ヴォーデイリアの秘儀術師》	名詞
＠ヴぉーでいりあのひぎじゅつ	《ヴォーデイリアの秘儀術師》	名詞
＠ヴぉーでいりあのひぎじゅつし	《ヴォーデイリアの秘儀術師》	名詞
＠ヴ	《ヴリンの翼馬》	名詞
＠ヴり	《ヴリンの翼馬》	名詞
＠ヴりん	《ヴリンの翼馬》	名詞
＠ヴりんの	《ヴリンの翼馬》	名詞
＠ヴりんのつ	《ヴリンの翼馬》	名詞
＠ヴりんのつば	《ヴリンの翼馬》	名詞
＠ヴりんのつばさ	《ヴリンの翼馬》	名詞
＠ヴりんのつばさば	《ヴリンの翼馬》	名詞
＠い	《一斉噴火》	名詞
＠いっ	《一斉噴火》	名詞
＠いっせ	《一斉噴火》	名詞
＠いっせい	《一斉噴火》	名詞
＠いっせいふ	《一斉噴火》	名詞
＠いっせいふん	《一斉噴火》	名詞
＠いっせいふんか	《一斉噴火》	名詞
＠ば	《万物の聖域》	名詞
＠ばん	《万物の聖域》	名詞
＠ばんぶ	《万物の聖域》	名詞
＠ばんぶつ	《万物の聖域》	名詞
＠ばんぶつの	《万物の聖域》	名詞
＠ばんぶつのせ	《万物の聖域》	名詞
＠ばんぶつのせい	《万物の聖域》	名詞
＠ばんぶつのせいい	《万物の聖域》	名詞
＠ばんぶつのせいいき	《万物の聖域》	名詞
＠ぶ	《不気味な教示者》	名詞
＠ぶき	《不気味な教示者》	名詞
＠ぶきみ	《不気味な教示者》	名詞
＠ぶきみな	《不気味な教示者》	名詞
＠ぶきみなき	《不気味な教示者》	名詞
＠ぶきみなきょ	《不気味な教示者》	名詞
＠ぶきみなきょう	《不気味な教示者》	名詞
＠ぶきみなきょうじ	《不気味な教示者》	名詞
＠ぶきみなきょうじし	《不気味な教示者》	名詞
＠ぶきみなきょうじしゃ	《不気味な教示者》	名詞
＠ふ	《不連続性》	名詞
＠ふれ	《不連続性》	名詞
＠ふれん	《不連続性》	名詞
＠ふれんぞ	《不連続性》	名詞
＠ふれんぞく	《不連続性》	名詞
＠ふれんぞくせ	《不連続性》	名詞
＠ふれんぞくせい	《不連続性》	名詞
＠こ	《九つの命》	名詞
＠ここ	《九つの命》	名詞
＠ここの	《九つの命》	名詞
＠ここのつ	《九つの命》	名詞
＠ここのつの	《九つの命》	名詞
＠ここのつのい	《九つの命》	名詞
＠ここのつのいの	《九つの命》	名詞
＠ここのつのいのち	《九つの命》	名詞
＠じ	《人生は続く》	名詞
＠じん	《人生は続く》	名詞
＠じんせ	《人生は続く》	名詞
＠じんせい	《人生は続く》	名詞
＠じんせいは	《人生は続く》	名詞
＠じんせいはつ	《人生は続く》	名詞
＠じんせいはつづ	《人生は続く》	名詞
＠じんせいはつづく	《人生は続く》	名詞
＠ひ	《人目を引く詮索者》	名詞
＠ひと	《人目を引く詮索者》	名詞
＠ひとめ	《人目を引く詮索者》	名詞
＠ひとめを	《人目を引く詮索者》	名詞
＠ひとめをひ	《人目を引く詮索者》	名詞
＠ひとめをひく	《人目を引く詮索者》	名詞
＠ひとめをひくせ	《人目を引く詮索者》	名詞
＠ひとめをひくせん	《人目を引く詮索者》	名詞
＠ひとめをひくせんさ	《人目を引く詮索者》	名詞
＠ひとめをひくせんさく	《人目を引く詮索者》	名詞
＠ひとめをひくせんさくし	《人目を引く詮索者》	名詞
＠ひとめをひくせんさくしゃ	《人目を引く詮索者》	名詞
＠か	《仮面の悪党》	名詞
＠かめ	《仮面の悪党》	名詞
＠かめん	《仮面の悪党》	名詞
＠かめんの	《仮面の悪党》	名詞
＠かめんのあ	《仮面の悪党》	名詞
＠かめんのあく	《仮面の悪党》	名詞
＠かめんのあくと	《仮面の悪党》	名詞
＠かめんのあくとう	《仮面の悪党》	名詞
＠し	《信仰の足枷》	名詞
＠しん	《信仰の足枷》	名詞
＠しんこ	《信仰の足枷》	名詞
＠しんこう	《信仰の足枷》	名詞
＠しんこうの	《信仰の足枷》	名詞
＠しんこうのあ	《信仰の足枷》	名詞
＠しんこうのあし	《信仰の足枷》	名詞
＠しんこうのあしか	《信仰の足枷》	名詞
＠しんこうのあしかせ	《信仰の足枷》	名詞
＠へ	《偏執的な縫い師》	名詞
＠へん	《偏執的な縫い師》	名詞
＠へんし	《偏執的な縫い師》	名詞
＠へんしゅ	《偏執的な縫い師》	名詞
＠へんしゅう	《偏執的な縫い師》	名詞
＠へんしゅうて	《偏執的な縫い師》	名詞
＠へんしゅうてき	《偏執的な縫い師》	名詞
＠へんしゅうてきな	《偏執的な縫い師》	名詞
＠へんしゅうてきなぬ	《偏執的な縫い師》	名詞
＠へんしゅうてきなぬい	《偏執的な縫い師》	名詞
＠へんしゅうてきなぬいし	《偏執的な縫い師》	名詞
＠こ	《光輝の泉》	名詞
＠こう	《光輝の泉》	名詞
＠こうき	《光輝の泉》	名詞
＠こうきの	《光輝の泉》	名詞
＠こうきのい	《光輝の泉》	名詞
＠こうきのいず	《光輝の泉》	名詞
＠こうきのいずみ	《光輝の泉》	名詞
＠さ	《再命》	名詞
＠さい	《再命》	名詞
＠さいめ	《再命》	名詞
＠さいめい	《再命》	名詞
＠か	《冠滅ぼしのガドラク》	名詞
＠かん	《冠滅ぼしのガドラク》	名詞
＠かんむ	《冠滅ぼしのガドラク》	名詞
＠かんむり	《冠滅ぼしのガドラク》	名詞
＠かんむりほ	《冠滅ぼしのガドラク》	名詞
＠かんむりほろ	《冠滅ぼしのガドラク》	名詞
＠かんむりほろぼ	《冠滅ぼしのガドラク》	名詞
＠かんむりほろぼし	《冠滅ぼしのガドラク》	名詞
＠かんむりほろぼしの	《冠滅ぼしのガドラク》	名詞
＠かんむりほろぼしのが	《冠滅ぼしのガドラク》	名詞
＠かんむりほろぼしのがど	《冠滅ぼしのガドラク》	名詞
＠かんむりほろぼしのがどら	《冠滅ぼしのガドラク》	名詞
＠かんむりほろぼしのがどらく	《冠滅ぼしのガドラク》	名詞
＠が	《冠滅ぼしのガドラク》	名詞
＠がど	《冠滅ぼしのガドラク》	名詞
＠がどら	《冠滅ぼしのガドラク》	名詞
＠がどらく	《冠滅ぼしのガドラク》	名詞
＠め	《冥府の傷跡》	名詞
＠めい	《冥府の傷跡》	名詞
＠めいふ	《冥府の傷跡》	名詞
＠めいふの	《冥府の傷跡》	名詞
＠めいふのき	《冥府の傷跡》	名詞
＠めいふのきず	《冥府の傷跡》	名詞
＠めいふのきずあ	《冥府の傷跡》	名詞
＠めいふのきずあと	《冥府の傷跡》	名詞
＠が	《凱旋の神殿》	名詞
＠がい	《凱旋の神殿》	名詞
＠がいせ	《凱旋の神殿》	名詞
＠がいせん	《凱旋の神殿》	名詞
＠がいせんの	《凱旋の神殿》	名詞
＠がいせんのし	《凱旋の神殿》	名詞
＠がいせんのしん	《凱旋の神殿》	名詞
＠がいせんのしんで	《凱旋の神殿》	名詞
＠がいせんのしんでん	《凱旋の神殿》	名詞
＠き	《凶兆艦隊の戦争屋》	名詞
＠きょ	《凶兆艦隊の戦争屋》	名詞
＠きょう	《凶兆艦隊の戦争屋》	名詞
＠きょうち	《凶兆艦隊の戦争屋》	名詞
＠きょうちょ	《凶兆艦隊の戦争屋》	名詞
＠きょうちょう	《凶兆艦隊の戦争屋》	名詞
＠きょうちょうか	《凶兆艦隊の戦争屋》	名詞
＠きょうちょうかん	《凶兆艦隊の戦争屋》	名詞
＠きょうちょうかんた	《凶兆艦隊の戦争屋》	名詞
＠きょうちょうかんたい	《凶兆艦隊の戦争屋》	名詞
＠きょうちょうかんたいの	《凶兆艦隊の戦争屋》	名詞
＠きょうちょうかんたいのせ	《凶兆艦隊の戦争屋》	名詞
＠きょうちょうかんたいのせん	《凶兆艦隊の戦争屋》	名詞
＠きょうちょうかんたいのせんそ	《凶兆艦隊の戦争屋》	名詞
＠きょうちょうかんたいのせんそう	《凶兆艦隊の戦争屋》	名詞
＠きょうちょうかんたいのせんそうや	《凶兆艦隊の戦争屋》	名詞
＠し	《初心者の過ち》	名詞
＠しょ	《初心者の過ち》	名詞
＠しょし	《初心者の過ち》	名詞
＠しょしん	《初心者の過ち》	名詞
＠しょしんし	《初心者の過ち》	名詞
＠しょしんしゃ	《初心者の過ち》	名詞
＠しょしんしゃの	《初心者の過ち》	名詞
＠しょしんしゃのあ	《初心者の過ち》	名詞
＠しょしんしゃのあや	《初心者の過ち》	名詞
＠しょしんしゃのあやま	《初心者の過ち》	名詞
＠しょしんしゃのあやまち	《初心者の過ち》	名詞
＠ご	《剛力化》	名詞
＠ごう	《剛力化》	名詞
＠ごうり	《剛力化》	名詞
＠ごうりき	《剛力化》	名詞
＠ごうりきか	《剛力化》	名詞
＠け	《剣歯虎のやっかいもの》	名詞
＠けん	《剣歯虎のやっかいもの》	名詞
＠けんし	《剣歯虎のやっかいもの》	名詞
＠けんしこ	《剣歯虎のやっかいもの》	名詞
＠けんしこの	《剣歯虎のやっかいもの》	名詞
＠けんしこのや	《剣歯虎のやっかいもの》	名詞
＠けんしこのやっ	《剣歯虎のやっかいもの》	名詞
＠けんしこのやっか	《剣歯虎のやっかいもの》	名詞
＠けんしこのやっかい	《剣歯虎のやっかいもの》	名詞
＠けんしこのやっかいも	《剣歯虎のやっかいもの》	名詞
＠けんしこのやっかいもの	《剣歯虎のやっかいもの》	名詞
＠ゆ	《勇敢な駿馬》	名詞
＠ゆう	《勇敢な駿馬》	名詞
＠ゆうか	《勇敢な駿馬》	名詞
＠ゆうかん	《勇敢な駿馬》	名詞
＠ゆうかんな	《勇敢な駿馬》	名詞
＠ゆうかんなし	《勇敢な駿馬》	名詞
＠ゆうかんなしゅ	《勇敢な駿馬》	名詞
＠ゆうかんなしゅん	《勇敢な駿馬》	名詞
＠ゆうかんなしゅんば	《勇敢な駿馬》	名詞
＠ど	《動態の占い師》	名詞
＠どう	《動態の占い師》	名詞
＠どうた	《動態の占い師》	名詞
＠どうたい	《動態の占い師》	名詞
＠どうたいの	《動態の占い師》	名詞
＠どうたいのう	《動態の占い師》	名詞
＠どうたいのうら	《動態の占い師》	名詞
＠どうたいのうらな	《動態の占い師》	名詞
＠どうたいのうらない	《動態の占い師》	名詞
＠どうたいのうらないし	《動態の占い師》	名詞
＠ほ	《包囲戦の打撃者》	名詞
＠ほう	《包囲戦の打撃者》	名詞
＠ほうい	《包囲戦の打撃者》	名詞
＠ほういせ	《包囲戦の打撃者》	名詞
＠ほういせん	《包囲戦の打撃者》	名詞
＠ほういせんの	《包囲戦の打撃者》	名詞
＠ほういせんのだ	《包囲戦の打撃者》	名詞
＠ほういせんのだげ	《包囲戦の打撃者》	名詞
＠ほういせんのだげき	《包囲戦の打撃者》	名詞
＠ほういせんのだげきし	《包囲戦の打撃者》	名詞
＠ほういせんのだげきしゃ	《包囲戦の打撃者》	名詞
＠き	《北風の歌姫》	名詞
＠きた	《北風の歌姫》	名詞
＠きたか	《北風の歌姫》	名詞
＠きたかぜ	《北風の歌姫》	名詞
＠きたかぜの	《北風の歌姫》	名詞
＠きたかぜのう	《北風の歌姫》	名詞
＠きたかぜのうた	《北風の歌姫》	名詞
＠きたかぜのうたひ	《北風の歌姫》	名詞
＠きたかぜのうたひめ	《北風の歌姫》	名詞
＠き	《協約のペガサス》	名詞
＠きょ	《協約のペガサス》	名詞
＠きょう	《協約のペガサス》	名詞
＠きょうや	《協約のペガサス》	名詞
＠きょうやく	《協約のペガサス》	名詞
＠きょうやくの	《協約のペガサス》	名詞
＠きょうやくのぺ	《協約のペガサス》	名詞
＠きょうやくのぺが	《協約のペガサス》	名詞
＠きょうやくのぺがさ	《協約のペガサス》	名詞
＠きょうやくのぺがさす	《協約のペガサス》	名詞
＠げ	《原初の力》	名詞
＠げん	《原初の力》	名詞
＠げんし	《原初の力》	名詞
＠げんしょ	《原初の力》	名詞
＠げんしょの	《原初の力》	名詞
＠げんしょのち	《原初の力》	名詞
＠げんしょのちか	《原初の力》	名詞
＠げんしょのちから	《原初の力》	名詞
＠き	《厳しい滑空指導員》	名詞
＠きび	《厳しい滑空指導員》	名詞
＠きびし	《厳しい滑空指導員》	名詞
＠きびしい	《厳しい滑空指導員》	名詞
＠きびしいか	《厳しい滑空指導員》	名詞
＠きびしいかっ	《厳しい滑空指導員》	名詞
＠きびしいかっく	《厳しい滑空指導員》	名詞
＠きびしいかっくう	《厳しい滑空指導員》	名詞
＠きびしいかっくうし	《厳しい滑空指導員》	名詞
＠きびしいかっくうしど	《厳しい滑空指導員》	名詞
＠きびしいかっくうしどう	《厳しい滑空指導員》	名詞
＠きびしいかっくうしどうい	《厳しい滑空指導員》	名詞
＠きびしいかっくうしどういん	《厳しい滑空指導員》	名詞
＠そ	《双刃の暗殺者》	名詞
＠そう	《双刃の暗殺者》	名詞
＠そうじ	《双刃の暗殺者》	名詞
＠そうじん	《双刃の暗殺者》	名詞
＠そうじんの	《双刃の暗殺者》	名詞
＠そうじんのあ	《双刃の暗殺者》	名詞
＠そうじんのあん	《双刃の暗殺者》	名詞
＠そうじんのあんさ	《双刃の暗殺者》	名詞
＠そうじんのあんさつ	《双刃の暗殺者》	名詞
＠そうじんのあんさつし	《双刃の暗殺者》	名詞
＠そうじんのあんさつしゃ	《双刃の暗殺者》	名詞
＠と	《取り消し》	名詞
＠とり	《取り消し》	名詞
＠とりけ	《取り消し》	名詞
＠とりけし	《取り消し》	名詞
＠と	《取り除き》	名詞
＠とり	《取り除き》	名詞
＠とりの	《取り除き》	名詞
＠とりのぞ	《取り除き》	名詞
＠とりのぞき	《取り除き》	名詞
＠じ	《叙爵》	名詞
＠じょ	《叙爵》	名詞
＠じょし	《叙爵》	名詞
＠じょしゃ	《叙爵》	名詞
＠じょしゃく	《叙爵》	名詞
＠じ	《呪文喰いの奇魔》	名詞
＠じゅ	《呪文喰いの奇魔》	名詞
＠じゅも	《呪文喰いの奇魔》	名詞
＠じゅもん	《呪文喰いの奇魔》	名詞
＠じゅもんく	《呪文喰いの奇魔》	名詞
＠じゅもんくい	《呪文喰いの奇魔》	名詞
＠じゅもんくいの	《呪文喰いの奇魔》	名詞
＠じゅもんくいのき	《呪文喰いの奇魔》	名詞
＠じゅもんくいのきま	《呪文喰いの奇魔》	名詞
＠と	《唱え損ね》	名詞
＠とな	《唱え損ね》	名詞
＠となえ	《唱え損ね》	名詞
＠となえそ	《唱え損ね》	名詞
＠となえそこ	《唱え損ね》	名詞
＠となえそこね	《唱え損ね》	名詞
＠け	《啓示の雨》	名詞
＠けい	《啓示の雨》	名詞
＠けいじ	《啓示の雨》	名詞
＠けいじの	《啓示の雨》	名詞
＠けいじのあ	《啓示の雨》	名詞
＠けいじのあめ	《啓示の雨》	名詞
＠か	《噛み傷への興奮》	名詞
＠かみ	《噛み傷への興奮》	名詞
＠かみき	《噛み傷への興奮》	名詞
＠かみきず	《噛み傷への興奮》	名詞
＠かみきずへ	《噛み傷への興奮》	名詞
＠かみきずへの	《噛み傷への興奮》	名詞
＠かみきずへのこ	《噛み傷への興奮》	名詞
＠かみきずへのこう	《噛み傷への興奮》	名詞
＠かみきずへのこうふ	《噛み傷への興奮》	名詞
＠かみきずへのこうふん	《噛み傷への興奮》	名詞
＠け	《堅牢な盾仲間》	名詞
＠けん	《堅牢な盾仲間》	名詞
＠けんろ	《堅牢な盾仲間》	名詞
＠けんろう	《堅牢な盾仲間》	名詞
＠けんろうな	《堅牢な盾仲間》	名詞
＠けんろうなた	《堅牢な盾仲間》	名詞
＠けんろうなたて	《堅牢な盾仲間》	名詞
＠けんろうなたてな	《堅牢な盾仲間》	名詞
＠けんろうなたてなか	《堅牢な盾仲間》	名詞
＠けんろうなたてなかま	《堅牢な盾仲間》	名詞
＠ぼ	《墓所に潜むもの》	名詞
＠ぼし	《墓所に潜むもの》	名詞
＠ぼしょ	《墓所に潜むもの》	名詞
＠ぼしょに	《墓所に潜むもの》	名詞
＠ぼしょにひ	《墓所に潜むもの》	名詞
＠ぼしょにひそ	《墓所に潜むもの》	名詞
＠ぼしょにひそむ	《墓所に潜むもの》	名詞
＠ぼしょにひそむも	《墓所に潜むもの》	名詞
＠ぼしょにひそむもの	《墓所に潜むもの》	名詞
＠ぼ	《墓碑のゴーレム》	名詞
＠ぼひ	《墓碑のゴーレム》	名詞
＠ぼひの	《墓碑のゴーレム》	名詞
＠ぼひのご	《墓碑のゴーレム》	名詞
＠ぼひのごー	《墓碑のゴーレム》	名詞
＠ぼひのごーれ	《墓碑のゴーレム》	名詞
＠ぼひのごーれむ	《墓碑のゴーレム》	名詞
＠が	《外交官、マンガラ》	名詞
＠がい	《外交官、マンガラ》	名詞
＠がいこ	《外交官、マンガラ》	名詞
＠がいこう	《外交官、マンガラ》	名詞
＠がいこうか	《外交官、マンガラ》	名詞
＠がいこうかん	《外交官、マンガラ》	名詞
＠がいこうかん、	《外交官、マンガラ》	名詞
＠がいこうかん、ま	《外交官、マンガラ》	名詞
＠がいこうかん、まん	《外交官、マンガラ》	名詞
＠がいこうかん、まんが	《外交官、マンガラ》	名詞
＠がいこうかん、まんがら	《外交官、マンガラ》	名詞
＠ま	《外交官、マンガラ》	名詞
＠まん	《外交官、マンガラ》	名詞
＠まんが	《外交官、マンガラ》	名詞
＠まんがら	《外交官、マンガラ》	名詞
＠よ	《夜明けの突撃獣》	名詞
＠よあ	《夜明けの突撃獣》	名詞
＠よあけ	《夜明けの突撃獣》	名詞
＠よあけの	《夜明けの突撃獣》	名詞
＠よあけのと	《夜明けの突撃獣》	名詞
＠よあけのとつ	《夜明けの突撃獣》	名詞
＠よあけのとつげ	《夜明けの突撃獣》	名詞
＠よあけのとつげき	《夜明けの突撃獣》	名詞
＠よあけのとつげきけ	《夜明けの突撃獣》	名詞
＠よあけのとつげきけも	《夜明けの突撃獣》	名詞
＠よあけのとつげきけもの	《夜明けの突撃獣》	名詞
＠お	《大慌ての棚卸し》	名詞
＠おお	《大慌ての棚卸し》	名詞
＠おおあ	《大慌ての棚卸し》	名詞
＠おおあわ	《大慌ての棚卸し》	名詞
＠おおあわて	《大慌ての棚卸し》	名詞
＠おおあわての	《大慌ての棚卸し》	名詞
＠おおあわてのた	《大慌ての棚卸し》	名詞
＠おおあわてのたな	《大慌ての棚卸し》	名詞
＠おおあわてのたなお	《大慌ての棚卸し》	名詞
＠おおあわてのたなおろ	《大慌ての棚卸し》	名詞
＠おおあわてのたなおろし	《大慌ての棚卸し》	名詞
＠た	《大殺漢》	名詞
＠たい	《大殺漢》	名詞
＠たいさ	《大殺漢》	名詞
＠たいさつ	《大殺漢》	名詞
＠たいさつか	《大殺漢》	名詞
＠たいさつかん	《大殺漢》	名詞
＠て	《天使への昇天》	名詞
＠てん	《天使への昇天》	名詞
＠てんし	《天使への昇天》	名詞
＠てんしへ	《天使への昇天》	名詞
＠てんしへの	《天使への昇天》	名詞
＠てんしへのし	《天使への昇天》	名詞
＠てんしへのしょ	《天使への昇天》	名詞
＠てんしへのしょう	《天使への昇天》	名詞
＠てんしへのしょうて	《天使への昇天》	名詞
＠てんしへのしょうてん	《天使への昇天》	名詞
＠て	《天啓の神殿》	名詞
＠てん	《天啓の神殿》	名詞
＠てんけ	《天啓の神殿》	名詞
＠てんけい	《天啓の神殿》	名詞
＠てんけいの	《天啓の神殿》	名詞
＠てんけいのし	《天啓の神殿》	名詞
＠てんけいのしん	《天啓の神殿》	名詞
＠てんけいのしんで	《天啓の神殿》	名詞
＠てんけいのしんでん	《天啓の神殿》	名詞
＠て	《天球の見張り》	名詞
＠てん	《天球の見張り》	名詞
＠てんき	《天球の見張り》	名詞
＠てんきゅ	《天球の見張り》	名詞
＠てんきゅう	《天球の見張り》	名詞
＠てんきゅうの	《天球の見張り》	名詞
＠てんきゅうのみ	《天球の見張り》	名詞
＠てんきゅうのみは	《天球の見張り》	名詞
＠てんきゅうのみはり	《天球の見張り》	名詞
＠て	《天界の処罰者》	名詞
＠てん	《天界の処罰者》	名詞
＠てんか	《天界の処罰者》	名詞
＠てんかい	《天界の処罰者》	名詞
＠てんかいの	《天界の処罰者》	名詞
＠てんかいのし	《天界の処罰者》	名詞
＠てんかいのしょ	《天界の処罰者》	名詞
＠てんかいのしょば	《天界の処罰者》	名詞
＠てんかいのしょばつ	《天界の処罰者》	名詞
＠てんかいのしょばつし	《天界の処罰者》	名詞
＠てんかいのしょばつしゃ	《天界の処罰者》	名詞
＠て	《天界の語り部》	名詞
＠てん	《天界の語り部》	名詞
＠てんか	《天界の語り部》	名詞
＠てんかい	《天界の語り部》	名詞
＠てんかいの	《天界の語り部》	名詞
＠てんかいのか	《天界の語り部》	名詞
＠てんかいのかた	《天界の語り部》	名詞
＠てんかいのかたり	《天界の語り部》	名詞
＠てんかいのかたりべ	《天界の語り部》	名詞
＠じ	《実験的過負荷》	名詞
＠じっ	《実験的過負荷》	名詞
＠じっけ	《実験的過負荷》	名詞
＠じっけん	《実験的過負荷》	名詞
＠じっけんて	《実験的過負荷》	名詞
＠じっけんてき	《実験的過負荷》	名詞
＠じっけんてきか	《実験的過負荷》	名詞
＠じっけんてきかふ	《実験的過負荷》	名詞
＠じっけんてきかふか	《実験的過負荷》	名詞
＠ぐ	《寓話の小道》	名詞
＠ぐう	《寓話の小道》	名詞
＠ぐうわ	《寓話の小道》	名詞
＠ぐうわの	《寓話の小道》	名詞
＠ぐうわのこ	《寓話の小道》	名詞
＠ぐうわのこみ	《寓話の小道》	名詞
＠ぐうわのこみち	《寓話の小道》	名詞
＠ふ	《封じ込める僧侶》	名詞
＠ふう	《封じ込める僧侶》	名詞
＠ふうじ	《封じ込める僧侶》	名詞
＠ふうじこ	《封じ込める僧侶》	名詞
＠ふうじこめ	《封じ込める僧侶》	名詞
＠ふうじこめる	《封じ込める僧侶》	名詞
＠ふうじこめるそ	《封じ込める僧侶》	名詞
＠ふうじこめるそう	《封じ込める僧侶》	名詞
＠ふうじこめるそうり	《封じ込める僧侶》	名詞
＠ふうじこめるそうりょ	《封じ込める僧侶》	名詞
＠そ	《尊敬される語り手、ニアンビ》	名詞
＠そん	《尊敬される語り手、ニアンビ》	名詞
＠そんけ	《尊敬される語り手、ニアンビ》	名詞
＠そんけい	《尊敬される語り手、ニアンビ》	名詞
＠そんけいさ	《尊敬される語り手、ニアンビ》	名詞
＠そんけいされ	《尊敬される語り手、ニアンビ》	名詞
＠そんけいされる	《尊敬される語り手、ニアンビ》	名詞
＠そんけいされるか	《尊敬される語り手、ニアンビ》	名詞
＠そんけいされるかた	《尊敬される語り手、ニアンビ》	名詞
＠そんけいされるかたり	《尊敬される語り手、ニアンビ》	名詞
＠そんけいされるかたりて	《尊敬される語り手、ニアンビ》	名詞
＠そんけいされるかたりて、	《尊敬される語り手、ニアンビ》	名詞
＠そんけいされるかたりて、に	《尊敬される語り手、ニアンビ》	名詞
＠そんけいされるかたりて、にあ	《尊敬される語り手、ニアンビ》	名詞
＠そんけいされるかたりて、にあん	《尊敬される語り手、ニアンビ》	名詞
＠そんけいされるかたりて、にあんび	《尊敬される語り手、ニアンビ》	名詞
＠に	《尊敬される語り手、ニアンビ》	名詞
＠にあ	《尊敬される語り手、ニアンビ》	名詞
＠にあん	《尊敬される語り手、ニアンビ》	名詞
＠にあんび	《尊敬される語り手、ニアンビ》	名詞
＠し	《小剣》	名詞
＠しょ	《小剣》	名詞
＠しょう	《小剣》	名詞
＠しょうけ	《小剣》	名詞
＠しょうけん	《小剣》	名詞
＠し	《屍呆症》	名詞
＠しほ	《屍呆症》	名詞
＠しほう	《屍呆症》	名詞
＠しほうし	《屍呆症》	名詞
＠しほうしょ	《屍呆症》	名詞
＠しほうしょう	《屍呆症》	名詞
＠し	《屍肉地虫》	名詞
＠しに	《屍肉地虫》	名詞
＠しにく	《屍肉地虫》	名詞
＠しにくじ	《屍肉地虫》	名詞
＠しにくじむ	《屍肉地虫》	名詞
＠しにくじむし	《屍肉地虫》	名詞
＠い	《岩だらけの高地》	名詞
＠いわ	《岩だらけの高地》	名詞
＠いわだ	《岩だらけの高地》	名詞
＠いわだら	《岩だらけの高地》	名詞
＠いわだらけ	《岩だらけの高地》	名詞
＠いわだらけの	《岩だらけの高地》	名詞
＠いわだらけのこ	《岩だらけの高地》	名詞
＠いわだらけのこう	《岩だらけの高地》	名詞
＠いわだらけのこうち	《岩だらけの高地》	名詞
＠み	《峰の恐怖》	名詞
＠みね	《峰の恐怖》	名詞
＠みねの	《峰の恐怖》	名詞
＠みねのき	《峰の恐怖》	名詞
＠みねのきょ	《峰の恐怖》	名詞
＠みねのきょう	《峰の恐怖》	名詞
＠みねのきょうふ	《峰の恐怖》	名詞
＠す	《崇高な天啓》	名詞
＠すう	《崇高な天啓》	名詞
＠すうこ	《崇高な天啓》	名詞
＠すうこう	《崇高な天啓》	名詞
＠すうこうな	《崇高な天啓》	名詞
＠すうこうなて	《崇高な天啓》	名詞
＠すうこうなてん	《崇高な天啓》	名詞
＠すうこうなてんけ	《崇高な天啓》	名詞
＠すうこうなてんけい	《崇高な天啓》	名詞
＠ら	《嵐翼の精体》	名詞
＠らん	《嵐翼の精体》	名詞
＠らんよ	《嵐翼の精体》	名詞
＠らんよく	《嵐翼の精体》	名詞
＠らんよくの	《嵐翼の精体》	名詞
＠らんよくのせ	《嵐翼の精体》	名詞
＠らんよくのせい	《嵐翼の精体》	名詞
＠らんよくのせいた	《嵐翼の精体》	名詞
＠らんよくのせいたい	《嵐翼の精体》	名詞
＠き	《巨大な戦慄大口》	名詞
＠きょ	《巨大な戦慄大口》	名詞
＠きょだ	《巨大な戦慄大口》	名詞
＠きょだい	《巨大な戦慄大口》	名詞
＠きょだいな	《巨大な戦慄大口》	名詞
＠きょだいなせ	《巨大な戦慄大口》	名詞
＠きょだいなせん	《巨大な戦慄大口》	名詞
＠きょだいなせんり	《巨大な戦慄大口》	名詞
＠きょだいなせんりつ	《巨大な戦慄大口》	名詞
＠きょだいなせんりつお	《巨大な戦慄大口》	名詞
＠きょだいなせんりつおお	《巨大な戦慄大口》	名詞
＠きょだいなせんりつおおく	《巨大な戦慄大口》	名詞
＠きょだいなせんりつおおくち	《巨大な戦慄大口》	名詞
＠ま	《巻き添え》	名詞
＠まき	《巻き添え》	名詞
＠まきぞ	《巻き添え》	名詞
＠まきぞえ	《巻き添え》	名詞
＠ま	《巻き直し》	名詞
＠まき	《巻き直し》	名詞
＠まきな	《巻き直し》	名詞
＠まきなお	《巻き直し》	名詞
＠まきなおし	《巻き直し》	名詞
＠ほ	《帆凧の掠め盗り》	名詞
＠ほだ	《帆凧の掠め盗り》	名詞
＠ほだこ	《帆凧の掠め盗り》	名詞
＠ほだこの	《帆凧の掠め盗り》	名詞
＠ほだこのか	《帆凧の掠め盗り》	名詞
＠ほだこのかす	《帆凧の掠め盗り》	名詞
＠ほだこのかすめ	《帆凧の掠め盗り》	名詞
＠ほだこのかすめと	《帆凧の掠め盗り》	名詞
＠ほだこのかすめとり	《帆凧の掠め盗り》	名詞
＠へ	《平穏な入り江》	名詞
＠へい	《平穏な入り江》	名詞
＠へいお	《平穏な入り江》	名詞
＠へいおん	《平穏な入り江》	名詞
＠へいおんな	《平穏な入り江》	名詞
＠へいおんない	《平穏な入り江》	名詞
＠へいおんないり	《平穏な入り江》	名詞
＠へいおんないりえ	《平穏な入り江》	名詞
＠ゆ	《幽体のこそ泥》	名詞
＠ゆう	《幽体のこそ泥》	名詞
＠ゆうた	《幽体のこそ泥》	名詞
＠ゆうたい	《幽体のこそ泥》	名詞
＠ゆうたいの	《幽体のこそ泥》	名詞
＠ゆうたいのこ	《幽体のこそ泥》	名詞
＠ゆうたいのこそ	《幽体のこそ泥》	名詞
＠ゆうたいのこそど	《幽体のこそ泥》	名詞
＠ゆうたいのこそどろ	《幽体のこそ泥》	名詞
＠す	《廃れた高地の聖域》	名詞
＠すた	《廃れた高地の聖域》	名詞
＠すたれ	《廃れた高地の聖域》	名詞
＠すたれた	《廃れた高地の聖域》	名詞
＠すたれたこ	《廃れた高地の聖域》	名詞
＠すたれたこう	《廃れた高地の聖域》	名詞
＠すたれたこうち	《廃れた高地の聖域》	名詞
＠すたれたこうちの	《廃れた高地の聖域》	名詞
＠すたれたこうちのせ	《廃れた高地の聖域》	名詞
＠すたれたこうちのせい	《廃れた高地の聖域》	名詞
＠すたれたこうちのせいい	《廃れた高地の聖域》	名詞
＠すたれたこうちのせいいき	《廃れた高地の聖域》	名詞
＠ひ	《引きずり鬼》	名詞
＠ひき	《引きずり鬼》	名詞
＠ひきず	《引きずり鬼》	名詞
＠ひきずり	《引きずり鬼》	名詞
＠ひきずりお	《引きずり鬼》	名詞
＠ひきずりおに	《引きずり鬼》	名詞
＠き	《強迫》	名詞
＠きょ	《強迫》	名詞
＠きょう	《強迫》	名詞
＠きょうは	《強迫》	名詞
＠きょうはく	《強迫》	名詞
＠き	《強風の急襲者》	名詞
＠きょ	《強風の急襲者》	名詞
＠きょう	《強風の急襲者》	名詞
＠きょうふ	《強風の急襲者》	名詞
＠きょうふう	《強風の急襲者》	名詞
＠きょうふうの	《強風の急襲者》	名詞
＠きょうふうのき	《強風の急襲者》	名詞
＠きょうふうのきゅ	《強風の急襲者》	名詞
＠きょうふうのきゅう	《強風の急襲者》	名詞
＠きょうふうのきゅうし	《強風の急襲者》	名詞
＠きょうふうのきゅうしゅ	《強風の急襲者》	名詞
＠きょうふうのきゅうしゅう	《強風の急襲者》	名詞
＠きょうふうのきゅうしゅうし	《強風の急襲者》	名詞
＠きょうふうのきゅうしゅうしゃ	《強風の急襲者》	名詞
＠さ	《彩色の宇宙儀》	名詞
＠さい	《彩色の宇宙儀》	名詞
＠さいし	《彩色の宇宙儀》	名詞
＠さいしょ	《彩色の宇宙儀》	名詞
＠さいしょく	《彩色の宇宙儀》	名詞
＠さいしょくの	《彩色の宇宙儀》	名詞
＠さいしょくのう	《彩色の宇宙儀》	名詞
＠さいしょくのうち	《彩色の宇宙儀》	名詞
＠さいしょくのうちゅ	《彩色の宇宙儀》	名詞
＠さいしょくのうちゅう	《彩色の宇宙儀》	名詞
＠さいしょくのうちゅうぎ	《彩色の宇宙儀》	名詞
＠し	《心火の供犠者》	名詞
＠しん	《心火の供犠者》	名詞
＠しんか	《心火の供犠者》	名詞
＠しんかの	《心火の供犠者》	名詞
＠しんかのと	《心火の供犠者》	名詞
＠しんかのとも	《心火の供犠者》	名詞
＠しんかのともぎ	《心火の供犠者》	名詞
＠しんかのともぎし	《心火の供犠者》	名詞
＠しんかのともぎしゃ	《心火の供犠者》	名詞
＠し	《心酔させる掌握》	名詞
＠しん	《心酔させる掌握》	名詞
＠しんす	《心酔させる掌握》	名詞
＠しんすい	《心酔させる掌握》	名詞
＠しんすいさ	《心酔させる掌握》	名詞
＠しんすいさせ	《心酔させる掌握》	名詞
＠しんすいさせる	《心酔させる掌握》	名詞
＠しんすいさせるし	《心酔させる掌握》	名詞
＠しんすいさせるしょ	《心酔させる掌握》	名詞
＠しんすいさせるしょう	《心酔させる掌握》	名詞
＠しんすいさせるしょうあ	《心酔させる掌握》	名詞
＠しんすいさせるしょうあく	《心酔させる掌握》	名詞
＠に	《忍耐の偶像》	名詞
＠にん	《忍耐の偶像》	名詞
＠にんた	《忍耐の偶像》	名詞
＠にんたい	《忍耐の偶像》	名詞
＠にんたいの	《忍耐の偶像》	名詞
＠にんたいのぐ	《忍耐の偶像》	名詞
＠にんたいのぐう	《忍耐の偶像》	名詞
＠にんたいのぐうぞ	《忍耐の偶像》	名詞
＠にんたいのぐうぞう	《忍耐の偶像》	名詞
＠わ	《忘れられた歩哨》	名詞
＠わす	《忘れられた歩哨》	名詞
＠わすれ	《忘れられた歩哨》	名詞
＠わすれら	《忘れられた歩哨》	名詞
＠わすれられ	《忘れられた歩哨》	名詞
＠わすれられた	《忘れられた歩哨》	名詞
＠わすれられたほ	《忘れられた歩哨》	名詞
＠わすれられたほし	《忘れられた歩哨》	名詞
＠わすれられたほしょ	《忘れられた歩哨》	名詞
＠わすれられたほしょう	《忘れられた歩哨》	名詞
＠き	《急流の崖》	名詞
＠きゅ	《急流の崖》	名詞
＠きゅう	《急流の崖》	名詞
＠きゅうり	《急流の崖》	名詞
＠きゅうりゅ	《急流の崖》	名詞
＠きゅうりゅう	《急流の崖》	名詞
＠きゅうりゅうの	《急流の崖》	名詞
＠きゅうりゅうのが	《急流の崖》	名詞
＠きゅうりゅうのがけ	《急流の崖》	名詞
＠わ	《悪い取引》	名詞
＠わる	《悪い取引》	名詞
＠わるい	《悪い取引》	名詞
＠わるいと	《悪い取引》	名詞
＠わるいとり	《悪い取引》	名詞
＠わるいとりひ	《悪い取引》	名詞
＠わるいとりひき	《悪い取引》	名詞
＠あ	《悪意に満ちた者、ケアヴェク》	名詞
＠あく	《悪意に満ちた者、ケアヴェク》	名詞
＠あくい	《悪意に満ちた者、ケアヴェク》	名詞
＠あくいに	《悪意に満ちた者、ケアヴェク》	名詞
＠あくいにみ	《悪意に満ちた者、ケアヴェク》	名詞
＠あくいにみち	《悪意に満ちた者、ケアヴェク》	名詞
＠あくいにみちた	《悪意に満ちた者、ケアヴェク》	名詞
＠あくいにみちたも	《悪意に満ちた者、ケアヴェク》	名詞
＠あくいにみちたもの	《悪意に満ちた者、ケアヴェク》	名詞
＠あくいにみちたもの、	《悪意に満ちた者、ケアヴェク》	名詞
＠あくいにみちたもの、け	《悪意に満ちた者、ケアヴェク》	名詞
＠あくいにみちたもの、けあ	《悪意に満ちた者、ケアヴェク》	名詞
＠あくいにみちたもの、けあヴ	《悪意に満ちた者、ケアヴェク》	名詞
＠あくいにみちたもの、けあヴぇ	《悪意に満ちた者、ケアヴェク》	名詞
＠あくいにみちたもの、けあヴぇく	《悪意に満ちた者、ケアヴェク》	名詞
＠あ	《悪意の鎌》	名詞
＠あく	《悪意の鎌》	名詞
＠あくい	《悪意の鎌》	名詞
＠あくいの	《悪意の鎌》	名詞
＠あくいのか	《悪意の鎌》	名詞
＠あくいのかま	《悪意の鎌》	名詞
＠あ	《悪斬の天使》	名詞
＠あく	《悪斬の天使》	名詞
＠あくざ	《悪斬の天使》	名詞
＠あくざん	《悪斬の天使》	名詞
＠あくざんの	《悪斬の天使》	名詞
＠あくざんのて	《悪斬の天使》	名詞
＠あくざんのてん	《悪斬の天使》	名詞
＠あくざんのてんし	《悪斬の天使》	名詞
＠あ	《悪魔の抱擁》	名詞
＠あく	《悪魔の抱擁》	名詞
＠あくま	《悪魔の抱擁》	名詞
＠あくまの	《悪魔の抱擁》	名詞
＠あくまのほ	《悪魔の抱擁》	名詞
＠あくまのほう	《悪魔の抱擁》	名詞
＠あくまのほうよ	《悪魔の抱擁》	名詞
＠あくまのほうよう	《悪魔の抱擁》	名詞
＠ゆ	《憂鬱蒔き》	名詞
＠ゆう	《憂鬱蒔き》	名詞
＠ゆうう	《憂鬱蒔き》	名詞
＠ゆううつ	《憂鬱蒔き》	名詞
＠ゆううつま	《憂鬱蒔き》	名詞
＠ゆううつまき	《憂鬱蒔き》	名詞
＠ふ	《憤激解放》	名詞
＠ふん	《憤激解放》	名詞
＠ふんげ	《憤激解放》	名詞
＠ふんげき	《憤激解放》	名詞
＠ふんげきか	《憤激解放》	名詞
＠ふんげきかい	《憤激解放》	名詞
＠ふんげきかいほ	《憤激解放》	名詞
＠ふんげきかいほう	《憤激解放》	名詞
＠い	《戦装飾のシャーマン》	名詞
＠いく	《戦装飾のシャーマン》	名詞
＠いくさ	《戦装飾のシャーマン》	名詞
＠いくさそ	《戦装飾のシャーマン》	名詞
＠いくさそう	《戦装飾のシャーマン》	名詞
＠いくさそうし	《戦装飾のシャーマン》	名詞
＠いくさそうしょ	《戦装飾のシャーマン》	名詞
＠いくさそうしょく	《戦装飾のシャーマン》	名詞
＠いくさそうしょくの	《戦装飾のシャーマン》	名詞
＠いくさそうしょくのし	《戦装飾のシャーマン》	名詞
＠いくさそうしょくのしゃ	《戦装飾のシャーマン》	名詞
＠いくさそうしょくのしゃー	《戦装飾のシャーマン》	名詞
＠いくさそうしょくのしゃーま	《戦装飾のシャーマン》	名詞
＠いくさそうしょくのしゃーまん	《戦装飾のシャーマン》	名詞
＠う	《打ち壊すブロントドン》	名詞
＠うち	《打ち壊すブロントドン》	名詞
＠うちこ	《打ち壊すブロントドン》	名詞
＠うちこわ	《打ち壊すブロントドン》	名詞
＠うちこわす	《打ち壊すブロントドン》	名詞
＠うちこわすぶ	《打ち壊すブロントドン》	名詞
＠うちこわすぶろ	《打ち壊すブロントドン》	名詞
＠うちこわすぶろん	《打ち壊すブロントドン》	名詞
＠うちこわすぶろんと	《打ち壊すブロントドン》	名詞
＠うちこわすぶろんとど	《打ち壊すブロントドン》	名詞
＠うちこわすぶろんとどん	《打ち壊すブロントドン》	名詞
＠て	《抵抗の妙技》	名詞
＠てい	《抵抗の妙技》	名詞
＠ていこ	《抵抗の妙技》	名詞
＠ていこう	《抵抗の妙技》	名詞
＠ていこうの	《抵抗の妙技》	名詞
＠ていこうのみ	《抵抗の妙技》	名詞
＠ていこうのみょ	《抵抗の妙技》	名詞
＠ていこうのみょう	《抵抗の妙技》	名詞
＠ていこうのみょうぎ	《抵抗の妙技》	名詞
＠ほ	《捕獲球》	名詞
＠ほか	《捕獲球》	名詞
＠ほかく	《捕獲球》	名詞
＠ほかくき	《捕獲球》	名詞
＠ほかくきゅ	《捕獲球》	名詞
＠ほかくきゅう	《捕獲球》	名詞
＠と	《時の支配者、テフェリー》	名詞
＠とき	《時の支配者、テフェリー》	名詞
＠ときの	《時の支配者、テフェリー》	名詞
＠ときのし	《時の支配者、テフェリー》	名詞
＠ときのしは	《時の支配者、テフェリー》	名詞
＠ときのしはい	《時の支配者、テフェリー》	名詞
＠ときのしはいし	《時の支配者、テフェリー》	名詞
＠ときのしはいしゃ	《時の支配者、テフェリー》	名詞
＠ときのしはいしゃ、	《時の支配者、テフェリー》	名詞
＠ときのしはいしゃ、て	《時の支配者、テフェリー》	名詞
＠ときのしはいしゃ、てふ	《時の支配者、テフェリー》	名詞
＠ときのしはいしゃ、てふぇ	《時の支配者、テフェリー》	名詞
＠ときのしはいしゃ、てふぇり	《時の支配者、テフェリー》	名詞
＠ときのしはいしゃ、てふぇりー	《時の支配者、テフェリー》	名詞
＠て	《時の支配者、テフェリー》	名詞
＠てふ	《時の支配者、テフェリー》	名詞
＠てふぇ	《時の支配者、テフェリー》	名詞
＠てふぇり	《時の支配者、テフェリー》	名詞
＠てふぇりー	《時の支配者、テフェリー》	名詞
＠し	《書庫泥棒》	名詞
＠しょ	《書庫泥棒》	名詞
＠しょこ	《書庫泥棒》	名詞
＠しょこど	《書庫泥棒》	名詞
＠しょこどろ	《書庫泥棒》	名詞
＠しょこどろぼ	《書庫泥棒》	名詞
＠しょこどろぼう	《書庫泥棒》	名詞
＠ゆ	《有刺メガロドン》	名詞
＠ゆう	《有刺メガロドン》	名詞
＠ゆうし	《有刺メガロドン》	名詞
＠ゆうしめ	《有刺メガロドン》	名詞
＠ゆうしめが	《有刺メガロドン》	名詞
＠ゆうしめがろ	《有刺メガロドン》	名詞
＠ゆうしめがろど	《有刺メガロドン》	名詞
＠ゆうしめがろどん	《有刺メガロドン》	名詞
＠む	《村の儀式》	名詞
＠むら	《村の儀式》	名詞
＠むらの	《村の儀式》	名詞
＠むらのぎ	《村の儀式》	名詞
＠むらのぎし	《村の儀式》	名詞
＠むらのぎしき	《村の儀式》	名詞
＠か	《果敢な一撃》	名詞
＠かか	《果敢な一撃》	名詞
＠かかん	《果敢な一撃》	名詞
＠かかんな	《果敢な一撃》	名詞
＠かかんない	《果敢な一撃》	名詞
＠かかんないち	《果敢な一撃》	名詞
＠かかんないちげ	《果敢な一撃》	名詞
＠かかんないちげき	《果敢な一撃》	名詞
＠し	《枝葉族の報復者》	名詞
＠しよ	《枝葉族の報復者》	名詞
＠しよう	《枝葉族の報復者》	名詞
＠しようぞ	《枝葉族の報復者》	名詞
＠しようぞく	《枝葉族の報復者》	名詞
＠しようぞくの	《枝葉族の報復者》	名詞
＠しようぞくのほ	《枝葉族の報復者》	名詞
＠しようぞくのほう	《枝葉族の報復者》	名詞
＠しようぞくのほうふ	《枝葉族の報復者》	名詞
＠しようぞくのほうふく	《枝葉族の報復者》	名詞
＠しようぞくのほうふくし	《枝葉族の報復者》	名詞
＠しようぞくのほうふくしゃ	《枝葉族の報復者》	名詞
＠え	《栄光の頌歌》	名詞
＠えい	《栄光の頌歌》	名詞
＠えいこ	《栄光の頌歌》	名詞
＠えいこう	《栄光の頌歌》	名詞
＠えいこうの	《栄光の頌歌》	名詞
＠えいこうのし	《栄光の頌歌》	名詞
＠えいこうのしょ	《栄光の頌歌》	名詞
＠えいこうのしょう	《栄光の頌歌》	名詞
＠えいこうのしょうか	《栄光の頌歌》	名詞
＠こ	《梢の忍び寄り》	名詞
＠こず	《梢の忍び寄り》	名詞
＠こずえ	《梢の忍び寄り》	名詞
＠こずえの	《梢の忍び寄り》	名詞
＠こずえのし	《梢の忍び寄り》	名詞
＠こずえのしの	《梢の忍び寄り》	名詞
＠こずえのしのび	《梢の忍び寄り》	名詞
＠こずえのしのびよ	《梢の忍び寄り》	名詞
＠こずえのしのびより	《梢の忍び寄り》	名詞
＠も	《森の守部》	名詞
＠もり	《森の守部》	名詞
＠もりの	《森の守部》	名詞
＠もりのも	《森の守部》	名詞
＠もりのもり	《森の守部》	名詞
＠もりのもりべ	《森の守部》	名詞
＠お	《檻の中のゾンビ》	名詞
＠おり	《檻の中のゾンビ》	名詞
＠おりの	《檻の中のゾンビ》	名詞
＠おりのな	《檻の中のゾンビ》	名詞
＠おりのなか	《檻の中のゾンビ》	名詞
＠おりのなかの	《檻の中のゾンビ》	名詞
＠おりのなかのぞ	《檻の中のゾンビ》	名詞
＠おりのなかのぞん	《檻の中のゾンビ》	名詞
＠おりのなかのぞんび	《檻の中のゾンビ》	名詞
＠あ	《歩く死骸》	名詞
＠ある	《歩く死骸》	名詞
＠あるく	《歩く死骸》	名詞
＠あるくし	《歩く死骸》	名詞
＠あるくしが	《歩く死骸》	名詞
＠あるくしがい	《歩く死骸》	名詞
＠れ	《歴戦の神聖刃》	名詞
＠れき	《歴戦の神聖刃》	名詞
＠れきせ	《歴戦の神聖刃》	名詞
＠れきせん	《歴戦の神聖刃》	名詞
＠れきせんの	《歴戦の神聖刃》	名詞
＠れきせんのし	《歴戦の神聖刃》	名詞
＠れきせんのしん	《歴戦の神聖刃》	名詞
＠れきせんのしんせ	《歴戦の神聖刃》	名詞
＠れきせんのしんせい	《歴戦の神聖刃》	名詞
＠れきせんのしんせいは	《歴戦の神聖刃》	名詞
＠し	《死に至る霞》	名詞
＠しに	《死に至る霞》	名詞
＠しにい	《死に至る霞》	名詞
＠しにいた	《死に至る霞》	名詞
＠しにいたる	《死に至る霞》	名詞
＠しにいたるか	《死に至る霞》	名詞
＠しにいたるかす	《死に至る霞》	名詞
＠しにいたるかすみ	《死に至る霞》	名詞
＠し	《死者を目覚めさせる者、リリアナ》	名詞
＠しし	《死者を目覚めさせる者、リリアナ》	名詞
＠ししゃ	《死者を目覚めさせる者、リリアナ》	名詞
＠ししゃを	《死者を目覚めさせる者、リリアナ》	名詞
＠ししゃをめ	《死者を目覚めさせる者、リリアナ》	名詞
＠ししゃをめざ	《死者を目覚めさせる者、リリアナ》	名詞
＠ししゃをめざめ	《死者を目覚めさせる者、リリアナ》	名詞
＠ししゃをめざめさ	《死者を目覚めさせる者、リリアナ》	名詞
＠ししゃをめざめさせ	《死者を目覚めさせる者、リリアナ》	名詞
＠ししゃをめざめさせる	《死者を目覚めさせる者、リリアナ》	名詞
＠ししゃをめざめさせるも	《死者を目覚めさせる者、リリアナ》	名詞
＠ししゃをめざめさせるもの	《死者を目覚めさせる者、リリアナ》	名詞
＠ししゃをめざめさせるもの、	《死者を目覚めさせる者、リリアナ》	名詞
＠ししゃをめざめさせるもの、り	《死者を目覚めさせる者、リリアナ》	名詞
＠ししゃをめざめさせるもの、りり	《死者を目覚めさせる者、リリアナ》	名詞
＠ししゃをめざめさせるもの、りりあ	《死者を目覚めさせる者、リリアナ》	名詞
＠ししゃをめざめさせるもの、りりあな	《死者を目覚めさせる者、リリアナ》	名詞
＠り	《死者を目覚めさせる者、リリアナ》	名詞
＠りり	《死者を目覚めさせる者、リリアナ》	名詞
＠りりあ	《死者を目覚めさせる者、リリアナ》	名詞
＠りりあな	《死者を目覚めさせる者、リリアナ》	名詞
＠し	《死花のサリッド》	名詞
＠しに	《死花のサリッド》	名詞
＠しにば	《死花のサリッド》	名詞
＠しにばな	《死花のサリッド》	名詞
＠しにばなの	《死花のサリッド》	名詞
＠しにばなのさ	《死花のサリッド》	名詞
＠しにばなのさり	《死花のサリッド》	名詞
＠しにばなのさりっ	《死花のサリッド》	名詞
＠しにばなのさりっど	《死花のサリッド》	名詞
＠き	《気難しいディロフォサウルス》	名詞
＠きむ	《気難しいディロフォサウルス》	名詞
＠きむつ	《気難しいディロフォサウルス》	名詞
＠きむつか	《気難しいディロフォサウルス》	名詞
＠きむつかし	《気難しいディロフォサウルス》	名詞
＠きむつかしい	《気難しいディロフォサウルス》	名詞
＠きむつかしいで	《気難しいディロフォサウルス》	名詞
＠きむつかしいでぃ	《気難しいディロフォサウルス》	名詞
＠きむつかしいでぃろ	《気難しいディロフォサウルス》	名詞
＠きむつかしいでぃろふ	《気難しいディロフォサウルス》	名詞
＠きむつかしいでぃろふぉ	《気難しいディロフォサウルス》	名詞
＠きむつかしいでぃろふぉさ	《気難しいディロフォサウルス》	名詞
＠きむつかしいでぃろふぉさう	《気難しいディロフォサウルス》	名詞
＠きむつかしいでぃろふぉさうる	《気難しいディロフォサウルス》	名詞
＠きむつかしいでぃろふぉさうるす	《気難しいディロフォサウルス》	名詞
＠な	《波起こし》	名詞
＠なみ	《波起こし》	名詞
＠なみお	《波起こし》	名詞
＠なみおこ	《波起こし》	名詞
＠なみおこし	《波起こし》	名詞
＠か	《活力回復》	名詞
＠かつ	《活力回復》	名詞
＠かつり	《活力回復》	名詞
＠かつりょ	《活力回復》	名詞
＠かつりょく	《活力回復》	名詞
＠かつりょくか	《活力回復》	名詞
＠かつりょくかい	《活力回復》	名詞
＠かつりょくかいふ	《活力回復》	名詞
＠かつりょくかいふく	《活力回復》	名詞
＠か	《活性化のうねり》	名詞
＠かっ	《活性化のうねり》	名詞
＠かっせ	《活性化のうねり》	名詞
＠かっせい	《活性化のうねり》	名詞
＠かっせいか	《活性化のうねり》	名詞
＠かっせいかの	《活性化のうねり》	名詞
＠かっせいかのう	《活性化のうねり》	名詞
＠かっせいかのうね	《活性化のうねり》	名詞
＠かっせいかのうねり	《活性化のうねり》	名詞
＠し	《深淵への覗き込み》	名詞
＠しん	《深淵への覗き込み》	名詞
＠しんえ	《深淵への覗き込み》	名詞
＠しんえん	《深淵への覗き込み》	名詞
＠しんえんへ	《深淵への覗き込み》	名詞
＠しんえんへの	《深淵への覗き込み》	名詞
＠しんえんへのの	《深淵への覗き込み》	名詞
＠しんえんへののぞ	《深淵への覗き込み》	名詞
＠しんえんへののぞき	《深淵への覗き込み》	名詞
＠しんえんへののぞきこ	《深淵への覗き込み》	名詞
＠しんえんへののぞきこみ	《深淵への覗き込み》	名詞
＠よ	《溶岩噴火》	名詞
＠よう	《溶岩噴火》	名詞
＠ようが	《溶岩噴火》	名詞
＠ようがん	《溶岩噴火》	名詞
＠ようがんふ	《溶岩噴火》	名詞
＠ようがんふん	《溶岩噴火》	名詞
＠ようがんふんか	《溶岩噴火》	名詞
＠あ	《漁る軟泥》	名詞
＠あさ	《漁る軟泥》	名詞
＠あさる	《漁る軟泥》	名詞
＠あさるな	《漁る軟泥》	名詞
＠あさるなん	《漁る軟泥》	名詞
＠あさるなんで	《漁る軟泥》	名詞
＠あさるなんでい	《漁る軟泥》	名詞
＠し	《潮掬い》	名詞
＠しお	《潮掬い》	名詞
＠しおす	《潮掬い》	名詞
＠しおすく	《潮掬い》	名詞
＠しおすくい	《潮掬い》	名詞
＠し	《潮読み》	名詞
＠しお	《潮読み》	名詞
＠しおよ	《潮読み》	名詞
＠しおよみ	《潮読み》	名詞
＠げ	《激情の共感者》	名詞
＠げき	《激情の共感者》	名詞
＠げきじ	《激情の共感者》	名詞
＠げきじょ	《激情の共感者》	名詞
＠げきじょう	《激情の共感者》	名詞
＠げきじょうの	《激情の共感者》	名詞
＠げきじょうのき	《激情の共感者》	名詞
＠げきじょうのきょ	《激情の共感者》	名詞
＠げきじょうのきょう	《激情の共感者》	名詞
＠げきじょうのきょうか	《激情の共感者》	名詞
＠げきじょうのきょうかん	《激情の共感者》	名詞
＠げきじょうのきょうかんし	《激情の共感者》	名詞
＠げきじょうのきょうかんしゃ	《激情の共感者》	名詞
＠ひ	《灯狩人のマスティコア》	名詞
＠ひか	《灯狩人のマスティコア》	名詞
＠ひかり	《灯狩人のマスティコア》	名詞
＠ひかりゅ	《灯狩人のマスティコア》	名詞
＠ひかりゅう	《灯狩人のマスティコア》	名詞
＠ひかりゅうど	《灯狩人のマスティコア》	名詞
＠ひかりゅうどの	《灯狩人のマスティコア》	名詞
＠ひかりゅうどのま	《灯狩人のマスティコア》	名詞
＠ひかりゅうどのます	《灯狩人のマスティコア》	名詞
＠ひかりゅうどのますて	《灯狩人のマスティコア》	名詞
＠ひかりゅうどのますてぃ	《灯狩人のマスティコア》	名詞
＠ひかりゅうどのますてぃこ	《灯狩人のマスティコア》	名詞
＠ひかりゅうどのますてぃこあ	《灯狩人のマスティコア》	名詞
＠ほ	《炎の心、チャンドラ》	名詞
＠ほの	《炎の心、チャンドラ》	名詞
＠ほのお	《炎の心、チャンドラ》	名詞
＠ほのおの	《炎の心、チャンドラ》	名詞
＠ほのおのこ	《炎の心、チャンドラ》	名詞
＠ほのおのここ	《炎の心、チャンドラ》	名詞
＠ほのおのこころ	《炎の心、チャンドラ》	名詞
＠ほのおのこころ、	《炎の心、チャンドラ》	名詞
＠ほのおのこころ、ち	《炎の心、チャンドラ》	名詞
＠ほのおのこころ、ちゃ	《炎の心、チャンドラ》	名詞
＠ほのおのこころ、ちゃん	《炎の心、チャンドラ》	名詞
＠ほのおのこころ、ちゃんど	《炎の心、チャンドラ》	名詞
＠ほのおのこころ、ちゃんどら	《炎の心、チャンドラ》	名詞
＠ち	《炎の心、チャンドラ》	名詞
＠ちゃ	《炎の心、チャンドラ》	名詞
＠ちゃん	《炎の心、チャンドラ》	名詞
＠ちゃんど	《炎の心、チャンドラ》	名詞
＠ちゃんどら	《炎の心、チャンドラ》	名詞
＠え	《炎血の野犬》	名詞
＠えん	《炎血の野犬》	名詞
＠えんけ	《炎血の野犬》	名詞
＠えんけつ	《炎血の野犬》	名詞
＠えんけつの	《炎血の野犬》	名詞
＠えんけつのや	《炎血の野犬》	名詞
＠えんけつのやけ	《炎血の野犬》	名詞
＠えんけつのやけん	《炎血の野犬》	名詞
＠ぶ	《無作法な挑発者》	名詞
＠ぶさ	《無作法な挑発者》	名詞
＠ぶさほ	《無作法な挑発者》	名詞
＠ぶさほう	《無作法な挑発者》	名詞
＠ぶさほうな	《無作法な挑発者》	名詞
＠ぶさほうなち	《無作法な挑発者》	名詞
＠ぶさほうなちょ	《無作法な挑発者》	名詞
＠ぶさほうなちょう	《無作法な挑発者》	名詞
＠ぶさほうなちょうは	《無作法な挑発者》	名詞
＠ぶさほうなちょうはつ	《無作法な挑発者》	名詞
＠ぶさほうなちょうはつし	《無作法な挑発者》	名詞
＠ぶさほうなちょうはつしゃ	《無作法な挑発者》	名詞
＠む	《無私の救助犬》	名詞
＠むし	《無私の救助犬》	名詞
＠むしの	《無私の救助犬》	名詞
＠むしのき	《無私の救助犬》	名詞
＠むしのきゅ	《無私の救助犬》	名詞
＠むしのきゅう	《無私の救助犬》	名詞
＠むしのきゅうじ	《無私の救助犬》	名詞
＠むしのきゅうじょ	《無私の救助犬》	名詞
＠むしのきゅうじょけ	《無私の救助犬》	名詞
＠むしのきゅうじょけん	《無私の救助犬》	名詞
＠し	《焦熱の竜火》	名詞
＠しょ	《焦熱の竜火》	名詞
＠しょう	《焦熱の竜火》	名詞
＠しょうね	《焦熱の竜火》	名詞
＠しょうねつ	《焦熱の竜火》	名詞
＠しょうねつの	《焦熱の竜火》	名詞
＠しょうねつのり	《焦熱の竜火》	名詞
＠しょうねつのりゅ	《焦熱の竜火》	名詞
＠しょうねつのりゅう	《焦熱の竜火》	名詞
＠しょうねつのりゅうび	《焦熱の竜火》	名詞
＠し	《焦熱の解放》	名詞
＠しょ	《焦熱の解放》	名詞
＠しょう	《焦熱の解放》	名詞
＠しょうね	《焦熱の解放》	名詞
＠しょうねつ	《焦熱の解放》	名詞
＠しょうねつの	《焦熱の解放》	名詞
＠しょうねつのか	《焦熱の解放》	名詞
＠しょうねつのかい	《焦熱の解放》	名詞
＠しょうねつのかいほ	《焦熱の解放》	名詞
＠しょうねつのかいほう	《焦熱の解放》	名詞
＠も	《燃えさかる炎》	名詞
＠もえ	《燃えさかる炎》	名詞
＠もえさ	《燃えさかる炎》	名詞
＠もえさか	《燃えさかる炎》	名詞
＠もえさかる	《燃えさかる炎》	名詞
＠もえさかるほ	《燃えさかる炎》	名詞
＠もえさかるほの	《燃えさかる炎》	名詞
＠もえさかるほのお	《燃えさかる炎》	名詞
＠も	《燃え投げの小悪魔》	名詞
＠もえ	《燃え投げの小悪魔》	名詞
＠もえな	《燃え投げの小悪魔》	名詞
＠もえなげ	《燃え投げの小悪魔》	名詞
＠もえなげの	《燃え投げの小悪魔》	名詞
＠もえなげのこ	《燃え投げの小悪魔》	名詞
＠もえなげのこあ	《燃え投げの小悪魔》	名詞
＠もえなげのこあく	《燃え投げの小悪魔》	名詞
＠もえなげのこあくま	《燃え投げの小悪魔》	名詞
＠か	《狩人の刃》	名詞
＠かり	《狩人の刃》	名詞
＠かりう	《狩人の刃》	名詞
＠かりうど	《狩人の刃》	名詞
＠かりうどの	《狩人の刃》	名詞
＠かりうどのは	《狩人の刃》	名詞
＠も	《猛然たる顕現》	名詞
＠もう	《猛然たる顕現》	名詞
＠もうぜ	《猛然たる顕現》	名詞
＠もうぜん	《猛然たる顕現》	名詞
＠もうぜんた	《猛然たる顕現》	名詞
＠もうぜんたる	《猛然たる顕現》	名詞
＠もうぜんたるけ	《猛然たる顕現》	名詞
＠もうぜんたるけん	《猛然たる顕現》	名詞
＠もうぜんたるけんげ	《猛然たる顕現》	名詞
＠もうぜんたるけんげん	《猛然たる顕現》	名詞
＠ね	《猫の君主》	名詞
＠ねこ	《猫の君主》	名詞
＠ねこの	《猫の君主》	名詞
＠ねこのく	《猫の君主》	名詞
＠ねこのくん	《猫の君主》	名詞
＠ねこのくんし	《猫の君主》	名詞
＠ねこのくんしゅ	《猫の君主》	名詞
＠げ	《現場保存》	名詞
＠げん	《現場保存》	名詞
＠げんば	《現場保存》	名詞
＠げんばほ	《現場保存》	名詞
＠げんばほぞ	《現場保存》	名詞
＠げんばほぞん	《現場保存》	名詞
＠い	《異形化》	名詞
＠いけ	《異形化》	名詞
＠いけい	《異形化》	名詞
＠いけいか	《異形化》	名詞
＠い	《異臭のインプ》	名詞
＠いし	《異臭のインプ》	名詞
＠いしゅ	《異臭のインプ》	名詞
＠いしゅう	《異臭のインプ》	名詞
＠いしゅうの	《異臭のインプ》	名詞
＠いしゅうのい	《異臭のインプ》	名詞
＠いしゅうのいん	《異臭のインプ》	名詞
＠いしゅうのいんぷ	《異臭のインプ》	名詞
＠し	《疾病の神殿》	名詞
＠しっ	《疾病の神殿》	名詞
＠しっぺ	《疾病の神殿》	名詞
＠しっぺい	《疾病の神殿》	名詞
＠しっぺいの	《疾病の神殿》	名詞
＠しっぺいのし	《疾病の神殿》	名詞
＠しっぺいのしん	《疾病の神殿》	名詞
＠しっぺいのしんで	《疾病の神殿》	名詞
＠しっぺいのしんでん	《疾病の神殿》	名詞
＠と	《盗賊ギルドの処罰者》	名詞
＠とう	《盗賊ギルドの処罰者》	名詞
＠とうぞ	《盗賊ギルドの処罰者》	名詞
＠とうぞく	《盗賊ギルドの処罰者》	名詞
＠とうぞくぎ	《盗賊ギルドの処罰者》	名詞
＠とうぞくぎる	《盗賊ギルドの処罰者》	名詞
＠とうぞくぎるど	《盗賊ギルドの処罰者》	名詞
＠とうぞくぎるどの	《盗賊ギルドの処罰者》	名詞
＠とうぞくぎるどのし	《盗賊ギルドの処罰者》	名詞
＠とうぞくぎるどのしょ	《盗賊ギルドの処罰者》	名詞
＠とうぞくぎるどのしょば	《盗賊ギルドの処罰者》	名詞
＠とうぞくぎるどのしょばつ	《盗賊ギルドの処罰者》	名詞
＠とうぞくぎるどのしょばつし	《盗賊ギルドの処罰者》	名詞
＠とうぞくぎるどのしょばつしゃ	《盗賊ギルドの処罰者》	名詞
＠し	《真実の視認》	名詞
＠しん	《真実の視認》	名詞
＠しんじ	《真実の視認》	名詞
＠しんじつ	《真実の視認》	名詞
＠しんじつの	《真実の視認》	名詞
＠しんじつのし	《真実の視認》	名詞
＠しんじつのしに	《真実の視認》	名詞
＠しんじつのしにん	《真実の視認》	名詞
＠ま	《真面目な身代わり》	名詞
＠まじ	《真面目な身代わり》	名詞
＠まじめ	《真面目な身代わり》	名詞
＠まじめな	《真面目な身代わり》	名詞
＠まじめなみ	《真面目な身代わり》	名詞
＠まじめなみが	《真面目な身代わり》	名詞
＠まじめなみがわ	《真面目な身代わり》	名詞
＠まじめなみがわり	《真面目な身代わり》	名詞
＠ち	《知識鱗のコアトル》	名詞
＠ちし	《知識鱗のコアトル》	名詞
＠ちしき	《知識鱗のコアトル》	名詞
＠ちしきう	《知識鱗のコアトル》	名詞
＠ちしきうろ	《知識鱗のコアトル》	名詞
＠ちしきうろこ	《知識鱗のコアトル》	名詞
＠ちしきうろこの	《知識鱗のコアトル》	名詞
＠ちしきうろこのこ	《知識鱗のコアトル》	名詞
＠ちしきうろこのこあ	《知識鱗のコアトル》	名詞
＠ちしきうろこのこあと	《知識鱗のコアトル》	名詞
＠ちしきうろこのこあとる	《知識鱗のコアトル》	名詞
＠い	《石の牙の聖域》	名詞
＠いし	《石の牙の聖域》	名詞
＠いしの	《石の牙の聖域》	名詞
＠いしのき	《石の牙の聖域》	名詞
＠いしのきば	《石の牙の聖域》	名詞
＠いしのきばの	《石の牙の聖域》	名詞
＠いしのきばのせ	《石の牙の聖域》	名詞
＠いしのきばのせい	《石の牙の聖域》	名詞
＠いしのきばのせいい	《石の牙の聖域》	名詞
＠いしのきばのせいいき	《石の牙の聖域》	名詞
＠ほ	《砲塔のオーガ》	名詞
＠ほう	《砲塔のオーガ》	名詞
＠ほうと	《砲塔のオーガ》	名詞
＠ほうとう	《砲塔のオーガ》	名詞
＠ほうとうの	《砲塔のオーガ》	名詞
＠ほうとうのお	《砲塔のオーガ》	名詞
＠ほうとうのおー	《砲塔のオーガ》	名詞
＠ほうとうのおーが	《砲塔のオーガ》	名詞
＠は	《破壊的細工》	名詞
＠はか	《破壊的細工》	名詞
＠はかい	《破壊的細工》	名詞
＠はかいて	《破壊的細工》	名詞
＠はかいてき	《破壊的細工》	名詞
＠はかいてきさ	《破壊的細工》	名詞
＠はかいてきさい	《破壊的細工》	名詞
＠はかいてきさいく	《破壊的細工》	名詞
＠か	《確実な一撃》	名詞
＠かく	《確実な一撃》	名詞
＠かくじ	《確実な一撃》	名詞
＠かくじつ	《確実な一撃》	名詞
＠かくじつな	《確実な一撃》	名詞
＠かくじつない	《確実な一撃》	名詞
＠かくじつないち	《確実な一撃》	名詞
＠かくじつないちげ	《確実な一撃》	名詞
＠かくじつないちげき	《確実な一撃》	名詞
＠み	《磨かれたやせ地》	名詞
＠みが	《磨かれたやせ地》	名詞
＠みがか	《磨かれたやせ地》	名詞
＠みがかれ	《磨かれたやせ地》	名詞
＠みがかれた	《磨かれたやせ地》	名詞
＠みがかれたや	《磨かれたやせ地》	名詞
＠みがかれたやせ	《磨かれたやせ地》	名詞
＠みがかれたやせち	《磨かれたやせ地》	名詞
＠し	《神秘の神殿》	名詞
＠しん	《神秘の神殿》	名詞
＠しんぴ	《神秘の神殿》	名詞
＠しんぴの	《神秘の神殿》	名詞
＠しんぴのし	《神秘の神殿》	名詞
＠しんぴのしん	《神秘の神殿》	名詞
＠しんぴのしんで	《神秘の神殿》	名詞
＠しんぴのしんでん	《神秘の神殿》	名詞
＠ひ	《秘本のアニマ》	名詞
＠ひほ	《秘本のアニマ》	名詞
＠ひほん	《秘本のアニマ》	名詞
＠ひほんの	《秘本のアニマ》	名詞
＠ひほんのあ	《秘本のアニマ》	名詞
＠ひほんのあに	《秘本のアニマ》	名詞
＠ひほんのあにま	《秘本のアニマ》	名詞
＠お	《穏やかな光の聖域》	名詞
＠おだ	《穏やかな光の聖域》	名詞
＠おだや	《穏やかな光の聖域》	名詞
＠おだやか	《穏やかな光の聖域》	名詞
＠おだやかな	《穏やかな光の聖域》	名詞
＠おだやかなひ	《穏やかな光の聖域》	名詞
＠おだやかなひか	《穏やかな光の聖域》	名詞
＠おだやかなひかり	《穏やかな光の聖域》	名詞
＠おだやかなひかりの	《穏やかな光の聖域》	名詞
＠おだやかなひかりのせ	《穏やかな光の聖域》	名詞
＠おだやかなひかりのせい	《穏やかな光の聖域》	名詞
＠おだやかなひかりのせいい	《穏やかな光の聖域》	名詞
＠おだやかなひかりのせいいき	《穏やかな光の聖域》	名詞
＠く	《空中走査器》	名詞
＠くう	《空中走査器》	名詞
＠くうち	《空中走査器》	名詞
＠くうちゅ	《空中走査器》	名詞
＠くうちゅう	《空中走査器》	名詞
＠くうちゅうそ	《空中走査器》	名詞
＠くうちゅうそう	《空中走査器》	名詞
＠くうちゅうそうさ	《空中走査器》	名詞
＠くうちゅうそうさき	《空中走査器》	名詞
＠つ	《突き止め》	名詞
＠つき	《突き止め》	名詞
＠つきと	《突き止め》	名詞
＠つきとめ	《突き止め》	名詞
＠と	《突破》	名詞
＠とっ	《突破》	名詞
＠とっぱ	《突破》	名詞
＠ふ	《節くれの賢者》	名詞
＠ふし	《節くれの賢者》	名詞
＠ふしく	《節くれの賢者》	名詞
＠ふしくれ	《節くれの賢者》	名詞
＠ふしくれの	《節くれの賢者》	名詞
＠ふしくれのけ	《節くれの賢者》	名詞
＠ふしくれのけん	《節くれの賢者》	名詞
＠ふしくれのけんじ	《節くれの賢者》	名詞
＠ふしくれのけんじゃ	《節くれの賢者》	名詞
＠ふ	《節くれ拳の樫》	名詞
＠ふし	《節くれ拳の樫》	名詞
＠ふしく	《節くれ拳の樫》	名詞
＠ふしくれ	《節くれ拳の樫》	名詞
＠ふしくれこ	《節くれ拳の樫》	名詞
＠ふしくれこぶ	《節くれ拳の樫》	名詞
＠ふしくれこぶし	《節くれ拳の樫》	名詞
＠ふしくれこぶしの	《節くれ拳の樫》	名詞
＠ふしくれこぶしのか	《節くれ拳の樫》	名詞
＠ふしくれこぶしのかし	《節くれ拳の樫》	名詞
＠せ	《精神腐敗》	名詞
＠せい	《精神腐敗》	名詞
＠せいし	《精神腐敗》	名詞
＠せいしん	《精神腐敗》	名詞
＠せいしんふ	《精神腐敗》	名詞
＠せいしんふは	《精神腐敗》	名詞
＠せいしんふはい	《精神腐敗》	名詞
＠せ	《精神迷わせの秘本》	名詞
＠せい	《精神迷わせの秘本》	名詞
＠せいし	《精神迷わせの秘本》	名詞
＠せいしん	《精神迷わせの秘本》	名詞
＠せいしんま	《精神迷わせの秘本》	名詞
＠せいしんまよ	《精神迷わせの秘本》	名詞
＠せいしんまよわ	《精神迷わせの秘本》	名詞
＠せいしんまよわせ	《精神迷わせの秘本》	名詞
＠せいしんまよわせの	《精神迷わせの秘本》	名詞
＠せいしんまよわせのひ	《精神迷わせの秘本》	名詞
＠せいしんまよわせのひほ	《精神迷わせの秘本》	名詞
＠せいしんまよわせのひほん	《精神迷わせの秘本》	名詞
＠せ	《精霊龍、ウギン》	名詞
＠せい	《精霊龍、ウギン》	名詞
＠せいれ	《精霊龍、ウギン》	名詞
＠せいれい	《精霊龍、ウギン》	名詞
＠せいれいり	《精霊龍、ウギン》	名詞
＠せいれいりゅ	《精霊龍、ウギン》	名詞
＠せいれいりゅう	《精霊龍、ウギン》	名詞
＠せいれいりゅう、	《精霊龍、ウギン》	名詞
＠せいれいりゅう、う	《精霊龍、ウギン》	名詞
＠せいれいりゅう、うぎ	《精霊龍、ウギン》	名詞
＠せいれいりゅう、うぎん	《精霊龍、ウギン》	名詞
＠う	《精霊龍、ウギン》	名詞
＠うぎ	《精霊龍、ウギン》	名詞
＠うぎん	《精霊龍、ウギン》	名詞
＠や	《約束の光》	名詞
＠やく	《約束の光》	名詞
＠やくそ	《約束の光》	名詞
＠やくそく	《約束の光》	名詞
＠やくそくの	《約束の光》	名詞
＠やくそくのひ	《約束の光》	名詞
＠やくそくのひか	《約束の光》	名詞
＠やくそくのひかり	《約束の光》	名詞
＠す	《素早い反応》	名詞
＠すば	《素早い反応》	名詞
＠すばや	《素早い反応》	名詞
＠すばやい	《素早い反応》	名詞
＠すばやいは	《素早い反応》	名詞
＠すばやいはん	《素早い反応》	名詞
＠すばやいはんの	《素早い反応》	名詞
＠すばやいはんのう	《素早い反応》	名詞
＠わ	《罠紡ぎ》	名詞
＠わな	《罠紡ぎ》	名詞
＠わなつ	《罠紡ぎ》	名詞
＠わなつむ	《罠紡ぎ》	名詞
＠わなつむぎ	《罠紡ぎ》	名詞
＠む	《群れを導くもの》	名詞
＠むれ	《群れを導くもの》	名詞
＠むれを	《群れを導くもの》	名詞
＠むれをみ	《群れを導くもの》	名詞
＠むれをみち	《群れを導くもの》	名詞
＠むれをみちび	《群れを導くもの》	名詞
＠むれをみちびく	《群れを導くもの》	名詞
＠むれをみちびくも	《群れを導くもの》	名詞
＠むれをみちびくもの	《群れを導くもの》	名詞
＠こ	《耕作》	名詞
＠こう	《耕作》	名詞
＠こうさ	《耕作》	名詞
＠こうさく	《耕作》	名詞
＠た	《耽溺する貴族階級》	名詞
＠たん	《耽溺する貴族階級》	名詞
＠たんで	《耽溺する貴族階級》	名詞
＠たんでき	《耽溺する貴族階級》	名詞
＠たんできす	《耽溺する貴族階級》	名詞
＠たんできする	《耽溺する貴族階級》	名詞
＠たんできするき	《耽溺する貴族階級》	名詞
＠たんできするきぞ	《耽溺する貴族階級》	名詞
＠たんできするきぞく	《耽溺する貴族階級》	名詞
＠たんできするきぞくか	《耽溺する貴族階級》	名詞
＠たんできするきぞくかい	《耽溺する貴族階級》	名詞
＠たんできするきぞくかいき	《耽溺する貴族階級》	名詞
＠たんできするきぞくかいきゅ	《耽溺する貴族階級》	名詞
＠たんできするきぞくかいきゅう	《耽溺する貴族階級》	名詞
＠ほ	《胞子網の織り手》	名詞
＠ほう	《胞子網の織り手》	名詞
＠ほうし	《胞子網の織り手》	名詞
＠ほうしあ	《胞子網の織り手》	名詞
＠ほうしあみ	《胞子網の織り手》	名詞
＠ほうしあみの	《胞子網の織り手》	名詞
＠ほうしあみのお	《胞子網の織り手》	名詞
＠ほうしあみのおり	《胞子網の織り手》	名詞
＠ほうしあみのおりて	《胞子網の織り手》	名詞
＠む	《胸躍る可能性》	名詞
＠むね	《胸躍る可能性》	名詞
＠むねお	《胸躍る可能性》	名詞
＠むねおど	《胸躍る可能性》	名詞
＠むねおどる	《胸躍る可能性》	名詞
＠むねおどるか	《胸躍る可能性》	名詞
＠むねおどるかの	《胸躍る可能性》	名詞
＠むねおどるかのう	《胸躍る可能性》	名詞
＠むねおどるかのうせ	《胸躍る可能性》	名詞
＠むねおどるかのうせい	《胸躍る可能性》	名詞
＠し	《自然への回帰》	名詞
＠しぜ	《自然への回帰》	名詞
＠しぜん	《自然への回帰》	名詞
＠しぜんへ	《自然への回帰》	名詞
＠しぜんへの	《自然への回帰》	名詞
＠しぜんへのか	《自然への回帰》	名詞
＠しぜんへのかい	《自然への回帰》	名詞
＠しぜんへのかいき	《自然への回帰》	名詞
＠は	《花咲く砂地》	名詞
＠はな	《花咲く砂地》	名詞
＠はなさ	《花咲く砂地》	名詞
＠はなさく	《花咲く砂地》	名詞
＠はなさくす	《花咲く砂地》	名詞
＠はなさくすな	《花咲く砂地》	名詞
＠はなさくすなじ	《花咲く砂地》	名詞
＠え	《英雄的介入》	名詞
＠えい	《英雄的介入》	名詞
＠えいゆ	《英雄的介入》	名詞
＠えいゆう	《英雄的介入》	名詞
＠えいゆうて	《英雄的介入》	名詞
＠えいゆうてき	《英雄的介入》	名詞
＠えいゆうてきか	《英雄的介入》	名詞
＠えいゆうてきかい	《英雄的介入》	名詞
＠えいゆうてきかいに	《英雄的介入》	名詞
＠えいゆうてきかいにゅ	《英雄的介入》	名詞
＠えいゆうてきかいにゅう	《英雄的介入》	名詞
＠い	《茨森の滝》	名詞
＠いば	《茨森の滝》	名詞
＠いばら	《茨森の滝》	名詞
＠いばらも	《茨森の滝》	名詞
＠いばらもり	《茨森の滝》	名詞
＠いばらもりの	《茨森の滝》	名詞
＠いばらもりのた	《茨森の滝》	名詞
＠いばらもりのたき	《茨森の滝》	名詞
＠き	《菌類の再誕》	名詞
＠きん	《菌類の再誕》	名詞
＠きんる	《菌類の再誕》	名詞
＠きんるい	《菌類の再誕》	名詞
＠きんるいの	《菌類の再誕》	名詞
＠きんるいのさ	《菌類の再誕》	名詞
＠きんるいのさい	《菌類の再誕》	名詞
＠きんるいのさいた	《菌類の再誕》	名詞
＠きんるいのさいたん	《菌類の再誕》	名詞
＠お	《落とし格子の蔦》	名詞
＠おと	《落とし格子の蔦》	名詞
＠おとし	《落とし格子の蔦》	名詞
＠おとしご	《落とし格子の蔦》	名詞
＠おとしごう	《落とし格子の蔦》	名詞
＠おとしごうし	《落とし格子の蔦》	名詞
＠おとしごうしの	《落とし格子の蔦》	名詞
＠おとしごうしのつ	《落とし格子の蔦》	名詞
＠おとしごうしのつた	《落とし格子の蔦》	名詞
＠は	《薄暮薔薇の棘、ヴィト》	名詞
＠はく	《薄暮薔薇の棘、ヴィト》	名詞
＠はくぼ	《薄暮薔薇の棘、ヴィト》	名詞
＠はくぼば	《薄暮薔薇の棘、ヴィト》	名詞
＠はくぼばら	《薄暮薔薇の棘、ヴィト》	名詞
＠はくぼばらの	《薄暮薔薇の棘、ヴィト》	名詞
＠はくぼばらのと	《薄暮薔薇の棘、ヴィト》	名詞
＠はくぼばらのとげ	《薄暮薔薇の棘、ヴィト》	名詞
＠はくぼばらのとげ、	《薄暮薔薇の棘、ヴィト》	名詞
＠はくぼばらのとげ、ヴ	《薄暮薔薇の棘、ヴィト》	名詞
＠はくぼばらのとげ、ヴぃ	《薄暮薔薇の棘、ヴィト》	名詞
＠はくぼばらのとげ、ヴぃと	《薄暮薔薇の棘、ヴィト》	名詞
＠ヴ	《薄暮薔薇の棘、ヴィト》	名詞
＠ヴぃ	《薄暮薔薇の棘、ヴィト》	名詞
＠ヴぃと	《薄暮薔薇の棘、ヴィト》	名詞
＠ぎ	《虐殺のワーム》	名詞
＠ぎゃ	《虐殺のワーム》	名詞
＠ぎゃく	《虐殺のワーム》	名詞
＠ぎゃくさ	《虐殺のワーム》	名詞
＠ぎゃくさつ	《虐殺のワーム》	名詞
＠ぎゃくさつの	《虐殺のワーム》	名詞
＠ぎゃくさつのわ	《虐殺のワーム》	名詞
＠ぎゃくさつのわー	《虐殺のワーム》	名詞
＠ぎゃくさつのわーむ	《虐殺のワーム》	名詞
＠ち	《血なまぐさい耽溺》	名詞
＠ちな	《血なまぐさい耽溺》	名詞
＠ちなま	《血なまぐさい耽溺》	名詞
＠ちなまぐ	《血なまぐさい耽溺》	名詞
＠ちなまぐさ	《血なまぐさい耽溺》	名詞
＠ちなまぐさい	《血なまぐさい耽溺》	名詞
＠ちなまぐさいた	《血なまぐさい耽溺》	名詞
＠ちなまぐさいたん	《血なまぐさい耽溺》	名詞
＠ちなまぐさいたんで	《血なまぐさい耽溺》	名詞
＠ちなまぐさいたんでき	《血なまぐさい耽溺》	名詞
＠ち	《血の暴食》	名詞
＠ちの	《血の暴食》	名詞
＠ちのぼ	《血の暴食》	名詞
＠ちのぼう	《血の暴食》	名詞
＠ちのぼうし	《血の暴食》	名詞
＠ちのぼうしょ	《血の暴食》	名詞
＠ちのぼうしょく	《血の暴食》	名詞
＠ち	《血溜まりの洞窟》	名詞
＠ちだ	《血溜まりの洞窟》	名詞
＠ちだま	《血溜まりの洞窟》	名詞
＠ちだまり	《血溜まりの洞窟》	名詞
＠ちだまりの	《血溜まりの洞窟》	名詞
＠ちだまりのど	《血溜まりの洞窟》	名詞
＠ちだまりのどう	《血溜まりの洞窟》	名詞
＠ちだまりのどうく	《血溜まりの洞窟》	名詞
＠ちだまりのどうくつ	《血溜まりの洞窟》	名詞
＠う	《裏切りの強欲》	名詞
＠うら	《裏切りの強欲》	名詞
＠うらぎ	《裏切りの強欲》	名詞
＠うらぎり	《裏切りの強欲》	名詞
＠うらぎりの	《裏切りの強欲》	名詞
＠うらぎりのご	《裏切りの強欲》	名詞
＠うらぎりのごう	《裏切りの強欲》	名詞
＠うらぎりのごうよ	《裏切りの強欲》	名詞
＠うらぎりのごうよく	《裏切りの強欲》	名詞
＠ふ	《複視》	名詞
＠ふく	《複視》	名詞
＠ふくし	《複視》	名詞
＠と	《解き放たれた者、ガラク》	名詞
＠とき	《解き放たれた者、ガラク》	名詞
＠ときは	《解き放たれた者、ガラク》	名詞
＠ときはな	《解き放たれた者、ガラク》	名詞
＠ときはなた	《解き放たれた者、ガラク》	名詞
＠ときはなたれ	《解き放たれた者、ガラク》	名詞
＠ときはなたれた	《解き放たれた者、ガラク》	名詞
＠ときはなたれたも	《解き放たれた者、ガラク》	名詞
＠ときはなたれたもの	《解き放たれた者、ガラク》	名詞
＠ときはなたれたもの、	《解き放たれた者、ガラク》	名詞
＠ときはなたれたもの、が	《解き放たれた者、ガラク》	名詞
＠ときはなたれたもの、がら	《解き放たれた者、ガラク》	名詞
＠ときはなたれたもの、がらく	《解き放たれた者、ガラク》	名詞
＠ほ	《誇り猫》	名詞
＠ほこ	《誇り猫》	名詞
＠ほこり	《誇り猫》	名詞
＠ほこりね	《誇り猫》	名詞
＠ほこりねこ	《誇り猫》	名詞
＠な	《謎変化》	名詞
＠なぞ	《謎変化》	名詞
＠なぞへ	《謎変化》	名詞
＠なぞへん	《謎変化》	名詞
＠なぞへんげ	《謎変化》	名詞
＠ぎ	《議事会の導師》	名詞
＠ぎじ	《議事会の導師》	名詞
＠ぎじか	《議事会の導師》	名詞
＠ぎじかい	《議事会の導師》	名詞
＠ぎじかいの	《議事会の導師》	名詞
＠ぎじかいのど	《議事会の導師》	名詞
＠ぎじかいのどう	《議事会の導師》	名詞
＠ぎじかいのどうし	《議事会の導師》	名詞
＠ご	《護法の要塞》	名詞
＠ごほ	《護法の要塞》	名詞
＠ごほう	《護法の要塞》	名詞
＠ごほうの	《護法の要塞》	名詞
＠ごほうのよ	《護法の要塞》	名詞
＠ごほうのよう	《護法の要塞》	名詞
＠ごほうのようさ	《護法の要塞》	名詞
＠ごほうのようさい	《護法の要塞》	名詞
＠ゆ	《豊かな実りの聖域》	名詞
＠ゆた	《豊かな実りの聖域》	名詞
＠ゆたか	《豊かな実りの聖域》	名詞
＠ゆたかな	《豊かな実りの聖域》	名詞
＠ゆたかなみ	《豊かな実りの聖域》	名詞
＠ゆたかなみの	《豊かな実りの聖域》	名詞
＠ゆたかなみのり	《豊かな実りの聖域》	名詞
＠ゆたかなみのりの	《豊かな実りの聖域》	名詞
＠ゆたかなみのりのせ	《豊かな実りの聖域》	名詞
＠ゆたかなみのりのせい	《豊かな実りの聖域》	名詞
＠ゆたかなみのりのせいい	《豊かな実りの聖域》	名詞
＠ゆたかなみのりのせいいき	《豊かな実りの聖域》	名詞
＠さ	《賽銭ガニ》	名詞
＠さい	《賽銭ガニ》	名詞
＠さいせ	《賽銭ガニ》	名詞
＠さいせん	《賽銭ガニ》	名詞
＠さいせんが	《賽銭ガニ》	名詞
＠さいせんがに	《賽銭ガニ》	名詞
＠ぐ	《軍団の裁き》	名詞
＠ぐん	《軍団の裁き》	名詞
＠ぐんだ	《軍団の裁き》	名詞
＠ぐんだん	《軍団の裁き》	名詞
＠ぐんだんの	《軍団の裁き》	名詞
＠ぐんだんのさ	《軍団の裁き》	名詞
＠ぐんだんのさば	《軍団の裁き》	名詞
＠ぐんだんのさばき	《軍団の裁き》	名詞
＠ま	《迷える探求者、梓》	名詞
＠まよ	《迷える探求者、梓》	名詞
＠まよえ	《迷える探求者、梓》	名詞
＠まよえる	《迷える探求者、梓》	名詞
＠まよえるた	《迷える探求者、梓》	名詞
＠まよえるたん	《迷える探求者、梓》	名詞
＠まよえるたんき	《迷える探求者、梓》	名詞
＠まよえるたんきゅ	《迷える探求者、梓》	名詞
＠まよえるたんきゅう	《迷える探求者、梓》	名詞
＠まよえるたんきゅうし	《迷える探求者、梓》	名詞
＠まよえるたんきゅうしゃ	《迷える探求者、梓》	名詞
＠まよえるたんきゅうしゃ、	《迷える探求者、梓》	名詞
＠まよえるたんきゅうしゃ、あ	《迷える探求者、梓》	名詞
＠まよえるたんきゅうしゃ、あず	《迷える探求者、梓》	名詞
＠まよえるたんきゅうしゃ、あずさ	《迷える探求者、梓》	名詞
＠あ	《迷える探求者、梓》	名詞
＠あず	《迷える探求者、梓》	名詞
＠あずさ	《迷える探求者、梓》	名詞
＠お	《追われる鯨》	名詞
＠おわ	《追われる鯨》	名詞
＠おわれ	《追われる鯨》	名詞
＠おわれる	《追われる鯨》	名詞
＠おわれるく	《追われる鯨》	名詞
＠おわれるくじ	《追われる鯨》	名詞
＠おわれるくじら	《追われる鯨》	名詞
＠せ	《選定された聖歌員》	名詞
＠せん	《選定された聖歌員》	名詞
＠せんて	《選定された聖歌員》	名詞
＠せんてい	《選定された聖歌員》	名詞
＠せんていさ	《選定された聖歌員》	名詞
＠せんていされ	《選定された聖歌員》	名詞
＠せんていされた	《選定された聖歌員》	名詞
＠せんていされたせ	《選定された聖歌員》	名詞
＠せんていされたせい	《選定された聖歌員》	名詞
＠せんていされたせいか	《選定された聖歌員》	名詞
＠せんていされたせいかい	《選定された聖歌員》	名詞
＠せんていされたせいかいん	《選定された聖歌員》	名詞
＠せ	《選択》	名詞
＠せん	《選択》	名詞
＠せんた	《選択》	名詞
＠せんたく	《選択》	名詞
＠さ	《酒場の詐取師》	名詞
＠さか	《酒場の詐取師》	名詞
＠さかば	《酒場の詐取師》	名詞
＠さかばの	《酒場の詐取師》	名詞
＠さかばのさ	《酒場の詐取師》	名詞
＠さかばのさし	《酒場の詐取師》	名詞
＠さかばのさしゅ	《酒場の詐取師》	名詞
＠さかばのさしゅし	《酒場の詐取師》	名詞
＠や	《野生林の災い魔》	名詞
＠やせ	《野生林の災い魔》	名詞
＠やせい	《野生林の災い魔》	名詞
＠やせいり	《野生林の災い魔》	名詞
＠やせいりん	《野生林の災い魔》	名詞
＠やせいりんの	《野生林の災い魔》	名詞
＠やせいりんのわ	《野生林の災い魔》	名詞
＠やせいりんのわざ	《野生林の災い魔》	名詞
＠やせいりんのわざわ	《野生林の災い魔》	名詞
＠やせいりんのわざわい	《野生林の災い魔》	名詞
＠やせいりんのわざわいま	《野生林の災い魔》	名詞
＠か	《金屑化》	名詞
＠かな	《金屑化》	名詞
＠かなく	《金屑化》	名詞
＠かなくず	《金屑化》	名詞
＠かなくずか	《金屑化》	名詞
＠き	《金属複製機》	名詞
＠きん	《金属複製機》	名詞
＠きんぞ	《金属複製機》	名詞
＠きんぞく	《金属複製機》	名詞
＠きんぞくふ	《金属複製機》	名詞
＠きんぞくふく	《金属複製機》	名詞
＠きんぞくふくせ	《金属複製機》	名詞
＠きんぞくふくせい	《金属複製機》	名詞
＠きんぞくふくせいき	《金属複製機》	名詞
＠ぎ	《銀打ちのグール》	名詞
＠ぎん	《銀打ちのグール》	名詞
＠ぎんう	《銀打ちのグール》	名詞
＠ぎんうち	《銀打ちのグール》	名詞
＠ぎんうちの	《銀打ちのグール》	名詞
＠ぎんうちのぐ	《銀打ちのグール》	名詞
＠ぎんうちのぐー	《銀打ちのグール》	名詞
＠ぎんうちのぐーる	《銀打ちのグール》	名詞
＠れ	《錬金術師の贈り物》	名詞
＠れん	《錬金術師の贈り物》	名詞
＠れんき	《錬金術師の贈り物》	名詞
＠れんきん	《錬金術師の贈り物》	名詞
＠れんきんじ	《錬金術師の贈り物》	名詞
＠れんきんじゅ	《錬金術師の贈り物》	名詞
＠れんきんじゅつ	《錬金術師の贈り物》	名詞
＠れんきんじゅつし	《錬金術師の贈り物》	名詞
＠れんきんじゅつしの	《錬金術師の贈り物》	名詞
＠れんきんじゅつしのお	《錬金術師の贈り物》	名詞
＠れんきんじゅつしのおく	《錬金術師の贈り物》	名詞
＠れんきんじゅつしのおくり	《錬金術師の贈り物》	名詞
＠れんきんじゅつしのおくりも	《錬金術師の贈り物》	名詞
＠れんきんじゅつしのおくりもの	《錬金術師の贈り物》	名詞
＠き	《鍛え抜かれた古参兵》	名詞
＠きた	《鍛え抜かれた古参兵》	名詞
＠きたえ	《鍛え抜かれた古参兵》	名詞
＠きたえぬ	《鍛え抜かれた古参兵》	名詞
＠きたえぬか	《鍛え抜かれた古参兵》	名詞
＠きたえぬかれ	《鍛え抜かれた古参兵》	名詞
＠きたえぬかれた	《鍛え抜かれた古参兵》	名詞
＠きたえぬかれたこ	《鍛え抜かれた古参兵》	名詞
＠きたえぬかれたこさ	《鍛え抜かれた古参兵》	名詞
＠きたえぬかれたこさん	《鍛え抜かれた古参兵》	名詞
＠きたえぬかれたこさんへ	《鍛え抜かれた古参兵》	名詞
＠きたえぬかれたこさんへい	《鍛え抜かれた古参兵》	名詞
＠く	《鎖霊》	名詞
＠くさ	《鎖霊》	名詞
＠くさり	《鎖霊》	名詞
＠くさりれ	《鎖霊》	名詞
＠くさりれい	《鎖霊》	名詞
＠ち	《長老ガーガロス》	名詞
＠ちょ	《長老ガーガロス》	名詞
＠ちょう	《長老ガーガロス》	名詞
＠ちょうろ	《長老ガーガロス》	名詞
＠ちょうろう	《長老ガーガロス》	名詞
＠ちょうろうが	《長老ガーガロス》	名詞
＠ちょうろうがー	《長老ガーガロス》	名詞
＠ちょうろうがーが	《長老ガーガロス》	名詞
＠ちょうろうがーがろ	《長老ガーガロス》	名詞
＠ちょうろうがーがろす	《長老ガーガロス》	名詞
＠ま	《間に合わせの大隊》	名詞
＠まに	《間に合わせの大隊》	名詞
＠まにあ	《間に合わせの大隊》	名詞
＠まにあわ	《間に合わせの大隊》	名詞
＠まにあわせ	《間に合わせの大隊》	名詞
＠まにあわせの	《間に合わせの大隊》	名詞
＠まにあわせのだ	《間に合わせの大隊》	名詞
＠まにあわせのだい	《間に合わせの大隊》	名詞
＠まにあわせのだいた	《間に合わせの大隊》	名詞
＠まにあわせのだいたい	《間に合わせの大隊》	名詞
＠や	《闇の掌握》	名詞
＠やみ	《闇の掌握》	名詞
＠やみの	《闇の掌握》	名詞
＠やみのし	《闇の掌握》	名詞
＠やみのしょ	《闇の掌握》	名詞
＠やみのしょう	《闇の掌握》	名詞
＠やみのしょうあ	《闇の掌握》	名詞
＠やみのしょうあく	《闇の掌握》	名詞
＠い	《陰鬱な僻地》	名詞
＠いん	《陰鬱な僻地》	名詞
＠いんう	《陰鬱な僻地》	名詞
＠いんうつ	《陰鬱な僻地》	名詞
＠いんうつな	《陰鬱な僻地》	名詞
＠いんうつなへ	《陰鬱な僻地》	名詞
＠いんうつなへき	《陰鬱な僻地》	名詞
＠いんうつなへきち	《陰鬱な僻地》	名詞
＠い	《隕石》	名詞
＠いん	《隕石》	名詞
＠いんせ	《隕石》	名詞
＠いんせき	《隕石》	名詞
＠は	《隼使いの達人》	名詞
＠はや	《隼使いの達人》	名詞
＠はやぶ	《隼使いの達人》	名詞
＠はやぶさ	《隼使いの達人》	名詞
＠はやぶさつ	《隼使いの達人》	名詞
＠はやぶさつか	《隼使いの達人》	名詞
＠はやぶさつかい	《隼使いの達人》	名詞
＠はやぶさつかいの	《隼使いの達人》	名詞
＠はやぶさつかいのた	《隼使いの達人》	名詞
＠はやぶさつかいのたつ	《隼使いの達人》	名詞
＠はやぶさつかいのたつじ	《隼使いの達人》	名詞
＠はやぶさつかいのたつじん	《隼使いの達人》	名詞
＠な	《難破船の探知者》	名詞
＠なん	《難破船の探知者》	名詞
＠なんぱ	《難破船の探知者》	名詞
＠なんぱせ	《難破船の探知者》	名詞
＠なんぱせん	《難破船の探知者》	名詞
＠なんぱせんの	《難破船の探知者》	名詞
＠なんぱせんのた	《難破船の探知者》	名詞
＠なんぱせんのたん	《難破船の探知者》	名詞
＠なんぱせんのたんち	《難破船の探知者》	名詞
＠なんぱせんのたんちし	《難破船の探知者》	名詞
＠なんぱせんのたんちしゃ	《難破船の探知者》	名詞
＠ら	《雷光の猟犬》	名詞
＠らい	《雷光の猟犬》	名詞
＠らいこ	《雷光の猟犬》	名詞
＠らいこう	《雷光の猟犬》	名詞
＠らいこうの	《雷光の猟犬》	名詞
＠らいこうのり	《雷光の猟犬》	名詞
＠らいこうのりょ	《雷光の猟犬》	名詞
＠らいこうのりょう	《雷光の猟犬》	名詞
＠らいこうのりょうけ	《雷光の猟犬》	名詞
＠らいこうのりょうけん	《雷光の猟犬》	名詞
＠し	《霜のブレス》	名詞
＠しも	《霜のブレス》	名詞
＠しもの	《霜のブレス》	名詞
＠しものぶ	《霜のブレス》	名詞
＠しものぶれ	《霜のブレス》	名詞
＠しものぶれす	《霜のブレス》	名詞
＠し	《静かな水の聖域》	名詞
＠しず	《静かな水の聖域》	名詞
＠しずか	《静かな水の聖域》	名詞
＠しずかな	《静かな水の聖域》	名詞
＠しずかなみ	《静かな水の聖域》	名詞
＠しずかなみず	《静かな水の聖域》	名詞
＠しずかなみずの	《静かな水の聖域》	名詞
＠しずかなみずのせ	《静かな水の聖域》	名詞
＠しずかなみずのせい	《静かな水の聖域》	名詞
＠しずかなみずのせいい	《静かな水の聖域》	名詞
＠しずかなみずのせいいき	《静かな水の聖域》	名詞
＠し	《静かな隠し矢》	名詞
＠しず	《静かな隠し矢》	名詞
＠しずか	《静かな隠し矢》	名詞
＠しずかな	《静かな隠し矢》	名詞
＠しずかなか	《静かな隠し矢》	名詞
＠しずかなかく	《静かな隠し矢》	名詞
＠しずかなかくし	《静かな隠し矢》	名詞
＠しずかなかくしや	《静かな隠し矢》	名詞
＠せ	《静寂の神殿》	名詞
＠せい	《静寂の神殿》	名詞
＠せいじ	《静寂の神殿》	名詞
＠せいじゃ	《静寂の神殿》	名詞
＠せいじゃく	《静寂の神殿》	名詞
＠せいじゃくの	《静寂の神殿》	名詞
＠せいじゃくのし	《静寂の神殿》	名詞
＠せいじゃくのしん	《静寂の神殿》	名詞
＠せいじゃくのしんで	《静寂の神殿》	名詞
＠せいじゃくのしんでん	《静寂の神殿》	名詞
＠ひ	《非実体化》	名詞
＠ひじ	《非実体化》	名詞
＠ひじっ	《非実体化》	名詞
＠ひじった	《非実体化》	名詞
＠ひじったい	《非実体化》	名詞
＠ひじったいか	《非実体化》	名詞
＠ず	《頭巾様の荒廃牙》	名詞
＠ずき	《頭巾様の荒廃牙》	名詞
＠ずきん	《頭巾様の荒廃牙》	名詞
＠ずきんよ	《頭巾様の荒廃牙》	名詞
＠ずきんよう	《頭巾様の荒廃牙》	名詞
＠ずきんようの	《頭巾様の荒廃牙》	名詞
＠ずきんようのこ	《頭巾様の荒廃牙》	名詞
＠ずきんようのこう	《頭巾様の荒廃牙》	名詞
＠ずきんようのこうは	《頭巾様の荒廃牙》	名詞
＠ずきんようのこうはい	《頭巾様の荒廃牙》	名詞
＠ずきんようのこうはいき	《頭巾様の荒廃牙》	名詞
＠ずきんようのこうはいきば	《頭巾様の荒廃牙》	名詞
＠ふ	《風に削られた岩山》	名詞
＠ふう	《風に削られた岩山》	名詞
＠ふうに	《風に削られた岩山》	名詞
＠ふうにけ	《風に削られた岩山》	名詞
＠ふうにけず	《風に削られた岩山》	名詞
＠ふうにけずら	《風に削られた岩山》	名詞
＠ふうにけずられ	《風に削られた岩山》	名詞
＠ふうにけずられた	《風に削られた岩山》	名詞
＠ふうにけずられたい	《風に削られた岩山》	名詞
＠ふうにけずられたいわ	《風に削られた岩山》	名詞
＠ふうにけずられたいわや	《風に削られた岩山》	名詞
＠ふうにけずられたいわやま	《風に削られた岩山》	名詞
＠そ	《騒乱の道化》	名詞
＠そう	《騒乱の道化》	名詞
＠そうら	《騒乱の道化》	名詞
＠そうらん	《騒乱の道化》	名詞
＠そうらんの	《騒乱の道化》	名詞
＠そうらんのど	《騒乱の道化》	名詞
＠そうらんのどう	《騒乱の道化》	名詞
＠そうらんのどうけ	《騒乱の道化》	名詞
＠ほ	《骨穴の粗暴者》	名詞
＠ほね	《骨穴の粗暴者》	名詞
＠ほねあ	《骨穴の粗暴者》	名詞
＠ほねあな	《骨穴の粗暴者》	名詞
＠ほねあなの	《骨穴の粗暴者》	名詞
＠ほねあなのそ	《骨穴の粗暴者》	名詞
＠ほねあなのそぼ	《骨穴の粗暴者》	名詞
＠ほねあなのそぼう	《骨穴の粗暴者》	名詞
＠ほねあなのそぼうし	《骨穴の粗暴者》	名詞
＠ほねあなのそぼうしゃ	《骨穴の粗暴者》	名詞
＠が	《骸骨射手》	名詞
＠がい	《骸骨射手》	名詞
＠がいこ	《骸骨射手》	名詞
＠がいこつ	《骸骨射手》	名詞
＠がいこつし	《骸骨射手》	名詞
＠がいこつしゃ	《骸骨射手》	名詞
＠がいこつしゃし	《骸骨射手》	名詞
＠がいこつしゃしゅ	《骸骨射手》	名詞
＠こ	《高尚な否定》	名詞
＠こう	《高尚な否定》	名詞
＠こうし	《高尚な否定》	名詞
＠こうしょ	《高尚な否定》	名詞
＠こうしょう	《高尚な否定》	名詞
＠こうしょうな	《高尚な否定》	名詞
＠こうしょうなひ	《高尚な否定》	名詞
＠こうしょうなひて	《高尚な否定》	名詞
＠こうしょうなひてい	《高尚な否定》	名詞
＠こ	《高山の犬師》	名詞
＠こう	《高山の犬師》	名詞
＠こうざ	《高山の犬師》	名詞
＠こうざん	《高山の犬師》	名詞
＠こうざんの	《高山の犬師》	名詞
＠こうざんのい	《高山の犬師》	名詞
＠こうざんのいぬ	《高山の犬師》	名詞
＠こうざんのいぬし	《高山の犬師》	名詞
＠こ	《高山の番犬》	名詞
＠こう	《高山の番犬》	名詞
＠こうざ	《高山の番犬》	名詞
＠こうざん	《高山の番犬》	名詞
＠こうざんの	《高山の番犬》	名詞
＠こうざんのば	《高山の番犬》	名詞
＠こうざんのばん	《高山の番犬》	名詞
＠こうざんのばんけ	《高山の番犬》	名詞
＠こうざんのばんけん	《高山の番犬》	名詞
＠こ	《高揚する書物》	名詞
＠こう	《高揚する書物》	名詞
＠こうよ	《高揚する書物》	名詞
＠こうよう	《高揚する書物》	名詞
＠こうようす	《高揚する書物》	名詞
＠こうようする	《高揚する書物》	名詞
＠こうようするし	《高揚する書物》	名詞
＠こうようするしょ	《高揚する書物》	名詞
＠こうようするしょも	《高揚する書物》	名詞
＠こうようするしょもつ	《高揚する書物》	名詞
＠た	《魂焦がし》	名詞
＠たま	《魂焦がし》	名詞
＠たまし	《魂焦がし》	名詞
＠たましい	《魂焦がし》	名詞
＠たましいこ	《魂焦がし》	名詞
＠たましいこが	《魂焦がし》	名詞
＠たましいこがし	《魂焦がし》	名詞
＠ま	《魔女の大釜》	名詞
＠まじ	《魔女の大釜》	名詞
＠まじょ	《魔女の大釜》	名詞
＠まじょの	《魔女の大釜》	名詞
＠まじょのお	《魔女の大釜》	名詞
＠まじょのおお	《魔女の大釜》	名詞7
＠まじょのおおか	《魔女の大釜》	名詞
＠まじょのおおかま	《魔女の大釜》	名詞
＠ま	《魔王の器》	名詞
＠まお	《魔王の器》	名詞
＠まおう	《魔王の器》	名詞
＠まおうの	《魔王の器》	名詞
＠まおうのう	《魔王の器》	名詞
＠まおうのうつ	《魔王の器》	名詞
＠まおうのうつわ	《魔王の器》	名詞
＠ち	《鳥獣保護区》	名詞
＠ちょ	《鳥獣保護区》	名詞
＠ちょう	《鳥獣保護区》	名詞
＠ちょうじ	《鳥獣保護区》	名詞
＠ちょうじゅ	《鳥獣保護区》	名詞
＠ちょうじゅう	《鳥獣保護区》	名詞
＠ちょうじゅうほ	《鳥獣保護区》	名詞
＠ちょうじゅうほご	《鳥獣保護区》	名詞
＠ちょうじゅうほごく	《鳥獣保護区》	名詞
