＠う	《うろつくカラカル》	名詞
＠うろ	《うろつくカラカル》	名詞
＠うろつ	《うろつくカラカル》	名詞
＠うろつく	《うろつくカラカル》	名詞
＠うろつくか	《うろつくカラカル》	名詞
＠うろつくから	《うろつくカラカル》	名詞
＠うろつくからか	《うろつくカラカル》	名詞
＠うろつくからかる	《うろつくカラカル》	名詞
＠は	《はびこる精霊》	名詞
＠はび	《はびこる精霊》	名詞
＠はびこ	《はびこる精霊》	名詞
＠はびこる	《はびこる精霊》	名詞
＠はびこるし	《はびこる精霊》	名詞
＠はびこるしょ	《はびこる精霊》	名詞
＠はびこるしょう	《はびこる精霊》	名詞
＠はびこるしょうり	《はびこる精霊》	名詞
＠はびこるしょうりょ	《はびこる精霊》	名詞
＠はびこるしょうりょう	《はびこる精霊》	名詞
＠ま	《まばゆい神盾》	名詞
＠まば	《まばゆい神盾》	名詞
＠まばゆ	《まばゆい神盾》	名詞
＠まばゆい	《まばゆい神盾》	名詞
＠まばゆいか	《まばゆい神盾》	名詞
＠まばゆいかみ	《まばゆい神盾》	名詞
＠まばゆいかみだ	《まばゆい神盾》	名詞
＠まばゆいかみだて	《まばゆい神盾》	名詞
＠あ	《アンデッドの召使い》	名詞
＠あん	《アンデッドの召使い》	名詞
＠あんで	《アンデッドの召使い》	名詞
＠あんでっ	《アンデッドの召使い》	名詞
＠あんでっど	《アンデッドの召使い》	名詞
＠あんでっどの	《アンデッドの召使い》	名詞
＠あんでっどのめ	《アンデッドの召使い》	名詞
＠あんでっどのめし	《アンデッドの召使い》	名詞
＠あんでっどのめしつ	《アンデッドの召使い》	名詞
＠あんでっどのめしつか	《アンデッドの召使い》	名詞
＠あんでっどのめしつかい	《アンデッドの召使い》	名詞
＠あ	《アーク弓のレインジャー、ビビアン》	名詞
＠あー	《アーク弓のレインジャー、ビビアン》	名詞
＠あーく	《アーク弓のレインジャー、ビビアン》	名詞
＠あーくゆ	《アーク弓のレインジャー、ビビアン》	名詞
＠あーくゆみ	《アーク弓のレインジャー、ビビアン》	名詞
＠あーくゆみの	《アーク弓のレインジャー、ビビアン》	名詞
＠あーくゆみのれ	《アーク弓のレインジャー、ビビアン》	名詞
＠あーくゆみのれい	《アーク弓のレインジャー、ビビアン》	名詞
＠あーくゆみのれいん	《アーク弓のレインジャー、ビビアン》	名詞
＠あーくゆみのれいんじ	《アーク弓のレインジャー、ビビアン》	名詞
＠あーくゆみのれいんじゃ	《アーク弓のレインジャー、ビビアン》	名詞
＠あーくゆみのれいんじゃー	《アーク弓のレインジャー、ビビアン》	名詞
＠あーくゆみのれいんじゃー、	《アーク弓のレインジャー、ビビアン》	名詞
＠あーくゆみのれいんじゃー、び	《アーク弓のレインジャー、ビビアン》	名詞
＠あーくゆみのれいんじゃー、びび	《アーク弓のレインジャー、ビビアン》	名詞
＠あーくゆみのれいんじゃー、びびあ	《アーク弓のレインジャー、ビビアン》	名詞
＠あーくゆみのれいんじゃー、びびあん	《アーク弓のレインジャー、ビビアン》	名詞
＠い	《イーヴォ島の管理人》	名詞
＠いー	《イーヴォ島の管理人》	名詞
＠いーう	《イーヴォ島の管理人》	名詞
＠いーヴ	《イーヴォ島の管理人》	名詞
＠いーヴぉ	《イーヴォ島の管理人》	名詞
＠いーヴぉじ	《イーヴォ島の管理人》	名詞
＠いーヴぉじま	《イーヴォ島の管理人》	名詞
＠いーヴぉじまの	《イーヴォ島の管理人》	名詞
＠いーヴぉじまのか	《イーヴォ島の管理人》	名詞
＠いーヴぉじまのかん	《イーヴォ島の管理人》	名詞
＠いーヴぉじまのかんり	《イーヴォ島の管理人》	名詞
＠いーヴぉじまのかんりに	《イーヴォ島の管理人》	名詞
＠いーヴぉじまのかんりにん	《イーヴォ島の管理人》	名詞
＠え	《エリマキサンドワラ》	名詞
＠えり	《エリマキサンドワラ》	名詞
＠えりま	《エリマキサンドワラ》	名詞
＠えりまき	《エリマキサンドワラ》	名詞
＠えりまきさ	《エリマキサンドワラ》	名詞
＠えりまきさん	《エリマキサンドワラ》	名詞
＠えりまきさんど	《エリマキサンドワラ》	名詞
＠えりまきさんどわ	《エリマキサンドワラ》	名詞
＠えりまきさんどわら	《エリマキサンドワラ》	名詞
＠え	《エルフの開墾者》	名詞
＠える	《エルフの開墾者》	名詞
＠えるふ	《エルフの開墾者》	名詞
＠えるふの	《エルフの開墾者》	名詞
＠えるふのか	《エルフの開墾者》	名詞
＠えるふのかい	《エルフの開墾者》	名詞
＠えるふのかいこ	《エルフの開墾者》	名詞
＠えるふのかいこん	《エルフの開墾者》	名詞
＠えるふのかいこんし	《エルフの開墾者》	名詞
＠えるふのかいこんしゃ	《エルフの開墾者》	名詞
＠お	《オーガの包囲破り》	名詞
＠おー	《オーガの包囲破り》	名詞
＠おーが	《オーガの包囲破り》	名詞
＠おーがの	《オーガの包囲破り》	名詞
＠おーがのほ	《オーガの包囲破り》	名詞
＠おーがのほう	《オーガの包囲破り》	名詞
＠おーがのほうい	《オーガの包囲破り》	名詞
＠おーがのほういや	《オーガの包囲破り》	名詞
＠おーがのほういやぶ	《オーガの包囲破り》	名詞
＠おーがのほういやぶり	《オーガの包囲破り》	名詞
＠ぐ	《グリフィンの歩哨》	名詞
＠ぐり	《グリフィンの歩哨》	名詞
＠ぐりふ	《グリフィンの歩哨》	名詞
＠ぐりふぃ	《グリフィンの歩哨》	名詞
＠ぐりふぃん	《グリフィンの歩哨》	名詞
＠ぐりふぃんの	《グリフィンの歩哨》	名詞
＠ぐりふぃんのほ	《グリフィンの歩哨》	名詞
＠ぐりふぃんのほし	《グリフィンの歩哨》	名詞
＠ぐりふぃんのほしょ	《グリフィンの歩哨》	名詞
＠ぐりふぃんのほしょう	《グリフィンの歩哨》	名詞
＠ぐ	《グレイブディガー》	名詞
＠ぐれ	《グレイブディガー》	名詞
＠ぐれい	《グレイブディガー》	名詞
＠ぐれいぶ	《グレイブディガー》	名詞
＠ぐれいぶで	《グレイブディガー》	名詞
＠ぐれいぶでぃ	《グレイブディガー》	名詞
＠ぐれいぶでぃが	《グレイブディガー》	名詞
＠ぐれいぶでぃがー	《グレイブディガー》	名詞
＠け	《ケルドの略奪者》	名詞
＠ける	《ケルドの略奪者》	名詞
＠けるど	《ケルドの略奪者》	名詞
＠けるどの	《ケルドの略奪者》	名詞
＠けるどのり	《ケルドの略奪者》	名詞
＠けるどのりゃ	《ケルドの略奪者》	名詞
＠けるどのりゃく	《ケルドの略奪者》	名詞
＠けるどのりゃくだ	《ケルドの略奪者》	名詞
＠けるどのりゃくだつ	《ケルドの略奪者》	名詞
＠けるどのりゃくだつし	《ケルドの略奪者》	名詞
＠けるどのりゃくだつしゃ	《ケルドの略奪者》	名詞
＠け	《ケンタウルスの狩猟者》	名詞
＠けん	《ケンタウルスの狩猟者》	名詞
＠けんた	《ケンタウルスの狩猟者》	名詞
＠けんたう	《ケンタウルスの狩猟者》	名詞
＠けんたうる	《ケンタウルスの狩猟者》	名詞
＠けんたうるす	《ケンタウルスの狩猟者》	名詞
＠けんたうるすの	《ケンタウルスの狩猟者》	名詞
＠けんたうるすのし	《ケンタウルスの狩猟者》	名詞
＠けんたうるすのしゅ	《ケンタウルスの狩猟者》	名詞
＠けんたうるすのしゅり	《ケンタウルスの狩猟者》	名詞
＠けんたうるすのしゅりょ	《ケンタウルスの狩猟者》	名詞
＠けんたうるすのしゅりょう	《ケンタウルスの狩猟者》	名詞
＠けんたうるすのしゅりょうし	《ケンタウルスの狩猟者》	名詞
＠けんたうるすのしゅりょうしゃ	《ケンタウルスの狩猟者》	名詞
＠ご	《ゴブリンの密輸人》	名詞
＠ごぶ	《ゴブリンの密輸人》	名詞
＠ごぶり	《ゴブリンの密輸人》	名詞
＠ごぶりん	《ゴブリンの密輸人》	名詞
＠ごぶりんの	《ゴブリンの密輸人》	名詞
＠ごぶりんのみ	《ゴブリンの密輸人》	名詞
＠ごぶりんのみつ	《ゴブリンの密輸人》	名詞
＠ごぶりんのみつゆ	《ゴブリンの密輸人》	名詞
＠ごぶりんのみつゆじ	《ゴブリンの密輸人》	名詞
＠ごぶりんのみつゆじん	《ゴブリンの密輸人》	名詞
＠ご	《ゴブリンの通り魔》	名詞
＠ごぶ	《ゴブリンの通り魔》	名詞
＠ごぶり	《ゴブリンの通り魔》	名詞
＠ごぶりん	《ゴブリンの通り魔》	名詞
＠ごぶりんの	《ゴブリンの通り魔》	名詞
＠ごぶりんのと	《ゴブリンの通り魔》	名詞
＠ごぶりんのとお	《ゴブリンの通り魔》	名詞
＠ごぶりんのとおり	《ゴブリンの通り魔》	名詞
＠ごぶりんのとおりま	《ゴブリンの通り魔》	名詞
＠ご	《ゴブリンの首謀者》	名詞
＠ごぶ	《ゴブリンの首謀者》	名詞
＠ごぶり	《ゴブリンの首謀者》	名詞
＠ごぶりん	《ゴブリンの首謀者》	名詞
＠ごぶりんの	《ゴブリンの首謀者》	名詞
＠ごぶりんのし	《ゴブリンの首謀者》	名詞
＠ごぶりんのしゅ	《ゴブリンの首謀者》	名詞
＠ごぶりんのしゅぼ	《ゴブリンの首謀者》	名詞
＠ごぶりんのしゅぼう	《ゴブリンの首謀者》	名詞
＠ごぶりんのしゅぼうし	《ゴブリンの首謀者》	名詞
＠ごぶりんのしゅぼうしゃ	《ゴブリンの首謀者》	名詞
＠ご	《ゴブリンの鳥掴み》	名詞
＠ごぶ	《ゴブリンの鳥掴み》	名詞
＠ごぶり	《ゴブリンの鳥掴み》	名詞
＠ごぶりん	《ゴブリンの鳥掴み》	名詞
＠ごぶりんの	《ゴブリンの鳥掴み》	名詞
＠ごぶりんのと	《ゴブリンの鳥掴み》	名詞
＠ごぶりんのとり	《ゴブリンの鳥掴み》	名詞
＠ごぶりんのとりづ	《ゴブリンの鳥掴み》	名詞
＠ごぶりんのとりづか	《ゴブリンの鳥掴み》	名詞
＠ごぶりんのとりづかみ	《ゴブリンの鳥掴み》	名詞
＠さ	《サバンナの賢者》	名詞
＠さば	《サバンナの賢者》	名詞
＠さばん	《サバンナの賢者》	名詞
＠さばんな	《サバンナの賢者》	名詞
＠さばんなの	《サバンナの賢者》	名詞
＠さばんなのけ	《サバンナの賢者》	名詞
＠さばんなのけん	《サバンナの賢者》	名詞
＠さばんなのけんじ	《サバンナの賢者》	名詞
＠さばんなのけんじゃ	《サバンナの賢者》	名詞
＠し	《ショック》	名詞
＠しょ	《ショック》	名詞
＠しょっ	《ショック》	名詞
＠しょっく	《ショック》	名詞
＠し	《シルバーバックの巫師》	名詞
＠しる	《シルバーバックの巫師》	名詞
＠しるば	《シルバーバックの巫師》	名詞
＠しるばー	《シルバーバックの巫師》	名詞
＠しるばーば	《シルバーバックの巫師》	名詞
＠しるばーばっ	《シルバーバックの巫師》	名詞
＠しるばーばっく	《シルバーバックの巫師》	名詞
＠しるばーばっくの	《シルバーバックの巫師》	名詞
＠しるばーばっくのみ	《シルバーバックの巫師》	名詞
＠しるばーばっくのみこ	《シルバーバックの巫師》	名詞
＠しるばーばっくのみこし	《シルバーバックの巫師》	名詞
＠し	《シヴ山のドラゴン》	名詞
＠しう	《シヴ山のドラゴン》	名詞
＠しヴ	《シヴ山のドラゴン》	名詞
＠しヴや	《シヴ山のドラゴン》	名詞
＠しヴやま	《シヴ山のドラゴン》	名詞
＠しヴやまの	《シヴ山のドラゴン》	名詞
＠しヴやまのど	《シヴ山のドラゴン》	名詞
＠しヴやまのどら	《シヴ山のドラゴン》	名詞
＠しヴやまのどらご	《シヴ山のドラゴン》	名詞
＠しヴやまのどらごん	《シヴ山のドラゴン》	名詞
＠じ	《ジャングルのうろ穴》	名詞
＠じゃ	《ジャングルのうろ穴》	名詞
＠じゃん	《ジャングルのうろ穴》	名詞
＠じゃんぐ	《ジャングルのうろ穴》	名詞
＠じゃんぐる	《ジャングルのうろ穴》	名詞
＠じゃんぐるの	《ジャングルのうろ穴》	名詞
＠じゃんぐるのう	《ジャングルのうろ穴》	名詞
＠じゃんぐるのうろ	《ジャングルのうろ穴》	名詞
＠じゃんぐるのうろあ	《ジャングルのうろ穴》	名詞
＠じゃんぐるのうろあな	《ジャングルのうろ穴》	名詞
＠せ	《セラの守護者》	名詞
＠せら	《セラの守護者》	名詞
＠せらの	《セラの守護者》	名詞
＠せらのし	《セラの守護者》	名詞
＠せらのしゅ	《セラの守護者》	名詞
＠せらのしゅご	《セラの守護者》	名詞
＠せらのしゅごし	《セラの守護者》	名詞
＠せらのしゅごしゃ	《セラの守護者》	名詞
＠そ	《ソリンの案内人》	名詞
＠そり	《ソリンの案内人》	名詞
＠そりん	《ソリンの案内人》	名詞
＠そりんの	《ソリンの案内人》	名詞
＠そりんのあ	《ソリンの案内人》	名詞
＠そりんのあん	《ソリンの案内人》	名詞
＠そりんのあんな	《ソリンの案内人》	名詞
＠そりんのあんない	《ソリンの案内人》	名詞
＠そりんのあんないに	《ソリンの案内人》	名詞
＠そりんのあんないにん	《ソリンの案内人》	名詞
＠そ	《ソリンの渇き》	名詞
＠そり	《ソリンの渇き》	名詞
＠そりん	《ソリンの渇き》	名詞
＠そりんの	《ソリンの渇き》	名詞
＠そりんのか	《ソリンの渇き》	名詞
＠そりんのかわ	《ソリンの渇き》	名詞
＠そりんのかわき	《ソリンの渇き》	名詞
＠だ	《ダイアモンドの騎士》	名詞
＠だい	《ダイアモンドの騎士》	名詞
＠だいあ	《ダイアモンドの騎士》	名詞
＠だいあも	《ダイアモンドの騎士》	名詞
＠だいあもん	《ダイアモンドの騎士》	名詞
＠だいあもんど	《ダイアモンドの騎士》	名詞
＠だいあもんどの	《ダイアモンドの騎士》	名詞
＠だいあもんどのき	《ダイアモンドの騎士》	名詞
＠だいあもんどのきし	《ダイアモンドの騎士》	名詞
＠ち	《チャンドラの吐火》	名詞
＠ちゃ	《チャンドラの吐火》	名詞
＠ちゃん	《チャンドラの吐火》	名詞
＠ちゃんど	《チャンドラの吐火》	名詞
＠ちゃんどら	《チャンドラの吐火》	名詞
＠ちゃんどらの	《チャンドラの吐火》	名詞
＠ちゃんどらのと	《チャンドラの吐火》	名詞
＠ちゃんどらのとひ	《チャンドラの吐火》	名詞
＠ち	《チャンドラの憤慨》	名詞
＠ちゃ	《チャンドラの憤慨》	名詞
＠ちゃん	《チャンドラの憤慨》	名詞
＠ちゃんど	《チャンドラの憤慨》	名詞
＠ちゃんどら	《チャンドラの憤慨》	名詞
＠ちゃんどらの	《チャンドラの憤慨》	名詞
＠ちゃんどらのふ	《チャンドラの憤慨》	名詞
＠ちゃんどらのふん	《チャンドラの憤慨》	名詞
＠ちゃんどらのふんが	《チャンドラの憤慨》	名詞
＠ちゃんどらのふんがい	《チャンドラの憤慨》	名詞
＠ち	《チャンドラの火炎猫》	名詞
＠ちゃ	《チャンドラの火炎猫》	名詞
＠ちゃん	《チャンドラの火炎猫》	名詞
＠ちゃんど	《チャンドラの火炎猫》	名詞
＠ちゃんどら	《チャンドラの火炎猫》	名詞
＠ちゃんどらの	《チャンドラの火炎猫》	名詞
＠ちゃんどらのか	《チャンドラの火炎猫》	名詞
＠ちゃんどらのかえ	《チャンドラの火炎猫》	名詞
＠ちゃんどらのかえん	《チャンドラの火炎猫》	名詞
＠ちゃんどらのかえんね	《チャンドラの火炎猫》	名詞
＠ちゃんどらのかえんねこ	《チャンドラの火炎猫》	名詞
＠ち	《チャンドラの炎波》	名詞
＠ちゃ	《チャンドラの炎波》	名詞
＠ちゃん	《チャンドラの炎波》	名詞
＠ちゃんど	《チャンドラの炎波》	名詞
＠ちゃんどら	《チャンドラの炎波》	名詞
＠ちゃんどらの	《チャンドラの炎波》	名詞
＠ちゃんどらのほ	《チャンドラの炎波》	名詞
＠ちゃんどらのほの	《チャンドラの炎波》	名詞
＠ちゃんどらのほのお	《チャンドラの炎波》	名詞
＠ちゃんどらのほのおな	《チャンドラの炎波》	名詞
＠ちゃんどらのほのおなみ	《チャンドラの炎波》	名詞
＠ち	《チャンドラの調圧器》	名詞
＠ちゃ	《チャンドラの調圧器》	名詞
＠ちゃん	《チャンドラの調圧器》	名詞
＠ちゃんど	《チャンドラの調圧器》	名詞
＠ちゃんどら	《チャンドラの調圧器》	名詞
＠ちゃんどらの	《チャンドラの調圧器》	名詞
＠ちゃんどらのち	《チャンドラの調圧器》	名詞
＠ちゃんどらのちょ	《チャンドラの調圧器》	名詞
＠ちゃんどらのちょう	《チャンドラの調圧器》	名詞
＠ちゃんどらのちょうあ	《チャンドラの調圧器》	名詞
＠ちゃんどらのちょうあつ	《チャンドラの調圧器》	名詞
＠ちゃんどらのちょうあつう	《チャンドラの調圧器》	名詞
＠ちゃんどらのちょうあつうつ	《チャンドラの調圧器》	名詞
＠ちゃんどらのちょうあつうつわ	《チャンドラの調圧器》	名詞
＠ど	《ドラゴン魔道士》	名詞
＠どら	《ドラゴン魔道士》	名詞
＠どらご	《ドラゴン魔道士》	名詞
＠どらごん	《ドラゴン魔道士》	名詞
＠どらごんま	《ドラゴン魔道士》	名詞
＠どらごんまど	《ドラゴン魔道士》	名詞
＠どらごんまどう	《ドラゴン魔道士》	名詞
＠どらごんまどうし	《ドラゴン魔道士》	名詞
＠は	《ハズダーの士官》	名詞
＠はず	《ハズダーの士官》	名詞
＠はずだ	《ハズダーの士官》	名詞
＠はずだー	《ハズダーの士官》	名詞
＠はずだーの	《ハズダーの士官》	名詞
＠はずだーのし	《ハズダーの士官》	名詞
＠はずだーのしか	《ハズダーの士官》	名詞
＠はずだーのしかん	《ハズダーの士官》	名詞
＠は	《ハードカバー》	名詞
＠はー	《ハードカバー》	名詞
＠はーど	《ハードカバー》	名詞
＠はーどか	《ハードカバー》	名詞
＠はーどかば	《ハードカバー》	名詞
＠はーどかばー	《ハードカバー》	名詞
＠び	《ビビアンのクロコダイル》	名詞
＠びび	《ビビアンのクロコダイル》	名詞
＠びびあ	《ビビアンのクロコダイル》	名詞
＠びびあん	《ビビアンのクロコダイル》	名詞
＠びびあんの	《ビビアンのクロコダイル》	名詞
＠びびあんのく	《ビビアンのクロコダイル》	名詞
＠びびあんのくろ	《ビビアンのクロコダイル》	名詞
＠びびあんのくろこ	《ビビアンのクロコダイル》	名詞
＠びびあんのくろこだ	《ビビアンのクロコダイル》	名詞
＠びびあんのくろこだい	《ビビアンのクロコダイル》	名詞
＠びびあんのくろこだいる	《ビビアンのクロコダイル》	名詞
＠ふ	《フェアリーの悪党》	名詞
＠ふぇ	《フェアリーの悪党》	名詞
＠ふぇあ	《フェアリーの悪党》	名詞
＠ふぇあり	《フェアリーの悪党》	名詞
＠ふぇありー	《フェアリーの悪党》	名詞
＠ふぇありーの	《フェアリーの悪党》	名詞
＠ふぇありーのあ	《フェアリーの悪党》	名詞
＠ふぇありーのあく	《フェアリーの悪党》	名詞
＠ふぇありーのあくと	《フェアリーの悪党》	名詞
＠ふぇありーのあくとう	《フェアリーの悪党》	名詞
＠ぷ	《プリズマイト》	名詞
＠ぷり	《プリズマイト》	名詞
＠ぷりず	《プリズマイト》	名詞
＠ぷりずま	《プリズマイト》	名詞
＠ぷりずまい	《プリズマイト》	名詞
＠ぷりずまいと	《プリズマイト》	名詞
＠ま	《マンモスグモ》	名詞
＠まん	《マンモスグモ》	名詞
＠まんも	《マンモスグモ》	名詞
＠まんもす	《マンモスグモ》	名詞
＠まんもすぐ	《マンモスグモ》	名詞
＠まんもすぐも	《マンモスグモ》	名詞
＠む	《ムラーサの胎動》	名詞
＠むら	《ムラーサの胎動》	名詞
＠むらー	《ムラーサの胎動》	名詞
＠むらーさ	《ムラーサの胎動》	名詞
＠むらーさの	《ムラーサの胎動》	名詞
＠むらーさのた	《ムラーサの胎動》	名詞
＠むらーさのたい	《ムラーサの胎動》	名詞
＠むらーさのたいど	《ムラーサの胎動》	名詞
＠むらーさのたいどう	《ムラーサの胎動》	名詞
＠む	《ムーアランドの審問官》	名詞
＠むー	《ムーアランドの審問官》	名詞
＠むーあ	《ムーアランドの審問官》	名詞
＠むーあら	《ムーアランドの審問官》	名詞
＠むーあらん	《ムーアランドの審問官》	名詞
＠むーあらんど	《ムーアランドの審問官》	名詞
＠むーあらんどの	《ムーアランドの審問官》	名詞
＠むーあらんどのし	《ムーアランドの審問官》	名詞
＠むーあらんどのしん	《ムーアランドの審問官》	名詞
＠むーあらんどのしんも	《ムーアランドの審問官》	名詞
＠むーあらんどのしんもん	《ムーアランドの審問官》	名詞
＠むーあらんどのしんもんか	《ムーアランドの審問官》	名詞
＠むーあらんどのしんもんかん	《ムーアランドの審問官》	名詞
＠や	《ヤロクの沼潜み》	名詞
＠やろ	《ヤロクの沼潜み》	名詞
＠やろく	《ヤロクの沼潜み》	名詞
＠やろくの	《ヤロクの沼潜み》	名詞
＠やろくのぬ	《ヤロクの沼潜み》	名詞
＠やろくのぬま	《ヤロクの沼潜み》	名詞
＠やろくのぬまひ	《ヤロクの沼潜み》	名詞
＠やろくのぬまひそ	《ヤロクの沼潜み》	名詞
＠やろくのぬまひそみ	《ヤロクの沼潜み》	名詞
＠や	《ヤロクの波壊し》	名詞
＠やろ	《ヤロクの波壊し》	名詞
＠やろく	《ヤロクの波壊し》	名詞
＠やろくの	《ヤロクの波壊し》	名詞
＠やろくのな	《ヤロクの波壊し》	名詞
＠やろくのなみ	《ヤロクの波壊し》	名詞
＠やろくのなみこ	《ヤロクの波壊し》	名詞
＠やろくのなみこわ	《ヤロクの波壊し》	名詞
＠やろくのなみこわし	《ヤロクの波壊し》	名詞
＠や	《ヤンリンの先触れ》	名詞
＠やん	《ヤンリンの先触れ》	名詞
＠やんり	《ヤンリンの先触れ》	名詞
＠やんりん	《ヤンリンの先触れ》	名詞
＠やんりんの	《ヤンリンの先触れ》	名詞
＠やんりんのさ	《ヤンリンの先触れ》	名詞
＠やんりんのさき	《ヤンリンの先触れ》	名詞
＠やんりんのさきぶ	《ヤンリンの先触れ》	名詞
＠やんりんのさきぶれ	《ヤンリンの先触れ》	名詞
＠ろ	《ロクソドンの生命詠み》	名詞
＠ろく	《ロクソドンの生命詠み》	名詞
＠ろくそ	《ロクソドンの生命詠み》	名詞
＠ろくそど	《ロクソドンの生命詠み》	名詞
＠ろくそどん	《ロクソドンの生命詠み》	名詞
＠ろくそどんの	《ロクソドンの生命詠み》	名詞
＠ろくそどんのせ	《ロクソドンの生命詠み》	名詞
＠ろくそどんのせい	《ロクソドンの生命詠み》	名詞
＠ろくそどんのせいめ	《ロクソドンの生命詠み》	名詞
＠ろくそどんのせいめい	《ロクソドンの生命詠み》	名詞
＠ろくそどんのせいめいよ	《ロクソドンの生命詠み》	名詞
＠ろくそどんのせいめいよみ	《ロクソドンの生命詠み》	名詞
＠ふ	《不動の哨兵》	名詞
＠ふど	《不動の哨兵》	名詞
＠ふどう	《不動の哨兵》	名詞
＠ふどうの	《不動の哨兵》	名詞
＠ふどうのし	《不動の哨兵》	名詞
＠ふどうのしょ	《不動の哨兵》	名詞
＠ふどうのしょう	《不動の哨兵》	名詞
＠ふどうのしょうへ	《不動の哨兵》	名詞
＠ふどうのしょうへい	《不動の哨兵》	名詞
＠ふ	《不屈の巡礼者、ゴロス》	名詞
＠ふく	《不屈の巡礼者、ゴロス》	名詞
＠ふくつ	《不屈の巡礼者、ゴロス》	名詞
＠ふくつの	《不屈の巡礼者、ゴロス》	名詞
＠ふくつのじ	《不屈の巡礼者、ゴロス》	名詞
＠ふくつのじゅ	《不屈の巡礼者、ゴロス》	名詞
＠ふくつのじゅん	《不屈の巡礼者、ゴロス》	名詞
＠ふくつのじゅんれ	《不屈の巡礼者、ゴロス》	名詞
＠ふくつのじゅんれい	《不屈の巡礼者、ゴロス》	名詞
＠ふくつのじゅんれいし	《不屈の巡礼者、ゴロス》	名詞
＠ふくつのじゅんれいしゃ	《不屈の巡礼者、ゴロス》	名詞
＠ふくつのじゅんれいしゃ、	《不屈の巡礼者、ゴロス》	名詞
＠ふくつのじゅんれいしゃ、ご	《不屈の巡礼者、ゴロス》	名詞
＠ふくつのじゅんれいしゃ、ごろ	《不屈の巡礼者、ゴロス》	名詞
＠ふくつのじゅんれいしゃ、ごろす	《不屈の巡礼者、ゴロス》	名詞
＠ふ	《不死のフェニックス》	名詞
＠ふし	《不死のフェニックス》	名詞
＠ふしの	《不死のフェニックス》	名詞
＠ふしのふ	《不死のフェニックス》	名詞
＠ふしのふぇ	《不死のフェニックス》	名詞
＠ふしのふぇに	《不死のフェニックス》	名詞
＠ふしのふぇにっ	《不死のフェニックス》	名詞
＠ふしのふぇにっく	《不死のフェニックス》	名詞
＠ふしのふぇにっくす	《不死のフェニックス》	名詞
＠ふ	《不浄な証約》	名詞
＠ふじ	《不浄な証約》	名詞
＠ふじょ	《不浄な証約》	名詞
＠ふじょう	《不浄な証約》	名詞
＠ふじょうな	《不浄な証約》	名詞
＠ふじょうなあ	《不浄な証約》	名詞
＠ふじょうなあか	《不浄な証約》	名詞
＠ふじょうなあかし	《不浄な証約》	名詞
＠ふじょうなあかしや	《不浄な証約》	名詞
＠ふじょうなあかしやく	《不浄な証約》	名詞
＠ま	《丸焼き》	名詞
＠まる	《丸焼き》	名詞
＠まるや	《丸焼き》	名詞
＠まるやき	《丸焼き》	名詞
＠ら	《乱動の座、オムナス》	名詞
＠らん	《乱動の座、オムナス》	名詞
＠らんど	《乱動の座、オムナス》	名詞
＠らんどう	《乱動の座、オムナス》	名詞
＠らんどうの	《乱動の座、オムナス》	名詞
＠らんどうのざ	《乱動の座、オムナス》	名詞
＠らんどうのざ、	《乱動の座、オムナス》	名詞
＠らんどうのざ、お	《乱動の座、オムナス》	名詞
＠らんどうのざ、おむ	《乱動の座、オムナス》	名詞
＠らんどうのざ、おむな	《乱動の座、オムナス》	名詞
＠らんどうのざ、おむなす	《乱動の座、オムナス》	名詞
＠よ	《予期》	名詞
＠よき	《予期》	名詞
＠よ	《予期の力線》	名詞
＠よき	《予期の力線》	名詞
＠よきの	《予期の力線》	名詞
＠よきのち	《予期の力線》	名詞
＠よきのちか	《予期の力線》	名詞
＠よきのちから	《予期の力線》	名詞
＠よきのちからせ	《予期の力線》	名詞
＠よきのちからせん	《予期の力線》	名詞
＠よ	《予言ダコ》	名詞
＠よげ	《予言ダコ》	名詞
＠よげん	《予言ダコ》	名詞
＠よげんだ	《予言ダコ》	名詞
＠よげんだこ	《予言ダコ》	名詞
＠と	《供犠の仮面》	名詞
＠とも	《供犠の仮面》	名詞
＠ともぎ	《供犠の仮面》	名詞
＠ともぎの	《供犠の仮面》	名詞
＠ともぎのか	《供犠の仮面》	名詞
＠ともぎのかめ	《供犠の仮面》	名詞
＠ともぎのかめん	《供犠の仮面》	名詞
＠ほ	《保有の鞄》	名詞
＠ほゆ	《保有の鞄》	名詞
＠ほゆう	《保有の鞄》	名詞
＠ほゆうの	《保有の鞄》	名詞
＠ほゆうのか	《保有の鞄》	名詞
＠ほゆうのかば	《保有の鞄》	名詞
＠ほゆうのかばん	《保有の鞄》	名詞
＠し	《信頼あるペガサス》	名詞
＠しん	《信頼あるペガサス》	名詞
＠しんら	《信頼あるペガサス》	名詞
＠しんらい	《信頼あるペガサス》	名詞
＠しんらいあ	《信頼あるペガサス》	名詞
＠しんらいある	《信頼あるペガサス》	名詞
＠しんらいあるぺ	《信頼あるペガサス》	名詞
＠しんらいあるぺが	《信頼あるペガサス》	名詞
＠しんらいあるぺがさ	《信頼あるペガサス》	名詞
＠しんらいあるぺがさす	《信頼あるペガサス》	名詞
＠ご	《傲慢な血王、ソリン》	名詞
＠ごう	《傲慢な血王、ソリン》	名詞
＠ごうま	《傲慢な血王、ソリン》	名詞
＠ごうまん	《傲慢な血王、ソリン》	名詞
＠ごうまんな	《傲慢な血王、ソリン》	名詞
＠ごうまんなち	《傲慢な血王、ソリン》	名詞
＠ごうまんなちお	《傲慢な血王、ソリン》	名詞
＠ごうまんなちおう	《傲慢な血王、ソリン》	名詞
＠ごうまんなちおう、	《傲慢な血王、ソリン》	名詞
＠ごうまんなちおう、そ	《傲慢な血王、ソリン》	名詞
＠ごうまんなちおう、そり	《傲慢な血王、ソリン》	名詞
＠ごうまんなちおう、そりん	《傲慢な血王、ソリン》	名詞
＠ひ	《光の篭手》	名詞
＠ひか	《光の篭手》	名詞
＠ひかり	《光の篭手》	名詞
＠ひかりの	《光の篭手》	名詞
＠ひかりのこ	《光の篭手》	名詞
＠ひかりのこて	《光の篭手》	名詞
＠び	《光り角の海賊》	名詞
＠びか	《光り角の海賊》	名詞
＠びかり	《光り角の海賊》	名詞
＠びかりか	《光り角の海賊》	名詞
＠びかりかく	《光り角の海賊》	名詞
＠びかりかくの	《光り角の海賊》	名詞
＠びかりかくのか	《光り角の海賊》	名詞
＠びかりかくのかい	《光り角の海賊》	名詞
＠びかりかくのかいぞ	《光り角の海賊》	名詞
＠びかりかくのかいぞく	《光り角の海賊》	名詞
＠す	《全てを見通す者、アテムシス》	名詞
＠すべ	《全てを見通す者、アテムシス》	名詞
＠すべて	《全てを見通す者、アテムシス》	名詞
＠すべてを	《全てを見通す者、アテムシス》	名詞
＠すべてをみ	《全てを見通す者、アテムシス》	名詞
＠すべてをみと	《全てを見通す者、アテムシス》	名詞
＠すべてをみとお	《全てを見通す者、アテムシス》	名詞
＠すべてをみとおす	《全てを見通す者、アテムシス》	名詞
＠すべてをみとおすも	《全てを見通す者、アテムシス》	名詞
＠すべてをみとおすもの	《全てを見通す者、アテムシス》	名詞
＠すべてをみとおすもの、	《全てを見通す者、アテムシス》	名詞
＠すべてをみとおすもの、あ	《全てを見通す者、アテムシス》	名詞
＠すべてをみとおすもの、あて	《全てを見通す者、アテムシス》	名詞
＠すべてをみとおすもの、あてむ	《全てを見通す者、アテムシス》	名詞
＠すべてをみとおすもの、あてむし	《全てを見通す者、アテムシス》	名詞
＠すべてをみとおすもの、あてむしす	《全てを見通す者、アテムシス》	名詞
＠へ	《兵団の隊長》	名詞
＠へい	《兵団の隊長》	名詞
＠へいだ	《兵団の隊長》	名詞
＠へいだん	《兵団の隊長》	名詞
＠へいだんの	《兵団の隊長》	名詞
＠へいだんのた	《兵団の隊長》	名詞
＠へいだんのたい	《兵団の隊長》	名詞
＠へいだんのたいち	《兵団の隊長》	名詞
＠へいだんのたいちょ	《兵団の隊長》	名詞
＠へいだんのたいちょう	《兵団の隊長》	名詞
＠さ	《再誕の天使、リエーン》	名詞
＠さい	《再誕の天使、リエーン》	名詞
＠さいた	《再誕の天使、リエーン》	名詞
＠さいたん	《再誕の天使、リエーン》	名詞
＠さいたんの	《再誕の天使、リエーン》	名詞
＠さいたんのて	《再誕の天使、リエーン》	名詞
＠さいたんのてん	《再誕の天使、リエーン》	名詞
＠さいたんのてんし	《再誕の天使、リエーン》	名詞
＠さいたんのてんし、	《再誕の天使、リエーン》	名詞
＠さいたんのてんし、り	《再誕の天使、リエーン》	名詞
＠さいたんのてんし、りえ	《再誕の天使、リエーン》	名詞
＠さいたんのてんし、りえー	《再誕の天使、リエーン》	名詞
＠さいたんのてんし、りえーん	《再誕の天使、リエーン》	名詞
＠ぼ	《冒涜されたもの、ヤロク》	名詞
＠ぼう	《冒涜されたもの、ヤロク》	名詞
＠ぼうと	《冒涜されたもの、ヤロク》	名詞
＠ぼうとく	《冒涜されたもの、ヤロク》	名詞
＠ぼうとくさ	《冒涜されたもの、ヤロク》	名詞
＠ぼうとくされ	《冒涜されたもの、ヤロク》	名詞
＠ぼうとくされた	《冒涜されたもの、ヤロク》	名詞
＠ぼうとくされたも	《冒涜されたもの、ヤロク》	名詞
＠ぼうとくされたもの	《冒涜されたもの、ヤロク》	名詞
＠ぼうとくされたもの、	《冒涜されたもの、ヤロク》	名詞
＠ぼうとくされたもの、や	《冒涜されたもの、ヤロク》	名詞
＠ぼうとくされたもの、やろ	《冒涜されたもの、ヤロク》	名詞
＠ぼうとくされたもの、やろく	《冒涜されたもの、ヤロク》	名詞
＠が	《凱旋の神殿》	名詞
＠がい	《凱旋の神殿》	名詞
＠がいせ	《凱旋の神殿》	名詞
＠がいせん	《凱旋の神殿》	名詞
＠がいせんの	《凱旋の神殿》	名詞
＠がいせんのし	《凱旋の神殿》	名詞
＠がいせんのしん	《凱旋の神殿》	名詞
＠がいせんのしんで	《凱旋の神殿》	名詞
＠がいせんのしんでん	《凱旋の神殿》	名詞
＠き	《凶暴な見張り、ガーゴス》	名詞
＠きょ	《凶暴な見張り、ガーゴス》	名詞
＠きょう	《凶暴な見張り、ガーゴス》	名詞
＠きょうぼ	《凶暴な見張り、ガーゴス》	名詞
＠きょうぼう	《凶暴な見張り、ガーゴス》	名詞
＠きょうぼうな	《凶暴な見張り、ガーゴス》	名詞
＠きょうぼうなみ	《凶暴な見張り、ガーゴス》	名詞
＠きょうぼうなみは	《凶暴な見張り、ガーゴス》	名詞
＠きょうぼうなみはり	《凶暴な見張り、ガーゴス》	名詞
＠きょうぼうなみはり、	《凶暴な見張り、ガーゴス》	名詞
＠きょうぼうなみはり、が	《凶暴な見張り、ガーゴス》	名詞
＠きょうぼうなみはり、がー	《凶暴な見張り、ガーゴス》	名詞
＠きょうぼうなみはり、がーご	《凶暴な見張り、ガーゴス》	名詞
＠きょうぼうなみはり、がーごす	《凶暴な見張り、ガーゴス》	名詞
＠き	《凶月の吸血鬼》	名詞
＠きょ	《凶月の吸血鬼》	名詞
＠きょう	《凶月の吸血鬼》	名詞
＠きょうつ	《凶月の吸血鬼》	名詞
＠きょうつき	《凶月の吸血鬼》	名詞
＠きょうつきの	《凶月の吸血鬼》	名詞
＠きょうつきのき	《凶月の吸血鬼》	名詞
＠きょうつきのきゅ	《凶月の吸血鬼》	名詞
＠きょうつきのきゅう	《凶月の吸血鬼》	名詞
＠きょうつきのきゅうけ	《凶月の吸血鬼》	名詞
＠きょうつきのきゅうけつ	《凶月の吸血鬼》	名詞
＠きょうつきのきゅうけつき	《凶月の吸血鬼》	名詞
＠ご	《剛力化》	名詞
＠ごう	《剛力化》	名詞
＠ごうり	《剛力化》	名詞
＠ごうりき	《剛力化》	名詞
＠ごうりきか	《剛力化》	名詞
＠け	《剣術の名手》	名詞
＠けん	《剣術の名手》	名詞
＠けんじ	《剣術の名手》	名詞
＠けんじゅ	《剣術の名手》	名詞
＠けんじゅつ	《剣術の名手》	名詞
＠けんじゅつの	《剣術の名手》	名詞
＠けんじゅつのめ	《剣術の名手》	名詞
＠けんじゅつのめい	《剣術の名手》	名詞
＠けんじゅつのめいし	《剣術の名手》	名詞
＠けんじゅつのめいしゅ	《剣術の名手》	名詞
＠ゆ	《勇壮の時》	名詞
＠ゆう	《勇壮の時》	名詞
＠ゆうそ	《勇壮の時》	名詞
＠ゆうそう	《勇壮の時》	名詞
＠ゆうそうの	《勇壮の時》	名詞
＠ゆうそうのと	《勇壮の時》	名詞
＠ゆうそうのとき	《勇壮の時》	名詞
＠ほ	《包囲マストドン》	名詞
＠ほう	《包囲マストドン》	名詞
＠ほうい	《包囲マストドン》	名詞
＠ほういま	《包囲マストドン》	名詞
＠ほういます	《包囲マストドン》	名詞
＠ほういますと	《包囲マストドン》	名詞
＠ほういますとど	《包囲マストドン》	名詞
＠ほういますとどん	《包囲マストドン》	名詞
＠ほ	《北方の精霊》	名詞
＠ほっ	《北方の精霊》	名詞
＠ほっぽ	《北方の精霊》	名詞
＠ほっぽう	《北方の精霊》	名詞
＠ほっぽうの	《北方の精霊》	名詞
＠ほっぽうのし	《北方の精霊》	名詞
＠ほっぽうのしょ	《北方の精霊》	名詞
＠ほっぽうのしょう	《北方の精霊》	名詞
＠ほっぽうのしょうり	《北方の精霊》	名詞
＠ほっぽうのしょうりょ	《北方の精霊》	名詞
＠ほっぽうのしょうりょう	《北方の精霊》	名詞
＠ひ	《匪賊の斧》	名詞
＠ひぞ	《匪賊の斧》	名詞
＠ひぞく	《匪賊の斧》	名詞
＠ひぞくの	《匪賊の斧》	名詞
＠ひぞくのお	《匪賊の斧》	名詞
＠ひぞくのおの	《匪賊の斧》	名詞
＠き	《協約のペガサス》	名詞
＠きょ	《協約のペガサス》	名詞
＠きょう	《協約のペガサス》	名詞
＠きょうや	《協約のペガサス》	名詞
＠きょうやく	《協約のペガサス》	名詞
＠きょうやくの	《協約のペガサス》	名詞
＠きょうやくのぺ	《協約のペガサス》	名詞
＠きょうやくのぺが	《協約のペガサス》	名詞
＠きょうやくのぺがさ	《協約のペガサス》	名詞
＠きょうやくのぺがさす	《協約のペガサス》	名詞
＠う	《占者の保管箱》	名詞
＠うら	《占者の保管箱》	名詞
＠うらな	《占者の保管箱》	名詞
＠うらない	《占者の保管箱》	名詞
＠うらないし	《占者の保管箱》	名詞
＠うらないしゃ	《占者の保管箱》	名詞
＠うらないしゃの	《占者の保管箱》	名詞
＠うらないしゃのほ	《占者の保管箱》	名詞
＠うらないしゃのほか	《占者の保管箱》	名詞
＠うらないしゃのほかん	《占者の保管箱》	名詞
＠うらないしゃのほかんば	《占者の保管箱》	名詞
＠うらないしゃのほかんばこ	《占者の保管箱》	名詞
＠そ	《双刃の聖騎士》	名詞
＠そう	《双刃の聖騎士》	名詞
＠そうじ	《双刃の聖騎士》	名詞
＠そうじん	《双刃の聖騎士》	名詞
＠そうじんの	《双刃の聖騎士》	名詞
＠そうじんのせ	《双刃の聖騎士》	名詞
＠そうじんのせい	《双刃の聖騎士》	名詞
＠そうじんのせいき	《双刃の聖騎士》	名詞
＠そうじんのせいきし	《双刃の聖騎士》	名詞
＠は	《反復する反響》	名詞
＠はん	《反復する反響》	名詞
＠はんぷ	《反復する反響》	名詞
＠はんぷく	《反復する反響》	名詞
＠はんぷくす	《反復する反響》	名詞
＠はんぷくする	《反復する反響》	名詞
＠はんぷくするは	《反復する反響》	名詞
＠はんぷくするはん	《反復する反響》	名詞
＠はんぷくするはんき	《反復する反響》	名詞
＠はんぷくするはんきょ	《反復する反響》	名詞
＠はんぷくするはんきょう	《反復する反響》	名詞
＠は	《反逆の行動》	名詞
＠はん	《反逆の行動》	名詞
＠はんぎ	《反逆の行動》	名詞
＠はんぎゃ	《反逆の行動》	名詞
＠はんぎゃく	《反逆の行動》	名詞
＠はんぎゃくの	《反逆の行動》	名詞
＠はんぎゃくのこ	《反逆の行動》	名詞
＠はんぎゃくのこう	《反逆の行動》	名詞
＠はんぎゃくのこうど	《反逆の行動》	名詞
＠はんぎゃくのこうどう	《反逆の行動》	名詞
＠な	《名高い武器職人》	名詞
＠なだ	《名高い武器職人》	名詞
＠なだか	《名高い武器職人》	名詞
＠なだかい	《名高い武器職人》	名詞
＠なだかいぶ	《名高い武器職人》	名詞
＠なだかいぶき	《名高い武器職人》	名詞
＠なだかいぶきし	《名高い武器職人》	名詞
＠なだかいぶきしょ	《名高い武器職人》	名詞
＠なだかいぶきしょく	《名高い武器職人》	名詞
＠なだかいぶきしょくに	《名高い武器職人》	名詞
＠なだかいぶきしょくにん	《名高い武器職人》	名詞
＠ほ	《吠える巨人》	名詞
＠ほえ	《吠える巨人》	名詞
＠ほえる	《吠える巨人》	名詞
＠ほえるき	《吠える巨人》	名詞
＠ほえるきょ	《吠える巨人》	名詞
＠ほえるきょじ	《吠える巨人》	名詞
＠ほえるきょじん	《吠える巨人》	名詞
＠ひ	《否認》	名詞
＠ひに	《否認》	名詞
＠ひにん	《否認》	名詞
＠き	《吸血鬼の王、ソリン》	名詞
＠きゅ	《吸血鬼の王、ソリン》	名詞
＠きゅう	《吸血鬼の王、ソリン》	名詞
＠きゅうけ	《吸血鬼の王、ソリン》	名詞
＠きゅうけつ	《吸血鬼の王、ソリン》	名詞
＠きゅうけつき	《吸血鬼の王、ソリン》	名詞
＠きゅうけつきの	《吸血鬼の王、ソリン》	名詞
＠きゅうけつきのお	《吸血鬼の王、ソリン》	名詞
＠きゅうけつきのおう	《吸血鬼の王、ソリン》	名詞
＠きゅうけつきのおう、	《吸血鬼の王、ソリン》	名詞
＠きゅうけつきのおう、そ	《吸血鬼の王、ソリン》	名詞
＠きゅうけつきのおう、そり	《吸血鬼の王、ソリン》	名詞
＠きゅうけつきのおう、そりん	《吸血鬼の王、ソリン》	名詞
＠こ	《呼応した呼集》	名詞
＠こお	《呼応した呼集》	名詞
＠こおう	《呼応した呼集》	名詞
＠こおうし	《呼応した呼集》	名詞
＠こおうした	《呼応した呼集》	名詞
＠こおうしたこ	《呼応した呼集》	名詞
＠こおうしたこし	《呼応した呼集》	名詞
＠こおうしたこしゅ	《呼応した呼集》	名詞
＠こおうしたこしゅう	《呼応した呼集》	名詞
＠か	《噛みつきドレイク》	名詞
＠かみ	《噛みつきドレイク》	名詞
＠かみつ	《噛みつきドレイク》	名詞
＠かみつき	《噛みつきドレイク》	名詞
＠かみつきど	《噛みつきドレイク》	名詞
＠かみつきどれ	《噛みつきドレイク》	名詞
＠かみつきどれい	《噛みつきドレイク》	名詞
＠かみつきどれいく	《噛みつきドレイク》	名詞
＠つ	《土覆いのシャーマン》	名詞
＠つち	《土覆いのシャーマン》	名詞
＠つちお	《土覆いのシャーマン》	名詞
＠つちおお	《土覆いのシャーマン》	名詞
＠つちおおい	《土覆いのシャーマン》	名詞
＠つちおおいの	《土覆いのシャーマン》	名詞
＠つちおおいのし	《土覆いのシャーマン》	名詞
＠つちおおいのしゃ	《土覆いのシャーマン》	名詞
＠つちおおいのしゃー	《土覆いのシャーマン》	名詞
＠つちおおいのしゃーま	《土覆いのシャーマン》	名詞
＠つちおおいのしゃーまん	《土覆いのシャーマン》	名詞
＠ち	《地下牢の霊》	名詞
＠ちか	《地下牢の霊》	名詞
＠ちかろ	《地下牢の霊》	名詞
＠ちかろう	《地下牢の霊》	名詞
＠ちかろうの	《地下牢の霊》	名詞
＠ちかろうのれ	《地下牢の霊》	名詞
＠ちかろうのれい	《地下牢の霊》	名詞
＠じ	《地盤の裂け目》	名詞
＠じば	《地盤の裂け目》	名詞
＠じばん	《地盤の裂け目》	名詞
＠じばんの	《地盤の裂け目》	名詞
＠じばんのさ	《地盤の裂け目》	名詞
＠じばんのさけ	《地盤の裂け目》	名詞
＠じばんのさけめ	《地盤の裂け目》	名詞
＠す	《垂直落下》	名詞
＠すい	《垂直落下》	名詞
＠すいち	《垂直落下》	名詞
＠すいちょ	《垂直落下》	名詞
＠すいちょく	《垂直落下》	名詞
＠すいちょくら	《垂直落下》	名詞
＠すいちょくらっ	《垂直落下》	名詞
＠すいちょくらっか	《垂直落下》	名詞
＠ほ	《報復のワンド》	名詞
＠ほう	《報復のワンド》	名詞
＠ほうふ	《報復のワンド》	名詞
＠ほうふく	《報復のワンド》	名詞
＠ほうふくの	《報復のワンド》	名詞
＠ほうふくのわ	《報復のワンド》	名詞
＠ほうふくのわん	《報復のワンド》	名詞
＠ほうふくのわんど	《報復のワンド》	名詞
＠し	《塩水生まれの殺し屋》	名詞
＠しお	《塩水生まれの殺し屋》	名詞
＠しおみ	《塩水生まれの殺し屋》	名詞
＠しおみず	《塩水生まれの殺し屋》	名詞
＠しおみずう	《塩水生まれの殺し屋》	名詞
＠しおみずうま	《塩水生まれの殺し屋》	名詞
＠しおみずうまれ	《塩水生まれの殺し屋》	名詞
＠しおみずうまれの	《塩水生まれの殺し屋》	名詞
＠しおみずうまれのこ	《塩水生まれの殺し屋》	名詞
＠しおみずうまれのころ	《塩水生まれの殺し屋》	名詞
＠しおみずうまれのころし	《塩水生まれの殺し屋》	名詞
＠しおみずうまれのころしや	《塩水生まれの殺し屋》	名詞
＠は	《墓掘りの檻》	名詞
＠はか	《墓掘りの檻》	名詞
＠はかほ	《墓掘りの檻》	名詞
＠はかほり	《墓掘りの檻》	名詞
＠はかほりの	《墓掘りの檻》	名詞
＠はかほりのお	《墓掘りの檻》	名詞
＠はかほりのおり	《墓掘りの檻》	名詞
＠は	《墓暴き》	名詞
＠はか	《墓暴き》	名詞
＠はかあ	《墓暴き》	名詞
＠はかあば	《墓暴き》	名詞
＠はかあばき	《墓暴き》	名詞
＠は	《墓起こし》	名詞
＠はか	《墓起こし》	名詞
＠はかお	《墓起こし》	名詞
＠はかおこ	《墓起こし》	名詞
＠はかおこし	《墓起こし》	名詞
＠へ	《変容するケラトプス》	名詞
＠へん	《変容するケラトプス》	名詞
＠へんよ	《変容するケラトプス》	名詞
＠へんよう	《変容するケラトプス》	名詞
＠へんようす	《変容するケラトプス》	名詞
＠へんようする	《変容するケラトプス》	名詞
＠へんようするけ	《変容するケラトプス》	名詞
＠へんようするけら	《変容するケラトプス》	名詞
＠へんようするけらと	《変容するケラトプス》	名詞
＠へんようするけらとぷ	《変容するケラトプス》	名詞
＠へんようするけらとぷす	《変容するケラトプス》	名詞
＠な	《夏の帳》	名詞
＠なつ	《夏の帳》	名詞
＠なつの	《夏の帳》	名詞
＠なつのち	《夏の帳》	名詞
＠なつのちょ	《夏の帳》	名詞
＠なつのちょう	《夏の帳》	名詞
＠た	《多欲なドラゴン》	名詞
＠たよ	《多欲なドラゴン》	名詞
＠たよく	《多欲なドラゴン》	名詞
＠たよくな	《多欲なドラゴン》	名詞
＠たよくなど	《多欲なドラゴン》	名詞
＠たよくなどら	《多欲なドラゴン》	名詞
＠たよくなどらご	《多欲なドラゴン》	名詞
＠たよくなどらごん	《多欲なドラゴン》	名詞
＠た	《多用途の鍵》	名詞
＠たよ	《多用途の鍵》	名詞
＠たよう	《多用途の鍵》	名詞
＠たようと	《多用途の鍵》	名詞
＠たようとの	《多用途の鍵》	名詞
＠たようとのか	《多用途の鍵》	名詞
＠たようとのかぎ	《多用途の鍵》	名詞
＠よ	《夜の騎兵》	名詞
＠よる	《夜の騎兵》	名詞
＠よるの	《夜の騎兵》	名詞
＠よるのき	《夜の騎兵》	名詞
＠よるのきへ	《夜の騎兵》	名詞
＠よるのきへい	《夜の騎兵》	名詞
＠よ	《夜明けの司祭》	名詞
＠よあ	《夜明けの司祭》	名詞
＠よあけ	《夜明けの司祭》	名詞
＠よあけの	《夜明けの司祭》	名詞
＠よあけのし	《夜明けの司祭》	名詞
＠よあけのしさ	《夜明けの司祭》	名詞
＠よあけのしさい	《夜明けの司祭》	名詞
＠よ	《夜明けの天使》	名詞
＠よあ	《夜明けの天使》	名詞
＠よあけ	《夜明けの天使》	名詞
＠よあけの	《夜明けの天使》	名詞
＠よあけのて	《夜明けの天使》	名詞
＠よあけのてん	《夜明けの天使》	名詞
＠よあけのてんし	《夜明けの天使》	名詞
＠よ	《夜群れの伏兵》	名詞
＠よる	《夜群れの伏兵》	名詞
＠よるむ	《夜群れの伏兵》	名詞
＠よるむれ	《夜群れの伏兵》	名詞
＠よるむれの	《夜群れの伏兵》	名詞
＠よるむれのふ	《夜群れの伏兵》	名詞
＠よるむれのふく	《夜群れの伏兵》	名詞
＠よるむれのふくへ	《夜群れの伏兵》	名詞
＠よるむれのふくへい	《夜群れの伏兵》	名詞
＠た	《大気の精霊》	名詞
＠たい	《大気の精霊》	名詞
＠たいき	《大気の精霊》	名詞
＠たいきの	《大気の精霊》	名詞
＠たいきのし	《大気の精霊》	名詞
＠たいきのしょ	《大気の精霊》	名詞
＠たいきのしょう	《大気の精霊》	名詞
＠たいきのしょうり	《大気の精霊》	名詞
＠たいきのしょうりょ	《大気の精霊》	名詞
＠たいきのしょうりょう	《大気の精霊》	名詞
＠た	《大群の力》	名詞
＠たい	《大群の力》	名詞
＠たいぐ	《大群の力》	名詞
＠たいぐん	《大群の力》	名詞
＠たいぐんの	《大群の力》	名詞
＠たいぐんのち	《大群の力》	名詞
＠たいぐんのちか	《大群の力》	名詞
＠たいぐんのちから	《大群の力》	名詞
＠だ	《大胆な盗人》	名詞
＠だい	《大胆な盗人》	名詞
＠だいた	《大胆な盗人》	名詞
＠だいたん	《大胆な盗人》	名詞
＠だいたんな	《大胆な盗人》	名詞
＠だいたんなぬ	《大胆な盗人》	名詞
＠だいたんなぬす	《大胆な盗人》	名詞
＠だいたんなぬすび	《大胆な盗人》	名詞
＠だいたんなぬすびと	《大胆な盗人》	名詞
＠だ	《大襞海蛇》	名詞
＠だい	《大襞海蛇》	名詞
＠だいひ	《大襞海蛇》	名詞
＠だいひだ	《大襞海蛇》	名詞
＠だいひだう	《大襞海蛇》	名詞
＠だいひだうみ	《大襞海蛇》	名詞
＠だいひだうみへ	《大襞海蛇》	名詞
＠だいひだうみへび	《大襞海蛇》	名詞
＠だ	《大都市のスプライト》	名詞
＠だい	《大都市のスプライト》	名詞
＠だいと	《大都市のスプライト》	名詞
＠だいとし	《大都市のスプライト》	名詞
＠だいとしの	《大都市のスプライト》	名詞
＠だいとしのす	《大都市のスプライト》	名詞
＠だいとしのすぷ	《大都市のスプライト》	名詞
＠だいとしのすぷら	《大都市のスプライト》	名詞
＠だいとしのすぷらい	《大都市のスプライト》	名詞
＠だいとしのすぷらいと	《大都市のスプライト》	名詞
＠だ	《大隊の歩兵》	名詞
＠だい	《大隊の歩兵》	名詞
＠だいた	《大隊の歩兵》	名詞
＠だいたい	《大隊の歩兵》	名詞
＠だいたいの	《大隊の歩兵》	名詞
＠だいたいのほ	《大隊の歩兵》	名詞
＠だいたいのほへ	《大隊の歩兵》	名詞
＠だいたいのほへい	《大隊の歩兵》	名詞
＠た	《大食のハイドラ》	名詞
＠たい	《大食のハイドラ》	名詞
＠たいし	《大食のハイドラ》	名詞
＠たいしょ	《大食のハイドラ》	名詞
＠たいしょく	《大食のハイドラ》	名詞
＠たいしょくの	《大食のハイドラ》	名詞
＠たいしょくのは	《大食のハイドラ》	名詞
＠たいしょくのはい	《大食のハイドラ》	名詞
＠たいしょくのはいど	《大食のハイドラ》	名詞
＠たいしょくのはいどら	《大食のハイドラ》	名詞
＠て	《天上の大鹿》	名詞
＠てん	《天上の大鹿》	名詞
＠てんじ	《天上の大鹿》	名詞
＠てんじょ	《天上の大鹿》	名詞
＠てんじょう	《天上の大鹿》	名詞
＠てんじょうの	《天上の大鹿》	名詞
＠てんじょうのお	《天上の大鹿》	名詞
＠てんじょうのおお	《天上の大鹿》	名詞
＠てんじょうのおおじ	《天上の大鹿》	名詞
＠てんじょうのおおじか	《天上の大鹿》	名詞
＠て	《天使の守護者》	名詞
＠てん	《天使の守護者》	名詞
＠てんし	《天使の守護者》	名詞
＠てんしの	《天使の守護者》	名詞
＠てんしのし	《天使の守護者》	名詞
＠てんしのしゅ	《天使の守護者》	名詞
＠てんしのしゅご	《天使の守護者》	名詞
＠てんしのしゅごし	《天使の守護者》	名詞
＠てんしのしゅごしゃ	《天使の守護者》	名詞
＠て	《天使の贈り物》	名詞
＠てん	《天使の贈り物》	名詞
＠てんし	《天使の贈り物》	名詞
＠てんしの	《天使の贈り物》	名詞
＠てんしのお	《天使の贈り物》	名詞
＠てんしのおく	《天使の贈り物》	名詞
＠てんしのおくり	《天使の贈り物》	名詞
＠てんしのおくりも	《天使の贈り物》	名詞
＠てんしのおくりもの	《天使の贈り物》	名詞
＠て	《天啓の神殿》	名詞
＠てん	《天啓の神殿》	名詞
＠てんけ	《天啓の神殿》	名詞
＠てんけい	《天啓の神殿》	名詞
＠てんけいの	《天啓の神殿》	名詞
＠てんけいのし	《天啓の神殿》	名詞
＠てんけいのしん	《天啓の神殿》	名詞
＠てんけいのしんで	《天啓の神殿》	名詞
＠てんけいのしんでん	《天啓の神殿》	名詞
＠て	《天界の伝書使》	名詞
＠てん	《天界の伝書使》	名詞
＠てんか	《天界の伝書使》	名詞
＠てんかい	《天界の伝書使》	名詞
＠てんかいの	《天界の伝書使》	名詞
＠てんかいので	《天界の伝書使》	名詞
＠てんかいのでん	《天界の伝書使》	名詞
＠てんかいのでんし	《天界の伝書使》	名詞
＠てんかいのでんしょ	《天界の伝書使》	名詞
＠てんかいのでんしょづ	《天界の伝書使》	名詞
＠てんかいのでんしょづか	《天界の伝書使》	名詞
＠てんかいのでんしょづかい	《天界の伝書使》	名詞
＠て	《天界の風、ムー・ヤンリン》	名詞
＠てん	《天界の風、ムー・ヤンリン》	名詞
＠てんか	《天界の風、ムー・ヤンリン》	名詞
＠てんかい	《天界の風、ムー・ヤンリン》	名詞
＠てんかいの	《天界の風、ムー・ヤンリン》	名詞
＠てんかいのか	《天界の風、ムー・ヤンリン》	名詞
＠てんかいのかぜ	《天界の風、ムー・ヤンリン》	名詞
＠てんかいのかぜ、	《天界の風、ムー・ヤンリン》	名詞
＠てんかいのかぜ、む	《天界の風、ムー・ヤンリン》	名詞
＠てんかいのかぜ、むー	《天界の風、ムー・ヤンリン》	名詞
＠てんかいのかぜ、むー・	《天界の風、ムー・ヤンリン》	名詞
＠てんかいのかぜ、むー・や	《天界の風、ムー・ヤンリン》	名詞
＠てんかいのかぜ、むー・やん	《天界の風、ムー・ヤンリン》	名詞
＠てんかいのかぜ、むー・やんり	《天界の風、ムー・ヤンリン》	名詞
＠てんかいのかぜ、むー・やんりん	《天界の風、ムー・ヤンリン》	名詞
＠て	《天穹の鷲》	名詞
＠てん	《天穹の鷲》	名詞
＠てんき	《天穹の鷲》	名詞
＠てんきゅ	《天穹の鷲》	名詞
＠てんきゅう	《天穹の鷲》	名詞
＠てんきゅうの	《天穹の鷲》	名詞
＠てんきゅうのわ	《天穹の鷲》	名詞
＠てんきゅうのわし	《天穹の鷲》	名詞
＠て	《天空の刃、セファラ》	名詞
＠てん	《天空の刃、セファラ》	名詞
＠てんく	《天空の刃、セファラ》	名詞
＠てんくう	《天空の刃、セファラ》	名詞
＠てんくうの	《天空の刃、セファラ》	名詞
＠てんくうのは	《天空の刃、セファラ》	名詞
＠てんくうのは、	《天空の刃、セファラ》	名詞
＠てんくうのは、せ	《天空の刃、セファラ》	名詞
＠てんくうのは、せふ	《天空の刃、セファラ》	名詞
＠てんくうのは、せふぁ	《天空の刃、セファラ》	名詞
＠てんくうのは、せふぁら	《天空の刃、セファラ》	名詞
＠て	《天頂の探求者、カーリア》	名詞
＠てん	《天頂の探求者、カーリア》	名詞
＠てんち	《天頂の探求者、カーリア》	名詞
＠てんちょ	《天頂の探求者、カーリア》	名詞
＠てんちょう	《天頂の探求者、カーリア》	名詞
＠てんちょうの	《天頂の探求者、カーリア》	名詞
＠てんちょうのた	《天頂の探求者、カーリア》	名詞
＠てんちょうのたん	《天頂の探求者、カーリア》	名詞
＠てんちょうのたんき	《天頂の探求者、カーリア》	名詞
＠てんちょうのたんきゅ	《天頂の探求者、カーリア》	名詞
＠てんちょうのたんきゅう	《天頂の探求者、カーリア》	名詞
＠てんちょうのたんきゅうし	《天頂の探求者、カーリア》	名詞
＠てんちょうのたんきゅうしゃ	《天頂の探求者、カーリア》	名詞
＠てんちょうのたんきゅうしゃ、	《天頂の探求者、カーリア》	名詞
＠てんちょうのたんきゅうしゃ、か	《天頂の探求者、カーリア》	名詞
＠てんちょうのたんきゅうしゃ、かー	《天頂の探求者、カーリア》	名詞
＠てんちょうのたんきゅうしゃ、かーり	《天頂の探求者、カーリア》	名詞
＠てんちょうのたんきゅうしゃ、かーりあ	《天頂の探求者、カーリア》	名詞
＠た	《太陽の伝令》	名詞
＠たい	《太陽の伝令》	名詞
＠たいよ	《太陽の伝令》	名詞
＠たいよう	《太陽の伝令》	名詞
＠たいようの	《太陽の伝令》	名詞
＠たいようので	《太陽の伝令》	名詞
＠たいようのでん	《太陽の伝令》	名詞
＠たいようのでんれ	《太陽の伝令》	名詞
＠たいようのでんれい	《太陽の伝令》	名詞
＠が	《害悪な掌握》	名詞
＠がい	《害悪な掌握》	名詞
＠がいあ	《害悪な掌握》	名詞
＠がいあく	《害悪な掌握》	名詞
＠がいあくな	《害悪な掌握》	名詞
＠がいあくなし	《害悪な掌握》	名詞
＠がいあくなしょ	《害悪な掌握》	名詞
＠がいあくなしょう	《害悪な掌握》	名詞
＠がいあくなしょうあ	《害悪な掌握》	名詞
＠がいあくなしょうあく	《害悪な掌握》	名詞
＠た	《対称な対応》	名詞
＠たい	《対称な対応》	名詞
＠たいし	《対称な対応》	名詞
＠たいしょ	《対称な対応》	名詞
＠たいしょう	《対称な対応》	名詞
＠たいしょうな	《対称な対応》	名詞
＠たいしょうなた	《対称な対応》	名詞
＠たいしょうなたい	《対称な対応》	名詞
＠たいしょうなたいお	《対称な対応》	名詞
＠たいしょうなたいおう	《対称な対応》	名詞
＠と	《尊き一角獣》	名詞
＠とう	《尊き一角獣》	名詞
＠とうと	《尊き一角獣》	名詞
＠とうとき	《尊き一角獣》	名詞
＠とうときい	《尊き一角獣》	名詞
＠とうときいっ	《尊き一角獣》	名詞
＠とうときいっか	《尊き一角獣》	名詞
＠とうときいっかく	《尊き一角獣》	名詞
＠とうときいっかくじ	《尊き一角獣》	名詞
＠とうときいっかくじゅ	《尊き一角獣》	名詞
＠とうときいっかくじゅう	《尊き一角獣》	名詞
＠こ	《小走り犬》	名詞
＠こば	《小走り犬》	名詞
＠こばし	《小走り犬》	名詞
＠こばしり	《小走り犬》	名詞
＠こばしりい	《小走り犬》	名詞
＠こばしりいぬ	《小走り犬》	名詞
＠や	《山》	名詞
＠やま	《山》	名詞
＠い	《岩だらけの高地》	名詞
＠いわ	《岩だらけの高地》	名詞
＠いわだ	《岩だらけの高地》	名詞
＠いわだら	《岩だらけの高地》	名詞
＠いわだらけ	《岩だらけの高地》	名詞
＠いわだらけの	《岩だらけの高地》	名詞
＠いわだらけのこ	《岩だらけの高地》	名詞
＠いわだらけのこう	《岩だらけの高地》	名詞
＠いわだらけのこうち	《岩だらけの高地》	名詞
＠じ	《島》	名詞
＠じま	《島》	名詞
＠き	《巨像の鎚》	名詞
＠きょ	《巨像の鎚》	名詞
＠きょぞ	《巨像の鎚》	名詞
＠きょぞう	《巨像の鎚》	名詞
＠きょぞうの	《巨像の鎚》	名詞
＠きょぞうのつ	《巨像の鎚》	名詞
＠きょぞうのつち	《巨像の鎚》	名詞
＠ま	《巻き込み》	名詞
＠まき	《巻き込み》	名詞
＠まきこ	《巻き込み》	名詞
＠まきこみ	《巻き込み》	名詞
＠て	《帝国の先導》	名詞
＠てい	《帝国の先導》	名詞
＠ていこ	《帝国の先導》	名詞
＠ていこく	《帝国の先導》	名詞
＠ていこくの	《帝国の先導》	名詞
＠ていこくのせ	《帝国の先導》	名詞
＠ていこくのせん	《帝国の先導》	名詞
＠ていこくのせんど	《帝国の先導》	名詞
＠ていこくのせんどう	《帝国の先導》	名詞
＠き	《帰寂からの帰還》	名詞
＠きじ	《帰寂からの帰還》	名詞
＠きじゃ	《帰寂からの帰還》	名詞
＠きじゃく	《帰寂からの帰還》	名詞
＠きじゃくか	《帰寂からの帰還》	名詞
＠きじゃくから	《帰寂からの帰還》	名詞
＠きじゃくからの	《帰寂からの帰還》	名詞
＠きじゃくからのき	《帰寂からの帰還》	名詞
＠きじゃくからのきか	《帰寂からの帰還》	名詞
＠きじゃくからのきかん	《帰寂からの帰還》	名詞
＠へ	《平和な心》	名詞
＠へい	《平和な心》	名詞
＠へいわ	《平和な心》	名詞
＠へいわな	《平和な心》	名詞
＠へいわなこ	《平和な心》	名詞
＠へいわなここ	《平和な心》	名詞
＠へいわなこころ	《平和な心》	名詞
＠へ	《平地》	名詞
＠へい	《平地》	名詞
＠へいち	《平地》	名詞
＠へ	《平穏な入り江》	名詞
＠へい	《平穏な入り江》	名詞
＠へいお	《平穏な入り江》	名詞
＠へいおん	《平穏な入り江》	名詞
＠へいおんな	《平穏な入り江》	名詞
＠へいおんない	《平穏な入り江》	名詞
＠へいおんないり	《平穏な入り江》	名詞
＠へいおんないりえ	《平穏な入り江》	名詞
＠げ	《幻影の戦士》	名詞
＠げん	《幻影の戦士》	名詞
＠げんえ	《幻影の戦士》	名詞
＠げんえい	《幻影の戦士》	名詞
＠げんえいの	《幻影の戦士》	名詞
＠げんえいのせ	《幻影の戦士》	名詞
＠げんえいのせん	《幻影の戦士》	名詞
＠げんえいのせんし	《幻影の戦士》	名詞
＠ゆ	《幽体の船乗り》	名詞
＠ゆう	《幽体の船乗り》	名詞
＠ゆうた	《幽体の船乗り》	名詞
＠ゆうたい	《幽体の船乗り》	名詞
＠ゆうたいの	《幽体の船乗り》	名詞
＠ゆうたいのふ	《幽体の船乗り》	名詞
＠ゆうたいのふな	《幽体の船乗り》	名詞
＠ゆうたいのふなの	《幽体の船乗り》	名詞
＠ゆうたいのふなのり	《幽体の船乗り》	名詞
＠ひ	《庇護のグリフィン》	名詞
＠ひご	《庇護のグリフィン》	名詞
＠ひごの	《庇護のグリフィン》	名詞
＠ひごのぐ	《庇護のグリフィン》	名詞
＠ひごのぐり	《庇護のグリフィン》	名詞
＠ひごのぐりふ	《庇護のグリフィン》	名詞
＠ひごのぐりふぃ	《庇護のグリフィン》	名詞
＠ひごのぐりふぃん	《庇護のグリフィン》	名詞
＠は	《張り出し櫓のコウモリ》	名詞
＠はり	《張り出し櫓のコウモリ》	名詞
＠はりだ	《張り出し櫓のコウモリ》	名詞
＠はりだし	《張り出し櫓のコウモリ》	名詞
＠はりだしや	《張り出し櫓のコウモリ》	名詞
＠はりだしやぐ	《張り出し櫓のコウモリ》	名詞
＠はりだしやぐら	《張り出し櫓のコウモリ》	名詞
＠はりだしやぐらの	《張り出し櫓のコウモリ》	名詞
＠はりだしやぐらのこ	《張り出し櫓のコウモリ》	名詞
＠はりだしやぐらのこう	《張り出し櫓のコウモリ》	名詞
＠はりだしやぐらのこうも	《張り出し櫓のコウモリ》	名詞
＠はりだしやぐらのこうもり	《張り出し櫓のコウモリ》	名詞
＠き	《強迫》	名詞
＠きょ	《強迫》	名詞
＠きょう	《強迫》	名詞
＠きょうは	《強迫》	名詞
＠きょうはく	《強迫》	名詞
＠ふ	《復讐に燃えた戦長》	名詞
＠ふく	《復讐に燃えた戦長》	名詞
＠ふくし	《復讐に燃えた戦長》	名詞
＠ふくしゅ	《復讐に燃えた戦長》	名詞
＠ふくしゅう	《復讐に燃えた戦長》	名詞
＠ふくしゅうに	《復讐に燃えた戦長》	名詞
＠ふくしゅうにも	《復讐に燃えた戦長》	名詞
＠ふくしゅうにもえ	《復讐に燃えた戦長》	名詞
＠ふくしゅうにもえた	《復讐に燃えた戦長》	名詞
＠ふくしゅうにもえたい	《復讐に燃えた戦長》	名詞
＠ふくしゅうにもえたいく	《復讐に燃えた戦長》	名詞
＠ふくしゅうにもえたいくさ	《復讐に燃えた戦長》	名詞
＠ふくしゅうにもえたいくさち	《復讐に燃えた戦長》	名詞
＠ふくしゅうにもえたいくさちょ	《復讐に燃えた戦長》	名詞
＠ふくしゅうにもえたいくさちょう	《復讐に燃えた戦長》	名詞
＠し	《心臓貫きの弓》	名詞
＠しん	《心臓貫きの弓》	名詞
＠しんぞ	《心臓貫きの弓》	名詞
＠しんぞう	《心臓貫きの弓》	名詞
＠しんぞうつ	《心臓貫きの弓》	名詞
＠しんぞうつら	《心臓貫きの弓》	名詞
＠しんぞうつらぬ	《心臓貫きの弓》	名詞
＠しんぞうつらぬき	《心臓貫きの弓》	名詞
＠しんぞうつらぬきの	《心臓貫きの弓》	名詞
＠しんぞうつらぬきのゆ	《心臓貫きの弓》	名詞
＠しんぞうつらぬきのゆみ	《心臓貫きの弓》	名詞
＠ち	《忠実なペガサス》	名詞
＠ちゅ	《忠実なペガサス》	名詞
＠ちゅう	《忠実なペガサス》	名詞
＠ちゅうじ	《忠実なペガサス》	名詞
＠ちゅうじつ	《忠実なペガサス》	名詞
＠ちゅうじつな	《忠実なペガサス》	名詞
＠ちゅうじつなぺ	《忠実なペガサス》	名詞
＠ちゅうじつなぺが	《忠実なペガサス》	名詞
＠ちゅうじつなぺがさ	《忠実なペガサス》	名詞
＠ちゅうじつなぺがさす	《忠実なペガサス》	名詞
＠し	《思考のひずみ》	名詞
＠しこ	《思考のひずみ》	名詞
＠しこう	《思考のひずみ》	名詞
＠しこうの	《思考のひずみ》	名詞
＠しこうのひ	《思考のひずみ》	名詞
＠しこうのひず	《思考のひずみ》	名詞
＠しこうのひずみ	《思考のひずみ》	名詞
＠き	《急報》	名詞
＠きゅ	《急報》	名詞
＠きゅう	《急報》	名詞
＠きゅうほ	《急報》	名詞
＠きゅうほう	《急報》	名詞
＠き	《急流の崖》	名詞
＠きゅ	《急流の崖》	名詞
＠きゅう	《急流の崖》	名詞
＠きゅうり	《急流の崖》	名詞
＠きゅうりゅ	《急流の崖》	名詞
＠きゅうりゅう	《急流の崖》	名詞
＠きゅうりゅうの	《急流の崖》	名詞
＠きゅうりゅうのが	《急流の崖》	名詞
＠きゅうりゅうのがけ	《急流の崖》	名詞
＠お	《恐れなき矛槍兵》	名詞
＠おそ	《恐れなき矛槍兵》	名詞
＠おそれ	《恐れなき矛槍兵》	名詞
＠おそれな	《恐れなき矛槍兵》	名詞
＠おそれなき	《恐れなき矛槍兵》	名詞
＠おそれなきほ	《恐れなき矛槍兵》	名詞
＠おそれなきほこ	《恐れなき矛槍兵》	名詞
＠おそれなきほこや	《恐れなき矛槍兵》	名詞
＠おそれなきほこやり	《恐れなき矛槍兵》	名詞
＠おそれなきほこやりへ	《恐れなき矛槍兵》	名詞
＠おそれなきほこやりへい	《恐れなき矛槍兵》	名詞
＠じ	《情熱的な扇動者》	名詞
＠じょ	《情熱的な扇動者》	名詞
＠じょう	《情熱的な扇動者》	名詞
＠じょうね	《情熱的な扇動者》	名詞
＠じょうねつ	《情熱的な扇動者》	名詞
＠じょうねつて	《情熱的な扇動者》	名詞
＠じょうねつてき	《情熱的な扇動者》	名詞
＠じょうねつてきな	《情熱的な扇動者》	名詞
＠じょうねつてきなせ	《情熱的な扇動者》	名詞
＠じょうねつてきなせん	《情熱的な扇動者》	名詞
＠じょうねつてきなせんど	《情熱的な扇動者》	名詞
＠じょうねつてきなせんどう	《情熱的な扇動者》	名詞
＠じょうねつてきなせんどうし	《情熱的な扇動者》	名詞
＠じょうねつてきなせんどうしゃ	《情熱的な扇動者》	名詞
＠せ	《成長の季節》	名詞
＠せい	《成長の季節》	名詞
＠せいち	《成長の季節》	名詞
＠せいちょ	《成長の季節》	名詞
＠せいちょう	《成長の季節》	名詞
＠せいちょうの	《成長の季節》	名詞
＠せいちょうのき	《成長の季節》	名詞
＠せいちょうのきせ	《成長の季節》	名詞
＠せいちょうのきせつ	《成長の季節》	名詞
＠せ	《成長周期》	名詞
＠せい	《成長周期》	名詞
＠せいち	《成長周期》	名詞
＠せいちょ	《成長周期》	名詞
＠せいちょう	《成長周期》	名詞
＠せいちょうし	《成長周期》	名詞
＠せいちょうしゅ	《成長周期》	名詞
＠せいちょうしゅう	《成長周期》	名詞
＠せいちょうしゅうき	《成長周期》	名詞
＠せ	《戦慄の存在》	名詞
＠せん	《戦慄の存在》	名詞
＠せんり	《戦慄の存在》	名詞
＠せんりつ	《戦慄の存在》	名詞
＠せんりつの	《戦慄の存在》	名詞
＠せんりつのそ	《戦慄の存在》	名詞
＠せんりつのそん	《戦慄の存在》	名詞
＠せんりつのそんざ	《戦慄の存在》	名詞
＠せんりつのそんざい	《戦慄の存在》	名詞
＠て	《手慣れた複製》	名詞
＠てな	《手慣れた複製》	名詞
＠てなれ	《手慣れた複製》	名詞
＠てなれた	《手慣れた複製》	名詞
＠てなれたふ	《手慣れた複製》	名詞
＠てなれたふく	《手慣れた複製》	名詞
＠てなれたふくせ	《手慣れた複製》	名詞
＠てなれたふくせい	《手慣れた複製》	名詞
＠う	《打ち壊すブロントドン》	名詞
＠うち	《打ち壊すブロントドン》	名詞
＠うちこ	《打ち壊すブロントドン》	名詞
＠うちこわ	《打ち壊すブロントドン》	名詞
＠うちこわす	《打ち壊すブロントドン》	名詞
＠うちこわすぶ	《打ち壊すブロントドン》	名詞
＠うちこわすぶろ	《打ち壊すブロントドン》	名詞
＠うちこわすぶろん	《打ち壊すブロントドン》	名詞
＠うちこわすぶろんと	《打ち壊すブロントドン》	名詞
＠うちこわすぶろんとど	《打ち壊すブロントドン》	名詞
＠うちこわすぶろんとどん	《打ち壊すブロントドン》	名詞
＠ち	《抽象からの抽出》	名詞
＠ちゅ	《抽象からの抽出》	名詞
＠ちゅう	《抽象からの抽出》	名詞
＠ちゅうし	《抽象からの抽出》	名詞
＠ちゅうしょ	《抽象からの抽出》	名詞
＠ちゅうしょう	《抽象からの抽出》	名詞
＠ちゅうしょうか	《抽象からの抽出》	名詞
＠ちゅうしょうから	《抽象からの抽出》	名詞
＠ちゅうしょうからの	《抽象からの抽出》	名詞
＠ちゅうしょうからのち	《抽象からの抽出》	名詞
＠ちゅうしょうからのちゅ	《抽象からの抽出》	名詞
＠ちゅうしょうからのちゅう	《抽象からの抽出》	名詞
＠ちゅうしょうからのちゅうし	《抽象からの抽出》	名詞
＠ちゅうしょうからのちゅうしゅ	《抽象からの抽出》	名詞
＠ちゅうしょうからのちゅうしゅつ	《抽象からの抽出》	名詞
＠ほ	《捕獲する渦》	名詞
＠ほか	《捕獲する渦》	名詞
＠ほかく	《捕獲する渦》	名詞
＠ほかくす	《捕獲する渦》	名詞
＠ほかくする	《捕獲する渦》	名詞
＠ほかくするう	《捕獲する渦》	名詞
＠ほかくするうず	《捕獲する渦》	名詞
＠こ	《攻撃的なマンモス》	名詞
＠こう	《攻撃的なマンモス》	名詞
＠こうげ	《攻撃的なマンモス》	名詞
＠こうげき	《攻撃的なマンモス》	名詞
＠こうげきて	《攻撃的なマンモス》	名詞
＠こうげきてき	《攻撃的なマンモス》	名詞
＠こうげきてきな	《攻撃的なマンモス》	名詞
＠こうげきてきなま	《攻撃的なマンモス》	名詞
＠こうげきてきなまん	《攻撃的なマンモス》	名詞
＠こうげきてきなまんも	《攻撃的なマンモス》	名詞
＠こうげきてきなまんもす	《攻撃的なマンモス》	名詞
＠は	《放たれた怒り》	名詞
＠はな	《放たれた怒り》	名詞
＠はなた	《放たれた怒り》	名詞
＠はなたれ	《放たれた怒り》	名詞
＠はなたれた	《放たれた怒り》	名詞
＠はなたれたい	《放たれた怒り》	名詞
＠はなたれたいか	《放たれた怒り》	名詞
＠はなたれたいかり	《放たれた怒り》	名詞
＠び	《敏捷な鳥突き》	名詞
＠びん	《敏捷な鳥突き》	名詞
＠びんし	《敏捷な鳥突き》	名詞
＠びんしょ	《敏捷な鳥突き》	名詞
＠びんしょう	《敏捷な鳥突き》	名詞
＠びんしょうな	《敏捷な鳥突き》	名詞
＠びんしょうなと	《敏捷な鳥突き》	名詞
＠びんしょうなとり	《敏捷な鳥突き》	名詞
＠びんしょうなとりつ	《敏捷な鳥突き》	名詞
＠びんしょうなとりつき	《敏捷な鳥突き》	名詞
＠け	《敬虔な命令》	名詞
＠けい	《敬虔な命令》	名詞
＠けいけ	《敬虔な命令》	名詞
＠けいけん	《敬虔な命令》	名詞
＠けいけんな	《敬虔な命令》	名詞
＠けいけんなめ	《敬虔な命令》	名詞
＠けいけんなめい	《敬虔な命令》	名詞
＠けいけんなめいれ	《敬虔な命令》	名詞
＠けいけんなめいれい	《敬虔な命令》	名詞
＠て	《敵意あるミノタウルス》	名詞
＠てき	《敵意あるミノタウルス》	名詞
＠てきい	《敵意あるミノタウルス》	名詞
＠てきいあ	《敵意あるミノタウルス》	名詞
＠てきいある	《敵意あるミノタウルス》	名詞
＠てきいあるみ	《敵意あるミノタウルス》	名詞
＠てきいあるみの	《敵意あるミノタウルス》	名詞
＠てきいあるみのた	《敵意あるミノタウルス》	名詞
＠てきいあるみのたう	《敵意あるミノタウルス》	名詞
＠てきいあるみのたうる	《敵意あるミノタウルス》	名詞
＠てきいあるみのたうるす	《敵意あるミノタウルス》	名詞
＠し	《新米紅蓮術師、チャンドラ》	名詞
＠しん	《新米紅蓮術師、チャンドラ》	名詞
＠しんま	《新米紅蓮術師、チャンドラ》	名詞
＠しんまい	《新米紅蓮術師、チャンドラ》	名詞
＠しんまいぐ	《新米紅蓮術師、チャンドラ》	名詞
＠しんまいぐれ	《新米紅蓮術師、チャンドラ》	名詞
＠しんまいぐれん	《新米紅蓮術師、チャンドラ》	名詞
＠しんまいぐれんじ	《新米紅蓮術師、チャンドラ》	名詞
＠しんまいぐれんじゅ	《新米紅蓮術師、チャンドラ》	名詞
＠しんまいぐれんじゅつ	《新米紅蓮術師、チャンドラ》	名詞
＠しんまいぐれんじゅつし	《新米紅蓮術師、チャンドラ》	名詞
＠しんまいぐれんじゅつし、	《新米紅蓮術師、チャンドラ》	名詞
＠しんまいぐれんじゅつし、ち	《新米紅蓮術師、チャンドラ》	名詞
＠しんまいぐれんじゅつし、ちゃ	《新米紅蓮術師、チャンドラ》	名詞
＠しんまいぐれんじゅつし、ちゃん	《新米紅蓮術師、チャンドラ》	名詞
＠しんまいぐれんじゅつし、ちゃんど	《新米紅蓮術師、チャンドラ》	名詞
＠しんまいぐれんじゅつし、ちゃんどら	《新米紅蓮術師、チャンドラ》	名詞
＠ひ	《日和見吸血鬼》	名詞
＠ひよ	《日和見吸血鬼》	名詞
＠ひより	《日和見吸血鬼》	名詞
＠ひよりみ	《日和見吸血鬼》	名詞
＠ひよりみき	《日和見吸血鬼》	名詞
＠ひよりみきゅ	《日和見吸血鬼》	名詞
＠ひよりみきゅう	《日和見吸血鬼》	名詞
＠ひよりみきゅうけ	《日和見吸血鬼》	名詞
＠ひよりみきゅうけつ	《日和見吸血鬼》	名詞
＠ひよりみきゅうけつき	《日和見吸血鬼》	名詞
＠ほ	《星原の神秘家》	名詞
＠ほし	《星原の神秘家》	名詞
＠ほしは	《星原の神秘家》	名詞
＠ほしはら	《星原の神秘家》	名詞
＠ほしはらの	《星原の神秘家》	名詞
＠ほしはらのし	《星原の神秘家》	名詞
＠ほしはらのしん	《星原の神秘家》	名詞
＠ほしはらのしんぴ	《星原の神秘家》	名詞
＠ほしはらのしんぴか	《星原の神秘家》	名詞
＠せ	《星霜の学者》	名詞
＠せい	《星霜の学者》	名詞
＠せいそ	《星霜の学者》	名詞
＠せいそう	《星霜の学者》	名詞
＠せいそうの	《星霜の学者》	名詞
＠せいそうのが	《星霜の学者》	名詞
＠せいそうのがく	《星霜の学者》	名詞
＠せいそうのがくし	《星霜の学者》	名詞
＠せいそうのがくしゃ	《星霜の学者》	名詞
＠あ	《暁の騎兵》	名詞
＠あか	《暁の騎兵》	名詞
＠あかつ	《暁の騎兵》	名詞
＠あかつき	《暁の騎兵》	名詞
＠あかつきの	《暁の騎兵》	名詞
＠あかつきのき	《暁の騎兵》	名詞
＠あかつきのきへ	《暁の騎兵》	名詞
＠あかつきのきへい	《暁の騎兵》	名詞
＠く	《朽ちゆくレギサウルス》	名詞
＠くち	《朽ちゆくレギサウルス》	名詞
＠くちゆ	《朽ちゆくレギサウルス》	名詞
＠くちゆく	《朽ちゆくレギサウルス》	名詞
＠くちゆくれ	《朽ちゆくレギサウルス》	名詞
＠くちゆくれぎ	《朽ちゆくレギサウルス》	名詞
＠くちゆくれぎさ	《朽ちゆくレギサウルス》	名詞
＠くちゆくれぎさう	《朽ちゆくレギサウルス》	名詞
＠くちゆくれぎさうる	《朽ちゆくレギサウルス》	名詞
＠くちゆくれぎさうるす	《朽ちゆくレギサウルス》	名詞
＠り	《林間の癒し手》	名詞
＠りん	《林間の癒し手》	名詞
＠りんか	《林間の癒し手》	名詞
＠りんかん	《林間の癒し手》	名詞
＠りんかんの	《林間の癒し手》	名詞
＠りんかんのい	《林間の癒し手》	名詞
＠りんかんのいや	《林間の癒し手》	名詞
＠りんかんのいやし	《林間の癒し手》	名詞
＠りんかんのいやして	《林間の癒し手》	名詞
＠え	《枝葉族のドルイド》	名詞
＠えだ	《枝葉族のドルイド》	名詞
＠えだは	《枝葉族のドルイド》	名詞
＠えだはぞ	《枝葉族のドルイド》	名詞
＠えだはぞく	《枝葉族のドルイド》	名詞
＠えだはぞくの	《枝葉族のドルイド》	名詞
＠えだはぞくのど	《枝葉族のドルイド》	名詞
＠えだはぞくのどる	《枝葉族のドルイド》	名詞
＠えだはぞくのどるい	《枝葉族のドルイド》	名詞
＠えだはぞくのどるいど	《枝葉族のドルイド》	名詞
＠こ	《梢の蜘蛛》	名詞
＠こず	《梢の蜘蛛》	名詞
＠こずえ	《梢の蜘蛛》	名詞
＠こずえの	《梢の蜘蛛》	名詞
＠こずえのく	《梢の蜘蛛》	名詞
＠こずえのくも	《梢の蜘蛛》	名詞
＠も	《森》	名詞
＠もり	《森》	名詞
＠し	《森林の勇者》	名詞
＠しん	《森林の勇者》	名詞
＠しんり	《森林の勇者》	名詞
＠しんりん	《森林の勇者》	名詞
＠しんりんの	《森林の勇者》	名詞
＠しんりんのゆ	《森林の勇者》	名詞
＠しんりんのゆう	《森林の勇者》	名詞
＠しんりんのゆうし	《森林の勇者》	名詞
＠しんりんのゆうしゃ	《森林の勇者》	名詞
＠し	《森林の神秘家》	名詞
＠しん	《森林の神秘家》	名詞
＠しんり	《森林の神秘家》	名詞
＠しんりん	《森林の神秘家》	名詞
＠しんりんの	《森林の神秘家》	名詞
＠しんりんのし	《森林の神秘家》	名詞
＠しんりんのしん	《森林の神秘家》	名詞
＠しんりんのしんぴ	《森林の神秘家》	名詞
＠しんりんのしんぴか	《森林の神秘家》	名詞
＠ら	《楽園の贈り物》	名詞
＠らく	《楽園の贈り物》	名詞
＠らくえ	《楽園の贈り物》	名詞
＠らくえん	《楽園の贈り物》	名詞
＠らくえんの	《楽園の贈り物》	名詞
＠らくえんのお	《楽園の贈り物》	名詞
＠らくえんのおく	《楽園の贈り物》	名詞
＠らくえんのおくり	《楽園の贈り物》	名詞
＠らくえんのおくりも	《楽園の贈り物》	名詞
＠らくえんのおくりもの	《楽園の贈り物》	名詞
＠か	《樫変化》	名詞
＠かし	《樫変化》	名詞
＠かしへ	《樫変化》	名詞
＠かしへん	《樫変化》	名詞
＠かしへんか	《樫変化》	名詞
＠じ	《樹皮革のトロール》	名詞
＠じゅ	《樹皮革のトロール》	名詞
＠じゅひ	《樹皮革のトロール》	名詞
＠じゅひが	《樹皮革のトロール》	名詞
＠じゅひがわ	《樹皮革のトロール》	名詞
＠じゅひがわの	《樹皮革のトロール》	名詞
＠じゅひがわのと	《樹皮革のトロール》	名詞
＠じゅひがわのとろ	《樹皮革のトロール》	名詞
＠じゅひがわのとろー	《樹皮革のトロール》	名詞
＠じゅひがわのとろーる	《樹皮革のトロール》	名詞
＠じ	《次元の浄化》	名詞
＠じげ	《次元の浄化》	名詞
＠じげん	《次元の浄化》	名詞
＠じげんの	《次元の浄化》	名詞
＠じげんのじ	《次元の浄化》	名詞
＠じげんのじょ	《次元の浄化》	名詞
＠じげんのじょう	《次元の浄化》	名詞
＠じげんのじょうか	《次元の浄化》	名詞
＠ぶ	《武勇の誇示》	名詞
＠ぶゆ	《武勇の誇示》	名詞
＠ぶゆう	《武勇の誇示》	名詞
＠ぶゆうの	《武勇の誇示》	名詞
＠ぶゆうのこ	《武勇の誇示》	名詞
＠ぶゆうのこじ	《武勇の誇示》	名詞
＠あ	《歩く死骸》	名詞
＠ある	《歩く死骸》	名詞
＠あるく	《歩く死骸》	名詞
＠あるくし	《歩く死骸》	名詞
＠あるくしが	《歩く死骸》	名詞
＠あるくしがい	《歩く死骸》	名詞
＠し	《死体騎士》	名詞
＠した	《死体騎士》	名詞
＠したい	《死体騎士》	名詞
＠したいき	《死体騎士》	名詞
＠したいきし	《死体騎士》	名詞
＠し	《死者の原野》	名詞
＠しし	《死者の原野》	名詞
＠ししゃ	《死者の原野》	名詞
＠ししゃの	《死者の原野》	名詞
＠ししゃのげ	《死者の原野》	名詞
＠ししゃのげん	《死者の原野》	名詞
＠ししゃのげんや	《死者の原野》	名詞
＠ざ	《残忍な異形》	名詞
＠ざん	《残忍な異形》	名詞
＠ざんに	《残忍な異形》	名詞
＠ざんにん	《残忍な異形》	名詞
＠ざんにんな	《残忍な異形》	名詞
＠ざんにんない	《残忍な異形》	名詞
＠ざんにんないけ	《残忍な異形》	名詞
＠ざんにんないけい	《残忍な異形》	名詞
＠ざ	《残忍な発動》	名詞
＠ざん	《残忍な発動》	名詞
＠ざんに	《残忍な発動》	名詞
＠ざんにん	《残忍な発動》	名詞
＠ざんにんな	《残忍な発動》	名詞
＠ざんにんなは	《残忍な発動》	名詞
＠ざんにんなはつ	《残忍な発動》	名詞
＠ざんにんなはつど	《残忍な発動》	名詞
＠ざんにんなはつどう	《残忍な発動》	名詞
＠さ	《殺害》	名詞
＠さつ	《殺害》	名詞
＠さつが	《殺害》	名詞
＠さつがい	《殺害》	名詞
＠す	《水族のシャーマン》	名詞
＠すい	《水族のシャーマン》	名詞
＠すいぞ	《水族のシャーマン》	名詞
＠すいぞく	《水族のシャーマン》	名詞
＠すいぞくの	《水族のシャーマン》	名詞
＠すいぞくのし	《水族のシャーマン》	名詞
＠すいぞくのしゃ	《水族のシャーマン》	名詞
＠すいぞくのしゃー	《水族のシャーマン》	名詞
＠すいぞくのしゃーま	《水族のシャーマン》	名詞
＠すいぞくのしゃーまん	《水族のシャーマン》	名詞
＠え	《永遠の疎外》	名詞
＠えい	《永遠の疎外》	名詞
＠えいえ	《永遠の疎外》	名詞
＠えいえん	《永遠の疎外》	名詞
＠えいえんの	《永遠の疎外》	名詞
＠えいえんのそ	《永遠の疎外》	名詞
＠えいえんのそが	《永遠の疎外》	名詞
＠えいえんのそがい	《永遠の疎外》	名詞
＠ぬ	《沼》	名詞
＠ぬま	《沼》	名詞
＠ぬ	《沼踏み》	名詞
＠ぬま	《沼踏み》	名詞
＠ぬまふ	《沼踏み》	名詞
＠ぬまふみ	《沼踏み》	名詞
＠ほ	《法の定め》	名詞
＠ほう	《法の定め》	名詞
＠ほうの	《法の定め》	名詞
＠ほうのさ	《法の定め》	名詞
＠ほうのさだ	《法の定め》	名詞
＠ほうのさだめ	《法の定め》	名詞
＠じ	《浄光の使徒》	名詞
＠じょ	《浄光の使徒》	名詞
＠じょう	《浄光の使徒》	名詞
＠じょうこ	《浄光の使徒》	名詞
＠じょうこう	《浄光の使徒》	名詞
＠じょうこうの	《浄光の使徒》	名詞
＠じょうこうのし	《浄光の使徒》	名詞
＠じょうこうのしと	《浄光の使徒》	名詞
＠な	《涙の氾濫》	名詞
＠なみ	《涙の氾濫》	名詞
＠なみだ	《涙の氾濫》	名詞
＠なみだの	《涙の氾濫》	名詞
＠なみだのは	《涙の氾濫》	名詞
＠なみだのはん	《涙の氾濫》	名詞
＠なみだのはんら	《涙の氾濫》	名詞
＠なみだのはんらん	《涙の氾濫》	名詞
＠し	《深海艦隊の殺し屋》	名詞
＠しん	《深海艦隊の殺し屋》	名詞
＠しんか	《深海艦隊の殺し屋》	名詞
＠しんかい	《深海艦隊の殺し屋》	名詞
＠しんかいか	《深海艦隊の殺し屋》	名詞
＠しんかいかん	《深海艦隊の殺し屋》	名詞
＠しんかいかんた	《深海艦隊の殺し屋》	名詞
＠しんかいかんたい	《深海艦隊の殺し屋》	名詞
＠しんかいかんたいの	《深海艦隊の殺し屋》	名詞
＠しんかいかんたいのこ	《深海艦隊の殺し屋》	名詞
＠しんかいかんたいのころ	《深海艦隊の殺し屋》	名詞
＠しんかいかんたいのころし	《深海艦隊の殺し屋》	名詞
＠しんかいかんたいのころしや	《深海艦隊の殺し屋》	名詞
＠こ	《混迷》	名詞
＠こん	《混迷》	名詞
＠こんめ	《混迷》	名詞
＠こんめい	《混迷》	名詞
＠よ	《溶岩族の喧嘩屋》	名詞
＠よう	《溶岩族の喧嘩屋》	名詞
＠ようが	《溶岩族の喧嘩屋》	名詞
＠ようがん	《溶岩族の喧嘩屋》	名詞
＠ようがんぞ	《溶岩族の喧嘩屋》	名詞
＠ようがんぞく	《溶岩族の喧嘩屋》	名詞
＠ようがんぞくの	《溶岩族の喧嘩屋》	名詞
＠ようがんぞくのけ	《溶岩族の喧嘩屋》	名詞
＠ようがんぞくのけん	《溶岩族の喧嘩屋》	名詞
＠ようがんぞくのけんか	《溶岩族の喧嘩屋》	名詞
＠ようがんぞくのけんかや	《溶岩族の喧嘩屋》	名詞
＠し	《漆黒軍の騎士》	名詞
＠しっ	《漆黒軍の騎士》	名詞
＠しっこ	《漆黒軍の騎士》	名詞
＠しっこく	《漆黒軍の騎士》	名詞
＠しっこくぐ	《漆黒軍の騎士》	名詞
＠しっこくぐん	《漆黒軍の騎士》	名詞
＠しっこくぐんの	《漆黒軍の騎士》	名詞
＠しっこくぐんのき	《漆黒軍の騎士》	名詞
＠しっこくぐんのきし	《漆黒軍の騎士》	名詞
＠ぼ	《濠のピラニア》	名詞
＠ぼり	《濠のピラニア》	名詞
＠ぼりの	《濠のピラニア》	名詞
＠ぼりのぴ	《濠のピラニア》	名詞
＠ぼりのぴら	《濠のピラニア》	名詞
＠ぼりのぴらに	《濠のピラニア》	名詞
＠ぼりのぴらにあ	《濠のピラニア》	名詞
＠か	《火山のドラゴン》	名詞
＠かざ	《火山のドラゴン》	名詞
＠かざん	《火山のドラゴン》	名詞
＠かざんの	《火山のドラゴン》	名詞
＠かざんのど	《火山のドラゴン》	名詞
＠かざんのどら	《火山のドラゴン》	名詞
＠かざんのどらご	《火山のドラゴン》	名詞
＠かざんのどらごん	《火山のドラゴン》	名詞
＠ひ	《火砕の精霊》	名詞
＠ひさ	《火砕の精霊》	名詞
＠ひさい	《火砕の精霊》	名詞
＠ひさいの	《火砕の精霊》	名詞
＠ひさいのし	《火砕の精霊》	名詞
＠ひさいのしょ	《火砕の精霊》	名詞
＠ひさいのしょう	《火砕の精霊》	名詞
＠ひさいのしょうり	《火砕の精霊》	名詞
＠ひさいのしょうりょ	《火砕の精霊》	名詞
＠ひさいのしょうりょう	《火砕の精霊》	名詞
＠は	《灰と化す》	名詞
＠はい	《灰と化す》	名詞
＠はいと	《灰と化す》	名詞
＠はいとば	《灰と化す》	名詞
＠はいとばか	《灰と化す》	名詞
＠はいとばかす	《灰と化す》	名詞
＠え	《炎の一掃》	名詞
＠えん	《炎の一掃》	名詞
＠えんの	《炎の一掃》	名詞
＠えんのい	《炎の一掃》	名詞
＠えんのいっ	《炎の一掃》	名詞
＠えんのいっそ	《炎の一掃》	名詞
＠えんのいっそう	《炎の一掃》	名詞
＠え	《炎の侍祭、チャンドラ》	名詞
＠えん	《炎の侍祭、チャンドラ》	名詞
＠えんの	《炎の侍祭、チャンドラ》	名詞
＠えんのさ	《炎の侍祭、チャンドラ》	名詞
＠えんのさむ	《炎の侍祭、チャンドラ》	名詞
＠えんのさむら	《炎の侍祭、チャンドラ》	名詞
＠えんのさむらい	《炎の侍祭、チャンドラ》	名詞
＠えんのさむらいさ	《炎の侍祭、チャンドラ》	名詞
＠えんのさむらいさい	《炎の侍祭、チャンドラ》	名詞
＠えんのさむらいさい、	《炎の侍祭、チャンドラ》	名詞
＠えんのさむらいさい、ち	《炎の侍祭、チャンドラ》	名詞
＠えんのさむらいさい、ちゃ	《炎の侍祭、チャンドラ》	名詞
＠えんのさむらいさい、ちゃん	《炎の侍祭、チャンドラ》	名詞
＠えんのさむらいさい、ちゃんど	《炎の侍祭、チャンドラ》	名詞
＠えんのさむらいさい、ちゃんどら	《炎の侍祭、チャンドラ》	名詞
＠え	《炎の大口、ドラクセス》	名詞
＠えん	《炎の大口、ドラクセス》	名詞
＠えんの	《炎の大口、ドラクセス》	名詞
＠えんのお	《炎の大口、ドラクセス》	名詞
＠えんのおお	《炎の大口、ドラクセス》	名詞
＠えんのおおく	《炎の大口、ドラクセス》	名詞
＠えんのおおくち	《炎の大口、ドラクセス》	名詞
＠えんのおおくち、	《炎の大口、ドラクセス》	名詞
＠えんのおおくち、ど	《炎の大口、ドラクセス》	名詞
＠えんのおおくち、どら	《炎の大口、ドラクセス》	名詞
＠えんのおおくち、どらく	《炎の大口、ドラクセス》	名詞
＠えんのおおくち、どらくせ	《炎の大口、ドラクセス》	名詞
＠えんのおおくち、どらくせす	《炎の大口、ドラクセス》	名詞
＠え	《炎の憤怒、チャンドラ》	名詞
＠えん	《炎の憤怒、チャンドラ》	名詞
＠えんの	《炎の憤怒、チャンドラ》	名詞
＠えんのふ	《炎の憤怒、チャンドラ》	名詞
＠えんのふん	《炎の憤怒、チャンドラ》	名詞
＠えんのふんぬ	《炎の憤怒、チャンドラ》	名詞
＠えんのふんぬ、	《炎の憤怒、チャンドラ》	名詞
＠えんのふんぬ、ち	《炎の憤怒、チャンドラ》	名詞
＠えんのふんぬ、ちゃ	《炎の憤怒、チャンドラ》	名詞
＠えんのふんぬ、ちゃん	《炎の憤怒、チャンドラ》	名詞
＠えんのふんぬ、ちゃんど	《炎の憤怒、チャンドラ》	名詞
＠えんのふんぬ、ちゃんどら	《炎の憤怒、チャンドラ》	名詞
＠え	《炎の精霊》	名詞
＠えん	《炎の精霊》	名詞
＠えんの	《炎の精霊》	名詞
＠えんのし	《炎の精霊》	名詞
＠えんのしょ	《炎の精霊》	名詞
＠えんのしょう	《炎の精霊》	名詞
＠えんのしょうり	《炎の精霊》	名詞
＠えんのしょうりょ	《炎の精霊》	名詞
＠えんのしょうりょう	《炎の精霊》	名詞
＠え	《炎の騎兵》	名詞
＠えん	《炎の騎兵》	名詞
＠えんの	《炎の騎兵》	名詞
＠えんのき	《炎の騎兵》	名詞
＠えんのきへ	《炎の騎兵》	名詞
＠えんのきへい	《炎の騎兵》	名詞
＠む	《無法の猛竜》	名詞
＠むほ	《無法の猛竜》	名詞
＠むほう	《無法の猛竜》	名詞
＠むほうの	《無法の猛竜》	名詞
＠むほうのた	《無法の猛竜》	名詞
＠むほうのたけ	《無法の猛竜》	名詞
＠むほうのたけし	《無法の猛竜》	名詞
＠むほうのたけしり	《無法の猛竜》	名詞
＠むほうのたけしりゅ	《無法の猛竜》	名詞
＠むほうのたけしりゅう	《無法の猛竜》	名詞
＠む	《無謀な空襲》	名詞
＠むぼ	《無謀な空襲》	名詞
＠むぼう	《無謀な空襲》	名詞
＠むぼうな	《無謀な空襲》	名詞
＠むぼうなく	《無謀な空襲》	名詞
＠むぼうなくう	《無謀な空襲》	名詞
＠むぼうなくうし	《無謀な空襲》	名詞
＠むぼうなくうしゅ	《無謀な空襲》	名詞
＠むぼうなくうしゅう	《無謀な空襲》	名詞
＠こ	《焦がし吐き》	名詞
＠こが	《焦がし吐き》	名詞
＠こがし	《焦がし吐き》	名詞
＠こがしは	《焦がし吐き》	名詞
＠こがしはき	《焦がし吐き》	名詞
＠や	《焼印刃》	名詞
＠やき	《焼印刃》	名詞
＠やきい	《焼印刃》	名詞
＠やきいん	《焼印刃》	名詞
＠やきいんは	《焼印刃》	名詞
＠も	《燃えさし運び》	名詞
＠もえ	《燃えさし運び》	名詞
＠もえさ	《燃えさし運び》	名詞
＠もえさし	《燃えさし運び》	名詞
＠もえさしは	《燃えさし運び》	名詞
＠もえさしはこ	《燃えさし運び》	名詞
＠もえさしはこび	《燃えさし運び》	名詞
＠き	《牙の魔術師》	名詞
＠きば	《牙の魔術師》	名詞
＠きばの	《牙の魔術師》	名詞
＠きばのま	《牙の魔術師》	名詞
＠きばのまじ	《牙の魔術師》	名詞
＠きばのまじゅ	《牙の魔術師》	名詞
＠きばのまじゅつ	《牙の魔術師》	名詞
＠きばのまじゅつし	《牙の魔術師》	名詞
＠も	《物語の終わり》	名詞
＠もの	《物語の終わり》	名詞
＠ものが	《物語の終わり》	名詞
＠ものがた	《物語の終わり》	名詞
＠ものがたり	《物語の終わり》	名詞
＠ものがたりの	《物語の終わり》	名詞
＠ものがたりのお	《物語の終わり》	名詞
＠ものがたりのおわ	《物語の終わり》	名詞
＠ものがたりのおわり	《物語の終わり》	名詞
＠く	《狂った怒り》	名詞
＠くる	《狂った怒り》	名詞
＠くるっ	《狂った怒り》	名詞
＠くるった	《狂った怒り》	名詞
＠くるったい	《狂った怒り》	名詞
＠くるったいか	《狂った怒り》	名詞
＠くるったいかり	《狂った怒り》	名詞
＠き	《狂気の一咬み》	名詞
＠きょ	《狂気の一咬み》	名詞
＠きょう	《狂気の一咬み》	名詞
＠きょうき	《狂気の一咬み》	名詞
＠きょうきの	《狂気の一咬み》	名詞
＠きょうきのか	《狂気の一咬み》	名詞
＠きょうきのかみ	《狂気の一咬み》	名詞
＠お	《狼乗りの鞍》	名詞
＠おお	《狼乗りの鞍》	名詞
＠おおか	《狼乗りの鞍》	名詞
＠おおかみ	《狼乗りの鞍》	名詞
＠おおかみの	《狼乗りの鞍》	名詞
＠おおかみのり	《狼乗りの鞍》	名詞
＠おおかみのりの	《狼乗りの鞍》	名詞
＠おおかみのりのく	《狼乗りの鞍》	名詞
＠おおかみのりのくら	《狼乗りの鞍》	名詞
＠お	《狼族の絆》	名詞
＠おお	《狼族の絆》	名詞
＠おおか	《狼族の絆》	名詞
＠おおかみ	《狼族の絆》	名詞
＠おおかみぞ	《狼族の絆》	名詞
＠おおかみぞく	《狼族の絆》	名詞
＠おおかみぞくの	《狼族の絆》	名詞
＠おおかみぞくのき	《狼族の絆》	名詞
＠おおかみぞくのきず	《狼族の絆》	名詞
＠おおかみぞくのきずな	《狼族の絆》	名詞
＠ど	《獰猛な仔狼》	名詞
＠どう	《獰猛な仔狼》	名詞
＠どうも	《獰猛な仔狼》	名詞
＠どうもう	《獰猛な仔狼》	名詞
＠どうもうな	《獰猛な仔狼》	名詞
＠どうもうなこ	《獰猛な仔狼》	名詞
＠どうもうなこお	《獰猛な仔狼》	名詞
＠どうもうなこおお	《獰猛な仔狼》	名詞
＠どうもうなこおおか	《獰猛な仔狼》	名詞
＠どうもうなこおおかみ	《獰猛な仔狼》	名詞
＠さ	《珊瑚マーフォーク》	名詞
＠さん	《珊瑚マーフォーク》	名詞
＠さんご	《珊瑚マーフォーク》	名詞
＠さんごま	《珊瑚マーフォーク》	名詞
＠さんごまー	《珊瑚マーフォーク》	名詞
＠さんごまーふ	《珊瑚マーフォーク》	名詞
＠さんごまーふぉ	《珊瑚マーフォーク》	名詞
＠さんごまーふぉー	《珊瑚マーフォーク》	名詞
＠さんごまーふぉーく	《珊瑚マーフォーク》	名詞
＠が	《瓦礫帯の世捨て人》	名詞
＠がれ	《瓦礫帯の世捨て人》	名詞
＠がれき	《瓦礫帯の世捨て人》	名詞
＠がれきお	《瓦礫帯の世捨て人》	名詞
＠がれきおび	《瓦礫帯の世捨て人》	名詞
＠がれきおびの	《瓦礫帯の世捨て人》	名詞
＠がれきおびのよ	《瓦礫帯の世捨て人》	名詞
＠がれきおびのよす	《瓦礫帯の世捨て人》	名詞
＠がれきおびのよすて	《瓦礫帯の世捨て人》	名詞
＠がれきおびのよすてび	《瓦礫帯の世捨て人》	名詞
＠がれきおびのよすてびと	《瓦礫帯の世捨て人》	名詞
＠せ	《生命力の天使》	名詞
＠せい	《生命力の天使》	名詞
＠せいめ	《生命力の天使》	名詞
＠せいめい	《生命力の天使》	名詞
＠せいめいり	《生命力の天使》	名詞
＠せいめいりょ	《生命力の天使》	名詞
＠せいめいりょく	《生命力の天使》	名詞
＠せいめいりょくの	《生命力の天使》	名詞
＠せいめいりょくのて	《生命力の天使》	名詞
＠せいめいりょくのてん	《生命力の天使》	名詞
＠せいめいりょくのてんし	《生命力の天使》	名詞
＠だ	《男爵領の吸血鬼》	名詞
＠だん	《男爵領の吸血鬼》	名詞
＠だんし	《男爵領の吸血鬼》	名詞
＠だんしゃ	《男爵領の吸血鬼》	名詞
＠だんしゃく	《男爵領の吸血鬼》	名詞
＠だんしゃくり	《男爵領の吸血鬼》	名詞
＠だんしゃくりょ	《男爵領の吸血鬼》	名詞
＠だんしゃくりょう	《男爵領の吸血鬼》	名詞
＠だんしゃくりょうの	《男爵領の吸血鬼》	名詞
＠だんしゃくりょうのき	《男爵領の吸血鬼》	名詞
＠だんしゃくりょうのきゅ	《男爵領の吸血鬼》	名詞
＠だんしゃくりょうのきゅう	《男爵領の吸血鬼》	名詞
＠だんしゃくりょうのきゅうけ	《男爵領の吸血鬼》	名詞
＠だんしゃくりょうのきゅうけつ	《男爵領の吸血鬼》	名詞
＠だんしゃくりょうのきゅうけつき	《男爵領の吸血鬼》	名詞
＠し	《疾病の神殿》	名詞
＠しっ	《疾病の神殿》	名詞
＠しっぺ	《疾病の神殿》	名詞
＠しっぺい	《疾病の神殿》	名詞
＠しっぺいの	《疾病の神殿》	名詞
＠しっぺいのし	《疾病の神殿》	名詞
＠しっぺいのしん	《疾病の神殿》	名詞
＠しっぺいのしんで	《疾病の神殿》	名詞
＠しっぺいのしんでん	《疾病の神殿》	名詞
＠り	《療養所の骸骨》	名詞
＠りょ	《療養所の骸骨》	名詞
＠りょう	《療養所の骸骨》	名詞
＠りょうよ	《療養所の骸骨》	名詞
＠りょうよう	《療養所の骸骨》	名詞
＠りょうようし	《療養所の骸骨》	名詞
＠りょうようしょ	《療養所の骸骨》	名詞
＠りょうようしょの	《療養所の骸骨》	名詞
＠りょうようしょのが	《療養所の骸骨》	名詞
＠りょうようしょのがい	《療養所の骸骨》	名詞
＠りょうようしょのがいこ	《療養所の骸骨》	名詞
＠りょうようしょのがいこつ	《療養所の骸骨》	名詞
＠は	《発火の力線》	名詞
＠はっ	《発火の力線》	名詞
＠はっか	《発火の力線》	名詞
＠はっかの	《発火の力線》	名詞
＠はっかのち	《発火の力線》	名詞
＠はっかのちか	《発火の力線》	名詞
＠はっかのちから	《発火の力線》	名詞
＠はっかのちからせ	《発火の力線》	名詞
＠はっかのちからせん	《発火の力線》	名詞
＠は	《発現する浅瀬》	名詞
＠はつ	《発現する浅瀬》	名詞
＠はつげ	《発現する浅瀬》	名詞
＠はつげん	《発現する浅瀬》	名詞
＠はつげんす	《発現する浅瀬》	名詞
＠はつげんする	《発現する浅瀬》	名詞
＠はつげんするあ	《発現する浅瀬》	名詞
＠はつげんするあさ	《発現する浅瀬》	名詞
＠はつげんするあさせ	《発現する浅瀬》	名詞
＠め	《目覚めた猛火、チャンドラ》	名詞
＠めざ	《目覚めた猛火、チャンドラ》	名詞
＠めざめ	《目覚めた猛火、チャンドラ》	名詞
＠めざめた	《目覚めた猛火、チャンドラ》	名詞
＠めざめたも	《目覚めた猛火、チャンドラ》	名詞
＠めざめたもう	《目覚めた猛火、チャンドラ》	名詞
＠めざめたもうか	《目覚めた猛火、チャンドラ》	名詞
＠めざめたもうか、	《目覚めた猛火、チャンドラ》	名詞
＠めざめたもうか、ち	《目覚めた猛火、チャンドラ》	名詞
＠めざめたもうか、ちゃ	《目覚めた猛火、チャンドラ》	名詞
＠めざめたもうか、ちゃん	《目覚めた猛火、チャンドラ》	名詞
＠めざめたもうか、ちゃんど	《目覚めた猛火、チャンドラ》	名詞
＠めざめたもうか、ちゃんどら	《目覚めた猛火、チャンドラ》	名詞
＠す	《睡蓮の原野》	名詞
＠すい	《睡蓮の原野》	名詞
＠すいれ	《睡蓮の原野》	名詞
＠すいれん	《睡蓮の原野》	名詞
＠すいれんの	《睡蓮の原野》	名詞
＠すいれんのげ	《睡蓮の原野》	名詞
＠すいれんのげん	《睡蓮の原野》	名詞
＠すいれんのげんや	《睡蓮の原野》	名詞
＠た	《短剣帆の飛空士》	名詞
＠たん	《短剣帆の飛空士》	名詞
＠たんけ	《短剣帆の飛空士》	名詞
＠たんけん	《短剣帆の飛空士》	名詞
＠たんけんほ	《短剣帆の飛空士》	名詞
＠たんけんほの	《短剣帆の飛空士》	名詞
＠たんけんほのひ	《短剣帆の飛空士》	名詞
＠たんけんほのひく	《短剣帆の飛空士》	名詞
＠たんけんほのひくう	《短剣帆の飛空士》	名詞
＠たんけんほのひくうし	《短剣帆の飛空士》	名詞
＠い	《石のゴーレム》	名詞
＠いし	《石のゴーレム》	名詞
＠いしの	《石のゴーレム》	名詞
＠いしのご	《石のゴーレム》	名詞
＠いしのごー	《石のゴーレム》	名詞
＠いしのごーれ	《石のゴーレム》	名詞
＠いしのごーれむ	《石のゴーレム》	名詞
＠と	《砦の執行官》	名詞
＠とり	《砦の執行官》	名詞
＠とりで	《砦の執行官》	名詞
＠とりでの	《砦の執行官》	名詞
＠とりでのし	《砦の執行官》	名詞
＠とりでのしっ	《砦の執行官》	名詞
＠とりでのしっこ	《砦の執行官》	名詞
＠とりでのしっこう	《砦の執行官》	名詞
＠とりでのしっこうか	《砦の執行官》	名詞
＠とりでのしっこうかん	《砦の執行官》	名詞
＠は	《破壊的穴掘り》	名詞
＠はか	《破壊的穴掘り》	名詞
＠はかい	《破壊的穴掘り》	名詞
＠はかいて	《破壊的穴掘り》	名詞
＠はかいてき	《破壊的穴掘り》	名詞
＠はかいてきあ	《破壊的穴掘り》	名詞
＠はかいてきあな	《破壊的穴掘り》	名詞
＠はかいてきあなほ	《破壊的穴掘り》	名詞
＠はかいてきあなほり	《破壊的穴掘り》	名詞
＠み	《磨かれたやせ地》	名詞
＠みが	《磨かれたやせ地》	名詞
＠みがか	《磨かれたやせ地》	名詞
＠みがかれ	《磨かれたやせ地》	名詞
＠みがかれた	《磨かれたやせ地》	名詞
＠みがかれたや	《磨かれたやせ地》	名詞
＠みがかれたやせ	《磨かれたやせ地》	名詞
＠みがかれたやせち	《磨かれたやせ地》	名詞
＠そ	《祖先の刃》	名詞
＠そせ	《祖先の刃》	名詞
＠そせん	《祖先の刃》	名詞
＠そせんの	《祖先の刃》	名詞
＠そせんのは	《祖先の刃》	名詞
＠そ	《祖先の象徴》	名詞
＠そせ	《祖先の象徴》	名詞
＠そせん	《祖先の象徴》	名詞
＠そせんの	《祖先の象徴》	名詞
＠そせんのし	《祖先の象徴》	名詞
＠そせんのしょ	《祖先の象徴》	名詞
＠そせんのしょう	《祖先の象徴》	名詞
＠そせんのしょうち	《祖先の象徴》	名詞
＠そせんのしょうちょ	《祖先の象徴》	名詞
＠そせんのしょうちょう	《祖先の象徴》	名詞
＠か	《神々の思し召し》	名詞
＠かみ	《神々の思し召し》	名詞
＠かみが	《神々の思し召し》	名詞
＠かみがみ	《神々の思し召し》	名詞
＠かみがみの	《神々の思し召し》	名詞
＠かみがみのお	《神々の思し召し》	名詞
＠かみがみのおぼ	《神々の思し召し》	名詞
＠かみがみのおぼし	《神々の思し召し》	名詞
＠かみがみのおぼしめ	《神々の思し召し》	名詞
＠かみがみのおぼしめし	《神々の思し召し》	名詞
＠し	《神秘の炉》	名詞
＠しん	《神秘の炉》	名詞
＠しんぴ	《神秘の炉》	名詞
＠しんぴの	《神秘の炉》	名詞
＠しんぴのろ	《神秘の炉》	名詞
＠し	《神秘の神殿》	名詞
＠しん	《神秘の神殿》	名詞
＠しんぴ	《神秘の神殿》	名詞
＠しんぴの	《神秘の神殿》	名詞
＠しんぴのし	《神秘の神殿》	名詞
＠しんぴのしん	《神秘の神殿》	名詞
＠しんぴのしんで	《神秘の神殿》	名詞
＠しんぴのしんでん	《神秘の神殿》	名詞
＠し	《神聖の力線》	名詞
＠しん	《神聖の力線》	名詞
＠しんせ	《神聖の力線》	名詞
＠しんせい	《神聖の力線》	名詞
＠しんせいの	《神聖の力線》	名詞
＠しんせいのち	《神聖の力線》	名詞
＠しんせいのちか	《神聖の力線》	名詞
＠しんせいのちから	《神聖の力線》	名詞
＠しんせいのちからせ	《神聖の力線》	名詞
＠しんせいのちからせん	《神聖の力線》	名詞
＠ひ	《秘本綴じのリッチ》	名詞
＠ひほ	《秘本綴じのリッチ》	名詞
＠ひほん	《秘本綴じのリッチ》	名詞
＠ひほんと	《秘本綴じのリッチ》	名詞
＠ひほんとじ	《秘本綴じのリッチ》	名詞
＠ひほんとじの	《秘本綴じのリッチ》	名詞
＠ひほんとじのり	《秘本綴じのリッチ》	名詞
＠ひほんとじのりっ	《秘本綴じのリッチ》	名詞
＠ひほんとじのりっち	《秘本綴じのリッチ》	名詞
＠い	《稲妻の嵐族》	名詞
＠いな	《稲妻の嵐族》	名詞
＠いなず	《稲妻の嵐族》	名詞
＠いなずま	《稲妻の嵐族》	名詞
＠いなずまの	《稲妻の嵐族》	名詞
＠いなずまのあ	《稲妻の嵐族》	名詞
＠いなずまのあら	《稲妻の嵐族》	名詞
＠いなずまのあらし	《稲妻の嵐族》	名詞
＠いなずまのあらしぞ	《稲妻の嵐族》	名詞
＠いなずまのあらしぞく	《稲妻の嵐族》	名詞
＠ぞ	《空からの突撃》	名詞
＠ぞら	《空からの突撃》	名詞
＠ぞらか	《空からの突撃》	名詞
＠ぞらから	《空からの突撃》	名詞
＠ぞらからの	《空からの突撃》	名詞
＠ぞらからのと	《空からの突撃》	名詞
＠ぞらからのとつ	《空からの突撃》	名詞
＠ぞらからのとつげ	《空からの突撃》	名詞
＠ぞらからのとつげき	《空からの突撃》	名詞
＠そ	《空の踊り手、ムー・ヤンリン》	名詞
＠そら	《空の踊り手、ムー・ヤンリン》	名詞
＠そらの	《空の踊り手、ムー・ヤンリン》	名詞
＠そらのお	《空の踊り手、ムー・ヤンリン》	名詞
＠そらのおど	《空の踊り手、ムー・ヤンリン》	名詞
＠そらのおどり	《空の踊り手、ムー・ヤンリン》	名詞
＠そらのおどりて	《空の踊り手、ムー・ヤンリン》	名詞
＠そらのおどりて、	《空の踊り手、ムー・ヤンリン》	名詞
＠そらのおどりて、む	《空の踊り手、ムー・ヤンリン》	名詞
＠そらのおどりて、むー	《空の踊り手、ムー・ヤンリン》	名詞
＠そらのおどりて、むー・	《空の踊り手、ムー・ヤンリン》	名詞
＠そらのおどりて、むー・や	《空の踊り手、ムー・ヤンリン》	名詞
＠そらのおどりて、むー・やん	《空の踊り手、ムー・ヤンリン》	名詞
＠そらのおどりて、むー・やんり	《空の踊り手、ムー・ヤンリン》	名詞
＠そらのおどりて、むー・やんりん	《空の踊り手、ムー・ヤンリン》	名詞
＠そ	《空騎士の先兵》	名詞
＠そら	《空騎士の先兵》	名詞
＠そらき	《空騎士の先兵》	名詞
＠そらきし	《空騎士の先兵》	名詞
＠そらきしの	《空騎士の先兵》	名詞
＠そらきしのせ	《空騎士の先兵》	名詞
＠そらきしのせん	《空騎士の先兵》	名詞
＠そらきしのせんぺ	《空騎士の先兵》	名詞
＠そらきしのせんぺい	《空騎士の先兵》	名詞
＠り	《立腹》	名詞
＠りっ	《立腹》	名詞
＠りっぷ	《立腹》	名詞
＠りっぷく	《立腹》	名詞
＠ふ	《節くれ背のサイ》	名詞
＠ふし	《節くれ背のサイ》	名詞
＠ふしく	《節くれ背のサイ》	名詞
＠ふしくれ	《節くれ背のサイ》	名詞
＠ふしくれせ	《節くれ背のサイ》	名詞
＠ふしくれせの	《節くれ背のサイ》	名詞
＠ふしくれせのさ	《節くれ背のサイ》	名詞
＠ふしくれせのさい	《節くれ背のサイ》	名詞
＠せ	《精神腐敗》	名詞
＠せい	《精神腐敗》	名詞
＠せいし	《精神腐敗》	名詞
＠せいしん	《精神腐敗》	名詞
＠せいしんふ	《精神腐敗》	名詞
＠せいしんふは	《精神腐敗》	名詞
＠せいしんふはい	《精神腐敗》	名詞
＠こ	《紺碧のドレイク》	名詞
＠こん	《紺碧のドレイク》	名詞
＠こんぺ	《紺碧のドレイク》	名詞
＠こんぺき	《紺碧のドレイク》	名詞
＠こんぺきの	《紺碧のドレイク》	名詞
＠こんぺきのど	《紺碧のドレイク》	名詞
＠こんぺきのどれ	《紺碧のドレイク》	名詞
＠こんぺきのどれい	《紺碧のドレイク》	名詞
＠こんぺきのどれいく	《紺碧のドレイク》	名詞
＠こ	《絞首された処刑人》	名詞
＠こう	《絞首された処刑人》	名詞
＠こうし	《絞首された処刑人》	名詞
＠こうしゅ	《絞首された処刑人》	名詞
＠こうしゅさ	《絞首された処刑人》	名詞
＠こうしゅされ	《絞首された処刑人》	名詞
＠こうしゅされた	《絞首された処刑人》	名詞
＠こうしゅされたし	《絞首された処刑人》	名詞
＠こうしゅされたしょ	《絞首された処刑人》	名詞
＠こうしゅされたしょけ	《絞首された処刑人》	名詞
＠こうしゅされたしょけい	《絞首された処刑人》	名詞
＠こうしゅされたしょけいに	《絞首された処刑人》	名詞
＠こうしゅされたしょけいにん	《絞首された処刑人》	名詞
＠あ	《網投げ蜘蛛》	名詞
＠あみ	《網投げ蜘蛛》	名詞
＠あみな	《網投げ蜘蛛》	名詞
＠あみなげ	《網投げ蜘蛛》	名詞
＠あみなげぐ	《網投げ蜘蛛》	名詞
＠あみなげぐも	《網投げ蜘蛛》	名詞
＠り	《緑林の歩哨》	名詞
＠りょ	《緑林の歩哨》	名詞
＠りょく	《緑林の歩哨》	名詞
＠りょくり	《緑林の歩哨》	名詞
＠りょくりん	《緑林の歩哨》	名詞
＠りょくりんの	《緑林の歩哨》	名詞
＠りょくりんのほ	《緑林の歩哨》	名詞
＠りょくりんのほし	《緑林の歩哨》	名詞
＠りょくりんのほしょ	《緑林の歩哨》	名詞
＠りょくりんのほしょう	《緑林の歩哨》	名詞
＠れ	《練達の接合者》	名詞
＠れん	《練達の接合者》	名詞
＠れんた	《練達の接合者》	名詞
＠れんたつ	《練達の接合者》	名詞
＠れんたつの	《練達の接合者》	名詞
＠れんたつのせ	《練達の接合者》	名詞
＠れんたつのせつ	《練達の接合者》	名詞
＠れんたつのせつご	《練達の接合者》	名詞
＠れんたつのせつごう	《練達の接合者》	名詞
＠れんたつのせつごうし	《練達の接合者》	名詞
＠れんたつのせつごうしゃ	《練達の接合者》	名詞
＠む	《群れの力、アジャニ》	名詞
＠むれ	《群れの力、アジャニ》	名詞
＠むれの	《群れの力、アジャニ》	名詞
＠むれのち	《群れの力、アジャニ》	名詞
＠むれのちか	《群れの力、アジャニ》	名詞
＠むれのちから	《群れの力、アジャニ》	名詞
＠むれのちから、	《群れの力、アジャニ》	名詞
＠むれのちから、あ	《群れの力、アジャニ》	名詞
＠むれのちから、あじ	《群れの力、アジャニ》	名詞
＠むれのちから、あじゃ	《群れの力、アジャニ》	名詞
＠むれのちから、あじゃに	《群れの力、アジャニ》	名詞
＠む	《群れる猛犬》	名詞
＠むれ	《群れる猛犬》	名詞
＠むれる	《群れる猛犬》	名詞
＠むれるも	《群れる猛犬》	名詞
＠むれるもう	《群れる猛犬》	名詞
＠むれるもうけ	《群れる猛犬》	名詞
＠むれるもうけん	《群れる猛犬》	名詞
＠つ	《翼ある言葉》	名詞
＠つば	《翼ある言葉》	名詞
＠つばさ	《翼ある言葉》	名詞
＠つばさあ	《翼ある言葉》	名詞
＠つばさある	《翼ある言葉》	名詞
＠つばさあるこ	《翼ある言葉》	名詞
＠つばさあること	《翼ある言葉》	名詞
＠つばさあることば	《翼ある言葉》	名詞
＠つ	《翼の司教》	名詞
＠つば	《翼の司教》	名詞
＠つばさ	《翼の司教》	名詞
＠つばさの	《翼の司教》	名詞
＠つばさのし	《翼の司教》	名詞
＠つばさのしき	《翼の司教》	名詞
＠つばさのしきょ	《翼の司教》	名詞
＠つばさのしきょう	《翼の司教》	名詞
＠せ	《聖域の門》	名詞
＠せい	《聖域の門》	名詞
＠せいい	《聖域の門》	名詞
＠せいいき	《聖域の門》	名詞
＠せいいきの	《聖域の門》	名詞
＠せいいきのも	《聖域の門》	名詞
＠せいいきのもん	《聖域の門》	名詞
＠く	《腐れ蔦の再生》	名詞
＠くさ	《腐れ蔦の再生》	名詞
＠くされ	《腐れ蔦の再生》	名詞
＠くされつ	《腐れ蔦の再生》	名詞
＠くされつた	《腐れ蔦の再生》	名詞
＠くされつたの	《腐れ蔦の再生》	名詞
＠くされつたのさ	《腐れ蔦の再生》	名詞
＠くされつたのさい	《腐れ蔦の再生》	名詞
＠くされつたのさいせ	《腐れ蔦の再生》	名詞
＠くされつたのさいせい	《腐れ蔦の再生》	名詞
＠し	《自然な最期》	名詞
＠しぜ	《自然な最期》	名詞
＠しぜん	《自然な最期》	名詞
＠しぜんな	《自然な最期》	名詞
＠しぜんなさ	《自然な最期》	名詞
＠しぜんなさい	《自然な最期》	名詞
＠しぜんなさいご	《自然な最期》	名詞
＠し	《自然の報復者、ビビアン》	名詞
＠しぜ	《自然の報復者、ビビアン》	名詞
＠しぜん	《自然の報復者、ビビアン》	名詞
＠しぜんの	《自然の報復者、ビビアン》	名詞
＠しぜんのほ	《自然の報復者、ビビアン》	名詞
＠しぜんのほう	《自然の報復者、ビビアン》	名詞
＠しぜんのほうふ	《自然の報復者、ビビアン》	名詞
＠しぜんのほうふく	《自然の報復者、ビビアン》	名詞
＠しぜんのほうふくし	《自然の報復者、ビビアン》	名詞
＠しぜんのほうふくしゃ	《自然の報復者、ビビアン》	名詞
＠しぜんのほうふくしゃ、	《自然の報復者、ビビアン》	名詞
＠しぜんのほうふくしゃ、び	《自然の報復者、ビビアン》	名詞
＠しぜんのほうふくしゃ、びび	《自然の報復者、ビビアン》	名詞
＠しぜんのほうふくしゃ、びびあ	《自然の報復者、ビビアン》	名詞
＠しぜんのほうふくしゃ、びびあん	《自然の報復者、ビビアン》	名詞
＠ば	《花咲く砂地》	名詞
＠ばな	《花咲く砂地》	名詞
＠ばなさ	《花咲く砂地》	名詞
＠ばなさく	《花咲く砂地》	名詞
＠ばなさくす	《花咲く砂地》	名詞
＠ばなさくすな	《花咲く砂地》	名詞
＠ばなさくすなじ	《花咲く砂地》	名詞
＠く	《苦しめる吸引》	名詞
＠くる	《苦しめる吸引》	名詞
＠くるし	《苦しめる吸引》	名詞
＠くるしめ	《苦しめる吸引》	名詞
＠くるしめる	《苦しめる吸引》	名詞
＠くるしめるき	《苦しめる吸引》	名詞
＠くるしめるきゅ	《苦しめる吸引》	名詞
＠くるしめるきゅう	《苦しめる吸引》	名詞
＠くるしめるきゅうい	《苦しめる吸引》	名詞
＠くるしめるきゅういん	《苦しめる吸引》	名詞
＠く	《苦悶の権化》	名詞
＠くも	《苦悶の権化》	名詞
＠くもん	《苦悶の権化》	名詞
＠くもんの	《苦悶の権化》	名詞
＠くもんのご	《苦悶の権化》	名詞
＠くもんのごん	《苦悶の権化》	名詞
＠くもんのごんげ	《苦悶の権化》	名詞
＠し	《茂み壊し》	名詞
＠しげ	《茂み壊し》	名詞
＠しげみ	《茂み壊し》	名詞
＠しげみこ	《茂み壊し》	名詞
＠しげみこわ	《茂み壊し》	名詞
＠しげみこわし	《茂み壊し》	名詞
＠い	《茨の騎兵》	名詞
＠いば	《茨の騎兵》	名詞
＠いばら	《茨の騎兵》	名詞
＠いばらの	《茨の騎兵》	名詞
＠いばらのき	《茨の騎兵》	名詞
＠いばらのきへ	《茨の騎兵》	名詞
＠いばらのきへい	《茨の騎兵》	名詞
＠い	《茨森の滝》	名詞
＠いば	《茨森の滝》	名詞
＠いばら	《茨森の滝》	名詞
＠いばらも	《茨森の滝》	名詞
＠いばらもり	《茨森の滝》	名詞
＠いばらもりの	《茨森の滝》	名詞
＠いばらもりのた	《茨森の滝》	名詞
＠いばらもりのたき	《茨森の滝》	名詞
＠こ	《荒廃甲虫》	名詞
＠こう	《荒廃甲虫》	名詞
＠こうは	《荒廃甲虫》	名詞
＠こうはい	《荒廃甲虫》	名詞
＠こうはいか	《荒廃甲虫》	名詞
＠こうはいかぶ	《荒廃甲虫》	名詞
＠こうはいかぶと	《荒廃甲虫》	名詞
＠こうはいかぶとむ	《荒廃甲虫》	名詞
＠こうはいかぶとむし	《荒廃甲虫》	名詞
＠す	《菅草の蠍》	名詞
＠すげ	《菅草の蠍》	名詞
＠すげぐ	《菅草の蠍》	名詞
＠すげぐさ	《菅草の蠍》	名詞
＠すげぐさの	《菅草の蠍》	名詞
＠すげぐさのさ	《菅草の蠍》	名詞
＠すげぐさのさそ	《菅草の蠍》	名詞
＠すげぐさのさそり	《菅草の蠍》	名詞
＠こ	《虚空の力線》	名詞
＠こく	《虚空の力線》	名詞
＠こくう	《虚空の力線》	名詞
＠こくうの	《虚空の力線》	名詞
＠こくうのち	《虚空の力線》	名詞
＠こくうのちか	《虚空の力線》	名詞
＠こくうのちから	《虚空の力線》	名詞
＠こくうのちからせ	《虚空の力線》	名詞
＠こくうのちからせん	《虚空の力線》	名詞
＠ち	《血に染まった祭壇》	名詞
＠ちに	《血に染まった祭壇》	名詞
＠ちにそ	《血に染まった祭壇》	名詞
＠ちにそま	《血に染まった祭壇》	名詞
＠ちにそまっ	《血に染まった祭壇》	名詞
＠ちにそまった	《血に染まった祭壇》	名詞
＠ちにそまったさ	《血に染まった祭壇》	名詞
＠ちにそまったさい	《血に染まった祭壇》	名詞
＠ちにそまったさいだ	《血に染まった祭壇》	名詞
＠ちにそまったさいだん	《血に染まった祭壇》	名詞
＠ち	《血に飢えた曲芸師》	名詞
＠ちに	《血に飢えた曲芸師》	名詞
＠ちにう	《血に飢えた曲芸師》	名詞
＠ちにうえ	《血に飢えた曲芸師》	名詞
＠ちにうえた	《血に飢えた曲芸師》	名詞
＠ちにうえたき	《血に飢えた曲芸師》	名詞
＠ちにうえたきょ	《血に飢えた曲芸師》	名詞
＠ちにうえたきょく	《血に飢えた曲芸師》	名詞
＠ちにうえたきょくげ	《血に飢えた曲芸師》	名詞
＠ちにうえたきょくげい	《血に飢えた曲芸師》	名詞
＠ちにうえたきょくげいし	《血に飢えた曲芸師》	名詞
＠ち	《血に飢えた血王》	名詞
＠ちに	《血に飢えた血王》	名詞
＠ちにう	《血に飢えた血王》	名詞
＠ちにうえ	《血に飢えた血王》	名詞
＠ちにうえた	《血に飢えた血王》	名詞
＠ちにうえたち	《血に飢えた血王》	名詞
＠ちにうえたちお	《血に飢えた血王》	名詞
＠ちにうえたちおう	《血に飢えた血王》	名詞
＠ち	《血の取引者、ヴィリス》	名詞
＠ちの	《血の取引者、ヴィリス》	名詞
＠ちのと	《血の取引者、ヴィリス》	名詞
＠ちのとり	《血の取引者、ヴィリス》	名詞
＠ちのとりひ	《血の取引者、ヴィリス》	名詞
＠ちのとりひき	《血の取引者、ヴィリス》	名詞
＠ちのとりひきし	《血の取引者、ヴィリス》	名詞
＠ちのとりひきしゃ	《血の取引者、ヴィリス》	名詞
＠ちのとりひきしゃ、	《血の取引者、ヴィリス》	名詞
＠ちのとりひきしゃ、う	《血の取引者、ヴィリス》	名詞
＠ちのとりひきしゃ、ヴ	《血の取引者、ヴィリス》	名詞
＠ちのとりひきしゃ、ヴぃ	《血の取引者、ヴィリス》	名詞
＠ちのとりひきしゃ、ヴぃり	《血の取引者、ヴィリス》	名詞
＠ちのとりひきしゃ、ヴぃりす	《血の取引者、ヴィリス》	名詞
＠ち	《血の強盗》	名詞
＠ちの	《血の強盗》	名詞
＠ちのご	《血の強盗》	名詞
＠ちのごう	《血の強盗》	名詞
＠ちのごうと	《血の強盗》	名詞
＠ちのごうとう	《血の強盗》	名詞
＠ち	《血の美食家》	名詞
＠ちの	《血の美食家》	名詞
＠ちのび	《血の美食家》	名詞
＠ちのびし	《血の美食家》	名詞
＠ちのびしょ	《血の美食家》	名詞
＠ちのびしょく	《血の美食家》	名詞
＠ちのびしょくか	《血の美食家》	名詞
＠ち	《血溜まりの洞窟》	名詞
＠ちだ	《血溜まりの洞窟》	名詞
＠ちだま	《血溜まりの洞窟》	名詞
＠ちだまり	《血溜まりの洞窟》	名詞
＠ちだまりの	《血溜まりの洞窟》	名詞
＠ちだまりのど	《血溜まりの洞窟》	名詞
＠ちだまりのどう	《血溜まりの洞窟》	名詞
＠ちだまりのどうく	《血溜まりの洞窟》	名詞
＠ちだまりのどうくつ	《血溜まりの洞窟》	名詞
＠う	《裏切りの工作員》	名詞
＠うら	《裏切りの工作員》	名詞
＠うらぎ	《裏切りの工作員》	名詞
＠うらぎり	《裏切りの工作員》	名詞
＠うらぎりの	《裏切りの工作員》	名詞
＠うらぎりのこ	《裏切りの工作員》	名詞
＠うらぎりのこう	《裏切りの工作員》	名詞
＠うらぎりのこうさ	《裏切りの工作員》	名詞
＠うらぎりのこうさく	《裏切りの工作員》	名詞
＠うらぎりのこうさくい	《裏切りの工作員》	名詞
＠うらぎりのこうさくいん	《裏切りの工作員》	名詞
＠せ	《西風の突撃》	名詞
＠せい	《西風の突撃》	名詞
＠せいふ	《西風の突撃》	名詞
＠せいふう	《西風の突撃》	名詞
＠せいふうの	《西風の突撃》	名詞
＠せいふうのと	《西風の突撃》	名詞
＠せいふうのとつ	《西風の突撃》	名詞
＠せいふうのとつげ	《西風の突撃》	名詞
＠せいふうのとつげき	《西風の突撃》	名詞
＠よ	《要塞ガニ》	名詞
＠よう	《要塞ガニ》	名詞
＠ようさ	《要塞ガニ》	名詞
＠ようさい	《要塞ガニ》	名詞
＠ようさいが	《要塞ガニ》	名詞
＠ようさいがに	《要塞ガニ》	名詞
＠み	《見本に倣うもの》	名詞
＠みほ	《見本に倣うもの》	名詞
＠みほん	《見本に倣うもの》	名詞
＠みほんに	《見本に倣うもの》	名詞
＠みほんにな	《見本に倣うもの》	名詞
＠みほんになら	《見本に倣うもの》	名詞
＠みほんにならう	《見本に倣うもの》	名詞
＠みほんにならうも	《見本に倣うもの》	名詞
＠みほんにならうもの	《見本に倣うもの》	名詞
＠み	《見栄え損ない》	名詞
＠みば	《見栄え損ない》	名詞
＠みばえ	《見栄え損ない》	名詞
＠みばえぞ	《見栄え損ない》	名詞
＠みばえぞん	《見栄え損ない》	名詞
＠みばえぞんな	《見栄え損ない》	名詞
＠みばえぞんない	《見栄え損ない》	名詞
＠か	《覚醒根の精霊》	名詞
＠かく	《覚醒根の精霊》	名詞
＠かくせ	《覚醒根の精霊》	名詞
＠かくせい	《覚醒根の精霊》	名詞
＠かくせいね	《覚醒根の精霊》	名詞
＠かくせいねの	《覚醒根の精霊》	名詞
＠かくせいねのし	《覚醒根の精霊》	名詞
＠かくせいねのしょ	《覚醒根の精霊》	名詞
＠かくせいねのしょう	《覚醒根の精霊》	名詞
＠かくせいねのしょうり	《覚醒根の精霊》	名詞
＠かくせいねのしょうりょ	《覚醒根の精霊》	名詞
＠かくせいねのしょうりょう	《覚醒根の精霊》	名詞
＠と	《解き放たれた狂戦士》	名詞
＠とき	《解き放たれた狂戦士》	名詞
＠ときは	《解き放たれた狂戦士》	名詞
＠ときはな	《解き放たれた狂戦士》	名詞
＠ときはなた	《解き放たれた狂戦士》	名詞
＠ときはなたれ	《解き放たれた狂戦士》	名詞
＠ときはなたれた	《解き放たれた狂戦士》	名詞
＠ときはなたれたく	《解き放たれた狂戦士》	名詞
＠ときはなたれたくる	《解き放たれた狂戦士》	名詞
＠ときはなたれたくるい	《解き放たれた狂戦士》	名詞
＠ときはなたれたくるいせ	《解き放たれた狂戦士》	名詞
＠ときはなたれたくるいせん	《解き放たれた狂戦士》	名詞
＠ときはなたれたくるいせんし	《解き放たれた狂戦士》	名詞
＠か	《解呪》	名詞
＠かい	《解呪》	名詞
＠かいの	《解呪》	名詞
＠かいのろ	《解呪》	名詞
＠かいのろい	《解呪》	名詞
＠な	《謎かけ達人スフィンクス》	名詞
＠なぞ	《謎かけ達人スフィンクス》	名詞
＠なぞか	《謎かけ達人スフィンクス》	名詞
＠なぞかけ	《謎かけ達人スフィンクス》	名詞
＠なぞかけた	《謎かけ達人スフィンクス》	名詞
＠なぞかけたつ	《謎かけ達人スフィンクス》	名詞
＠なぞかけたつじ	《謎かけ達人スフィンクス》	名詞
＠なぞかけたつじん	《謎かけ達人スフィンクス》	名詞
＠なぞかけたつじんす	《謎かけ達人スフィンクス》	名詞
＠なぞかけたつじんすふ	《謎かけ達人スフィンクス》	名詞
＠なぞかけたつじんすふぃ	《謎かけ達人スフィンクス》	名詞
＠なぞかけたつじんすふぃん	《謎かけ達人スフィンクス》	名詞
＠なぞかけたつじんすふぃんく	《謎かけ達人スフィンクス》	名詞
＠なぞかけたつじんすふぃんくす	《謎かけ達人スフィンクス》	名詞
＠な	《謎めいた洞窟》	名詞
＠なぞ	《謎めいた洞窟》	名詞
＠なぞめ	《謎めいた洞窟》	名詞
＠なぞめい	《謎めいた洞窟》	名詞
＠なぞめいた	《謎めいた洞窟》	名詞
＠なぞめいたど	《謎めいた洞窟》	名詞
＠なぞめいたどう	《謎めいた洞窟》	名詞
＠なぞめいたどうく	《謎めいた洞窟》	名詞
＠なぞめいたどうくつ	《謎めいた洞窟》	名詞
＠ほ	《豊穣の力線》	名詞
＠ほう	《豊穣の力線》	名詞
＠ほうじ	《豊穣の力線》	名詞
＠ほうじょ	《豊穣の力線》	名詞
＠ほうじょう	《豊穣の力線》	名詞
＠ほうじょうの	《豊穣の力線》	名詞
＠ほうじょうのち	《豊穣の力線》	名詞
＠ほうじょうのちか	《豊穣の力線》	名詞
＠ほうじょうのちから	《豊穣の力線》	名詞
＠ほうじょうのちからせ	《豊穣の力線》	名詞
＠ほうじょうのちからせん	《豊穣の力線》	名詞
＠む	《貪る禿鷹》	名詞
＠むさ	《貪る禿鷹》	名詞
＠むさぼ	《貪る禿鷹》	名詞
＠むさぼる	《貪る禿鷹》	名詞
＠むさぼるは	《貪る禿鷹》	名詞
＠むさぼるはげ	《貪る禿鷹》	名詞
＠むさぼるはげた	《貪る禿鷹》	名詞
＠むさぼるはげたか	《貪る禿鷹》	名詞
＠む	《貪爪》	名詞
＠むさ	《貪爪》	名詞
＠むさぼ	《貪爪》	名詞
＠むさぼり	《貪爪》	名詞
＠むさぼりづ	《貪爪》	名詞
＠むさぼりづめ	《貪爪》	名詞
＠け	《賢者街の住人》	名詞
＠けん	《賢者街の住人》	名詞
＠けんじ	《賢者街の住人》	名詞
＠けんじゃ	《賢者街の住人》	名詞
＠けんじゃま	《賢者街の住人》	名詞
＠けんじゃまち	《賢者街の住人》	名詞
＠けんじゃまちの	《賢者街の住人》	名詞
＠けんじゃまちのじ	《賢者街の住人》	名詞
＠けんじゃまちのじゅ	《賢者街の住人》	名詞
＠けんじゃまちのじゅう	《賢者街の住人》	名詞
＠けんじゃまちのじゅうに	《賢者街の住人》	名詞
＠けんじゃまちのじゅうにん	《賢者街の住人》	名詞
＠ち	《超克》	名詞
＠ちょ	《超克》	名詞
＠ちょう	《超克》	名詞
＠ちょうこ	《超克》	名詞
＠ちょうこく	《超克》	名詞
＠ぐ	《軍団の最期》	名詞
＠ぐん	《軍団の最期》	名詞
＠ぐんだ	《軍団の最期》	名詞
＠ぐんだん	《軍団の最期》	名詞
＠ぐんだんの	《軍団の最期》	名詞
＠ぐんだんのさ	《軍団の最期》	名詞
＠ぐんだんのさい	《軍団の最期》	名詞
＠ぐんだんのさいご	《軍団の最期》	名詞
＠か	《輝き森の追跡者》	名詞
＠かが	《輝き森の追跡者》	名詞
＠かがや	《輝き森の追跡者》	名詞
＠かがやき	《輝き森の追跡者》	名詞
＠かがやきも	《輝き森の追跡者》	名詞
＠かがやきもり	《輝き森の追跡者》	名詞
＠かがやきもりの	《輝き森の追跡者》	名詞
＠かがやきもりのつ	《輝き森の追跡者》	名詞
＠かがやきもりのつい	《輝き森の追跡者》	名詞
＠かがやきもりのついせ	《輝き森の追跡者》	名詞
＠かがやきもりのついせき	《輝き森の追跡者》	名詞
＠かがやきもりのついせきし	《輝き森の追跡者》	名詞
＠かがやきもりのついせきしゃ	《輝き森の追跡者》	名詞
＠へ	《返報》	名詞
＠へん	《返報》	名詞
＠へんぽ	《返報》	名詞
＠へんぽう	《返報》	名詞
＠そ	《送還》	名詞
＠そう	《送還》	名詞
＠そうか	《送還》	名詞
＠そうかん	《送還》	名詞
＠さ	《逆毛の猪》	名詞
＠さか	《逆毛の猪》	名詞
＠さかげ	《逆毛の猪》	名詞
＠さかげの	《逆毛の猪》	名詞
＠さかげのい	《逆毛の猪》	名詞
＠さかげのいの	《逆毛の猪》	名詞
＠さかげのいのし	《逆毛の猪》	名詞
＠さかげのいのしし	《逆毛の猪》	名詞
＠は	《這い絡む火跡》	名詞
＠はい	《這い絡む火跡》	名詞
＠はいか	《這い絡む火跡》	名詞
＠はいから	《這い絡む火跡》	名詞
＠はいからむ	《這い絡む火跡》	名詞
＠はいからむひ	《這い絡む火跡》	名詞
＠はいからむひあ	《這い絡む火跡》	名詞
＠はいからむひあと	《這い絡む火跡》	名詞
＠し	《進化する未開地》	名詞
＠しん	《進化する未開地》	名詞
＠しんか	《進化する未開地》	名詞
＠しんかす	《進化する未開地》	名詞
＠しんかする	《進化する未開地》	名詞
＠しんかするみ	《進化する未開地》	名詞
＠しんかするみか	《進化する未開地》	名詞
＠しんかするみかい	《進化する未開地》	名詞
＠しんかするみかいち	《進化する未開地》	名詞
＠い	《遺跡の回収者》	名詞
＠いせ	《遺跡の回収者》	名詞
＠いせき	《遺跡の回収者》	名詞
＠いせきの	《遺跡の回収者》	名詞
＠いせきのか	《遺跡の回収者》	名詞
＠いせきのかい	《遺跡の回収者》	名詞
＠いせきのかいし	《遺跡の回収者》	名詞
＠いせきのかいしゅ	《遺跡の回収者》	名詞
＠いせきのかいしゅう	《遺跡の回収者》	名詞
＠いせきのかいしゅうし	《遺跡の回収者》	名詞
＠いせきのかいしゅうしゃ	《遺跡の回収者》	名詞
＠の	《野火の精霊》	名詞
＠のび	《野火の精霊》	名詞
＠のびの	《野火の精霊》	名詞
＠のびのし	《野火の精霊》	名詞
＠のびのしょ	《野火の精霊》	名詞
＠のびのしょう	《野火の精霊》	名詞
＠のびのしょうり	《野火の精霊》	名詞
＠のびのしょうりょ	《野火の精霊》	名詞
＠のびのしょうりょう	《野火の精霊》	名詞
＠や	《野蛮な大喰らい》	名詞
＠やば	《野蛮な大喰らい》	名詞
＠やばん	《野蛮な大喰らい》	名詞
＠やばんな	《野蛮な大喰らい》	名詞
＠やばんなだ	《野蛮な大喰らい》	名詞
＠やばんなだい	《野蛮な大喰らい》	名詞
＠やばんなだいく	《野蛮な大喰らい》	名詞
＠やばんなだいくら	《野蛮な大喰らい》	名詞
＠やばんなだいくらい	《野蛮な大喰らい》	名詞
＠か	《金床鋳込みの猛禽》	名詞
＠かな	《金床鋳込みの猛禽》	名詞
＠かなと	《金床鋳込みの猛禽》	名詞
＠かなとこ	《金床鋳込みの猛禽》	名詞
＠かなとこい	《金床鋳込みの猛禽》	名詞
＠かなとこいこ	《金床鋳込みの猛禽》	名詞
＠かなとこいこみ	《金床鋳込みの猛禽》	名詞
＠かなとこいこみの	《金床鋳込みの猛禽》	名詞
＠かなとこいこみのも	《金床鋳込みの猛禽》	名詞
＠かなとこいこみのもう	《金床鋳込みの猛禽》	名詞
＠かなとこいこみのもうき	《金床鋳込みの猛禽》	名詞
＠かなとこいこみのもうきん	《金床鋳込みの猛禽》	名詞
＠か	《金縛り》	名詞
＠かな	《金縛り》	名詞
＠かなし	《金縛り》	名詞
＠かなしば	《金縛り》	名詞
＠かなしばり	《金縛り》	名詞
＠て	《鉄根の大将軍》	名詞
＠てつ	《鉄根の大将軍》	名詞
＠てつね	《鉄根の大将軍》	名詞
＠てつねの	《鉄根の大将軍》	名詞
＠てつねのた	《鉄根の大将軍》	名詞
＠てつねのたい	《鉄根の大将軍》	名詞
＠てつねのたいし	《鉄根の大将軍》	名詞
＠てつねのたいしょ	《鉄根の大将軍》	名詞
＠てつねのたいしょう	《鉄根の大将軍》	名詞
＠てつねのたいしょうぐ	《鉄根の大将軍》	名詞
＠てつねのたいしょうぐん	《鉄根の大将軍》	名詞
＠て	《鉄覆いのクロヴァド》	名詞
＠てつ	《鉄覆いのクロヴァド》	名詞
＠てつお	《鉄覆いのクロヴァド》	名詞
＠てつおお	《鉄覆いのクロヴァド》	名詞
＠てつおおい	《鉄覆いのクロヴァド》	名詞
＠てつおおいの	《鉄覆いのクロヴァド》	名詞
＠てつおおいのく	《鉄覆いのクロヴァド》	名詞
＠てつおおいのくろ	《鉄覆いのクロヴァド》	名詞
＠てつおおいのくろう	《鉄覆いのクロヴァド》	名詞
＠てつおおいのくろヴ	《鉄覆いのクロヴァド》	名詞
＠てつおおいのくろヴぁ	《鉄覆いのクロヴァド》	名詞
＠てつおおいのくろヴぁど	《鉄覆いのクロヴァド》	名詞
＠す	《鋤引きの雄牛》	名詞
＠すき	《鋤引きの雄牛》	名詞
＠すきび	《鋤引きの雄牛》	名詞
＠すきびき	《鋤引きの雄牛》	名詞
＠すきびきの	《鋤引きの雄牛》	名詞
＠すきびきのお	《鋤引きの雄牛》	名詞
＠すきびきのおう	《鋤引きの雄牛》	名詞
＠すきびきのおうし	《鋤引きの雄牛》	名詞
＠は	《鋼の監視者》	名詞
＠はが	《鋼の監視者》	名詞
＠はがね	《鋼の監視者》	名詞
＠はがねの	《鋼の監視者》	名詞
＠はがねのか	《鋼の監視者》	名詞
＠はがねのかん	《鋼の監視者》	名詞
＠はがねのかんし	《鋼の監視者》	名詞
＠はがねのかんしし	《鋼の監視者》	名詞
＠はがねのかんししゃ	《鋼の監視者》	名詞
＠や	《闇の療法》	名詞
＠やみ	《闇の療法》	名詞
＠やみの	《闇の療法》	名詞
＠やみのり	《闇の療法》	名詞
＠やみのりょ	《闇の療法》	名詞
＠やみのりょう	《闇の療法》	名詞
＠やみのりょうほ	《闇の療法》	名詞
＠やみのりょうほう	《闇の療法》	名詞
＠い	《陰惨な鞭使い》	名詞
＠いん	《陰惨な鞭使い》	名詞
＠いんさ	《陰惨な鞭使い》	名詞
＠いんさん	《陰惨な鞭使い》	名詞
＠いんさんな	《陰惨な鞭使い》	名詞
＠いんさんなむ	《陰惨な鞭使い》	名詞
＠いんさんなむち	《陰惨な鞭使い》	名詞
＠いんさんなむちつ	《陰惨な鞭使い》	名詞
＠いんさんなむちつか	《陰惨な鞭使い》	名詞
＠いんさんなむちつかい	《陰惨な鞭使い》	名詞
＠い	《陰鬱な僻地》	名詞
＠いん	《陰鬱な僻地》	名詞
＠いんう	《陰鬱な僻地》	名詞
＠いんうつ	《陰鬱な僻地》	名詞
＠いんうつな	《陰鬱な僻地》	名詞
＠いんうつなへ	《陰鬱な僻地》	名詞
＠いんうつなへき	《陰鬱な僻地》	名詞
＠いんうつなへきち	《陰鬱な僻地》	名詞
＠い	《隕石ゴーレム》	名詞
＠いん	《隕石ゴーレム》	名詞
＠いんせ	《隕石ゴーレム》	名詞
＠いんせき	《隕石ゴーレム》	名詞
＠いんせきご	《隕石ゴーレム》	名詞
＠いんせきごー	《隕石ゴーレム》	名詞
＠いんせきごーれ	《隕石ゴーレム》	名詞
＠いんせきごーれむ	《隕石ゴーレム》	名詞
＠か	《隠された手、ケシス》	名詞
＠かく	《隠された手、ケシス》	名詞
＠かくさ	《隠された手、ケシス》	名詞
＠かくされ	《隠された手、ケシス》	名詞
＠かくされた	《隠された手、ケシス》	名詞
＠かくされたて	《隠された手、ケシス》	名詞
＠かくされたて、	《隠された手、ケシス》	名詞
＠かくされたて、け	《隠された手、ケシス》	名詞
＠かくされたて、けし	《隠された手、ケシス》	名詞
＠かくされたて、けしす	《隠された手、ケシス》	名詞
＠く	《雲族の予見者》	名詞
＠くも	《雲族の予見者》	名詞
＠くもぞ	《雲族の予見者》	名詞
＠くもぞく	《雲族の予見者》	名詞
＠くもぞくの	《雲族の予見者》	名詞
＠くもぞくのよ	《雲族の予見者》	名詞
＠くもぞくのよけ	《雲族の予見者》	名詞
＠くもぞくのよけん	《雲族の予見者》	名詞
＠くもぞくのよけんし	《雲族の予見者》	名詞
＠くもぞくのよけんしゃ	《雲族の予見者》	名詞
＠か	《雷族の呼び覚まし》	名詞
＠かみ	《雷族の呼び覚まし》	名詞
＠かみな	《雷族の呼び覚まし》	名詞
＠かみなり	《雷族の呼び覚まし》	名詞
＠かみなりぞ	《雷族の呼び覚まし》	名詞
＠かみなりぞく	《雷族の呼び覚まし》	名詞
＠かみなりぞくの	《雷族の呼び覚まし》	名詞
＠かみなりぞくのよ	《雷族の呼び覚まし》	名詞
＠かみなりぞくのよび	《雷族の呼び覚まし》	名詞
＠かみなりぞくのよびさ	《雷族の呼び覚まし》	名詞
＠かみなりぞくのよびさま	《雷族の呼び覚まし》	名詞
＠かみなりぞくのよびさまし	《雷族の呼び覚まし》	名詞
＠れ	《霊気の疾風》	名詞
＠れい	《霊気の疾風》	名詞
＠れいき	《霊気の疾風》	名詞
＠れいきの	《霊気の疾風》	名詞
＠れいきのし	《霊気の疾風》	名詞
＠れいきのしっ	《霊気の疾風》	名詞
＠れいきのしっぷ	《霊気の疾風》	名詞
＠れいきのしっぷう	《霊気の疾風》	名詞
＠し	《霜のオオヤマネコ》	名詞
＠しも	《霜のオオヤマネコ》	名詞
＠しもの	《霜のオオヤマネコ》	名詞
＠しものお	《霜のオオヤマネコ》	名詞
＠しものおお	《霜のオオヤマネコ》	名詞
＠しものおおや	《霜のオオヤマネコ》	名詞
＠しものおおやま	《霜のオオヤマネコ》	名詞
＠しものおおやまね	《霜のオオヤマネコ》	名詞
＠しものおおやまねこ	《霜のオオヤマネコ》	名詞
＠せ	《静寂の神殿》	名詞
＠せい	《静寂の神殿》	名詞
＠せいじ	《静寂の神殿》	名詞
＠せいじゃ	《静寂の神殿》	名詞
＠せいじゃく	《静寂の神殿》	名詞
＠せいじゃくの	《静寂の神殿》	名詞
＠せいじゃくのし	《静寂の神殿》	名詞
＠せいじゃくのしん	《静寂の神殿》	名詞
＠せいじゃくのしんで	《静寂の神殿》	名詞
＠せいじゃくのしんでん	《静寂の神殿》	名詞
＠ふ	《風に削られた岩山》	名詞
＠ふう	《風に削られた岩山》	名詞
＠ふうに	《風に削られた岩山》	名詞
＠ふうにけ	《風に削られた岩山》	名詞
＠ふうにけず	《風に削られた岩山》	名詞
＠ふうにけずら	《風に削られた岩山》	名詞
＠ふうにけずられ	《風に削られた岩山》	名詞
＠ふうにけずられた	《風に削られた岩山》	名詞
＠ふうにけずられたい	《風に削られた岩山》	名詞
＠ふうにけずられたいわ	《風に削られた岩山》	名詞
＠ふうにけずられたいわや	《風に削られた岩山》	名詞
＠ふうにけずられたいわやま	《風に削られた岩山》	名詞
＠ふ	《風の憤怒、カイカ》	名詞
＠ふう	《風の憤怒、カイカ》	名詞
＠ふうの	《風の憤怒、カイカ》	名詞
＠ふうのふ	《風の憤怒、カイカ》	名詞
＠ふうのふん	《風の憤怒、カイカ》	名詞
＠ふうのふんぬ	《風の憤怒、カイカ》	名詞
＠ふうのふんぬ、	《風の憤怒、カイカ》	名詞
＠ふうのふんぬ、か	《風の憤怒、カイカ》	名詞
＠ふうのふんぬ、かい	《風の憤怒、カイカ》	名詞
＠ふうのふんぬ、かいか	《風の憤怒、カイカ》	名詞
＠ふ	《風の騎兵》	名詞
＠ふう	《風の騎兵》	名詞
＠ふうの	《風の騎兵》	名詞
＠ふうのき	《風の騎兵》	名詞
＠ふうのきへ	《風の騎兵》	名詞
＠ふうのきへい	《風の騎兵》	名詞
＠の	《飲み込む噴火》	名詞
＠のみ	《飲み込む噴火》	名詞
＠のみこ	《飲み込む噴火》	名詞
＠のみこむ	《飲み込む噴火》	名詞
＠のみこむふ	《飲み込む噴火》	名詞
＠のみこむふん	《飲み込む噴火》	名詞
＠のみこむふんか	《飲み込む噴火》	名詞
＠か	《駆け回る物焦がし》	名詞
＠かけ	《駆け回る物焦がし》	名詞
＠かけま	《駆け回る物焦がし》	名詞
＠かけまわ	《駆け回る物焦がし》	名詞
＠かけまわる	《駆け回る物焦がし》	名詞
＠かけまわるも	《駆け回る物焦がし》	名詞
＠かけまわるもの	《駆け回る物焦がし》	名詞
＠かけまわるものこ	《駆け回る物焦がし》	名詞
＠かけまわるものこが	《駆け回る物焦がし》	名詞
＠かけまわるものこがし	《駆け回る物焦がし》	名詞
＠ほ	《骨の粉砕》	名詞
＠ほね	《骨の粉砕》	名詞
＠ほねの	《骨の粉砕》	名詞
＠ほねのふ	《骨の粉砕》	名詞
＠ほねのふん	《骨の粉砕》	名詞
＠ほねのふんさ	《骨の粉砕》	名詞
＠ほねのふんさい	《骨の粉砕》	名詞
＠ほ	《骨への血》	名詞
＠ほね	《骨への血》	名詞
＠ほねへ	《骨への血》	名詞
＠ほねへの	《骨への血》	名詞
＠ほねへのち	《骨への血》	名詞
＠ほ	《骨まといの屍術師》	名詞
＠ほね	《骨まといの屍術師》	名詞
＠ほねま	《骨まといの屍術師》	名詞
＠ほねまと	《骨まといの屍術師》	名詞
＠ほねまとい	《骨まといの屍術師》	名詞
＠ほねまといの	《骨まといの屍術師》	名詞
＠ほねまといのか	《骨まといの屍術師》	名詞
＠ほねまといのかば	《骨まといの屍術師》	名詞
＠ほねまといのかばね	《骨まといの屍術師》	名詞
＠ほねまといのかばねじ	《骨まといの屍術師》	名詞
＠ほねまといのかばねじゅ	《骨まといの屍術師》	名詞
＠ほねまといのかばねじゅつ	《骨まといの屍術師》	名詞
＠ほねまといのかばねじゅつし	《骨まといの屍術師》	名詞
＠ほ	《骨を灰に》	名詞
＠ほね	《骨を灰に》	名詞
＠ほねを	《骨を灰に》	名詞
＠ほねをは	《骨を灰に》	名詞
＠ほねをはい	《骨を灰に》	名詞
＠ほねをはいに	《骨を灰に》	名詞
＠が	《骸骨射手》	名詞
＠がい	《骸骨射手》	名詞
＠がいこ	《骸骨射手》	名詞
＠がいこつ	《骸骨射手》	名詞
＠がいこつし	《骸骨射手》	名詞
＠がいこつしゃ	《骸骨射手》	名詞
＠がいこつしゃし	《骸骨射手》	名詞
＠がいこつしゃしゅ	《骸骨射手》	名詞
＠た	《魂回収》	名詞
＠たま	《魂回収》	名詞
＠たまし	《魂回収》	名詞
＠たましい	《魂回収》	名詞
＠たましいか	《魂回収》	名詞
＠たましいかい	《魂回収》	名詞
＠たましいかいし	《魂回収》	名詞
＠たましいかいしゅ	《魂回収》	名詞
＠たましいかいしゅう	《魂回収》	名詞
＠た	《魂癒し人》	名詞
＠たま	《魂癒し人》	名詞
＠たまし	《魂癒し人》	名詞
＠たましい	《魂癒し人》	名詞
＠たましいい	《魂癒し人》	名詞
＠たましいいや	《魂癒し人》	名詞
＠たましいいやし	《魂癒し人》	名詞
＠たましいいやしじ	《魂癒し人》	名詞
＠たましいいやしじん	《魂癒し人》	名詞
＠う	《鱗剥ぎの捕食者》	名詞
＠うろ	《鱗剥ぎの捕食者》	名詞
＠うろこ	《鱗剥ぎの捕食者》	名詞
＠うろこへ	《鱗剥ぎの捕食者》	名詞
＠うろこへぎ	《鱗剥ぎの捕食者》	名詞
＠うろこへぎの	《鱗剥ぎの捕食者》	名詞
＠うろこへぎのほ	《鱗剥ぎの捕食者》	名詞
＠うろこへぎのほし	《鱗剥ぎの捕食者》	名詞
＠うろこへぎのほしょ	《鱗剥ぎの捕食者》	名詞
＠うろこへぎのほしょく	《鱗剥ぎの捕食者》	名詞
＠うろこへぎのほしょくし	《鱗剥ぎの捕食者》	名詞
＠うろこへぎのほしょくしゃ	《鱗剥ぎの捕食者》	名詞
＠お	《黄金のたてがみのグリフィン》	名詞
＠おう	《黄金のたてがみのグリフィン》	名詞
＠おうご	《黄金のたてがみのグリフィン》	名詞
＠おうごん	《黄金のたてがみのグリフィン》	名詞
＠おうごんの	《黄金のたてがみのグリフィン》	名詞
＠おうごんのた	《黄金のたてがみのグリフィン》	名詞
＠おうごんのたて	《黄金のたてがみのグリフィン》	名詞
＠おうごんのたてが	《黄金のたてがみのグリフィン》	名詞
＠おうごんのたてがみ	《黄金のたてがみのグリフィン》	名詞
＠おうごんのたてがみの	《黄金のたてがみのグリフィン》	名詞
＠おうごんのたてがみのぐ	《黄金のたてがみのグリフィン》	名詞
＠おうごんのたてがみのぐり	《黄金のたてがみのグリフィン》	名詞
＠おうごんのたてがみのぐりふ	《黄金のたてがみのグリフィン》	名詞
＠おうごんのたてがみのぐりふぃ	《黄金のたてがみのグリフィン》	名詞
＠おうごんのたてがみのぐりふぃん	《黄金のたてがみのグリフィン》	名詞
＠こ	《鼓舞する指導者、アジャニ》	名詞
＠こぶ	《鼓舞する指導者、アジャニ》	名詞
＠こぶす	《鼓舞する指導者、アジャニ》	名詞
＠こぶする	《鼓舞する指導者、アジャニ》	名詞
＠こぶするし	《鼓舞する指導者、アジャニ》	名詞
＠こぶするしど	《鼓舞する指導者、アジャニ》	名詞
＠こぶするしどう	《鼓舞する指導者、アジャニ》	名詞
＠こぶするしどうし	《鼓舞する指導者、アジャニ》	名詞
＠こぶするしどうしゃ	《鼓舞する指導者、アジャニ》	名詞
＠こぶするしどうしゃ、	《鼓舞する指導者、アジャニ》	名詞
＠こぶするしどうしゃ、あ	《鼓舞する指導者、アジャニ》	名詞
＠こぶするしどうしゃ、あじ	《鼓舞する指導者、アジャニ》	名詞
＠こぶするしどうしゃ、あじゃ	《鼓舞する指導者、アジャニ》	名詞
＠こぶするしどうしゃ、あじゃに	《鼓舞する指導者、アジャニ》	名詞
＠こ	《鼓舞する突撃》	名詞
＠こぶ	《鼓舞する突撃》	名詞
＠こぶす	《鼓舞する突撃》	名詞
＠こぶする	《鼓舞する突撃》	名詞
＠こぶすると	《鼓舞する突撃》	名詞
＠こぶするとつ	《鼓舞する突撃》	名詞
＠こぶするとつげ	《鼓舞する突撃》	名詞
＠こぶするとつげき	《鼓舞する突撃》	名詞
＠こ	《鼓舞する隊長》	名詞
＠こぶ	《鼓舞する隊長》	名詞
＠こぶす	《鼓舞する隊長》	名詞
＠こぶする	《鼓舞する隊長》	名詞
＠こぶするた	《鼓舞する隊長》	名詞
＠こぶするたい	《鼓舞する隊長》	名詞
＠こぶするたいち	《鼓舞する隊長》	名詞
＠こぶするたいちょ	《鼓舞する隊長》	名詞
＠こぶするたいちょう	《鼓舞する隊長》	名詞
＠り	《龍火の薬瓶》	名詞
＠りゅ	《龍火の薬瓶》	名詞
＠りゅう	《龍火の薬瓶》	名詞
＠りゅうひ	《龍火の薬瓶》	名詞
＠りゅうひの	《龍火の薬瓶》	名詞
＠りゅうひのく	《龍火の薬瓶》	名詞
＠りゅうひのくす	《龍火の薬瓶》	名詞
＠りゅうひのくすり	《龍火の薬瓶》	名詞
＠りゅうひのくすりび	《龍火の薬瓶》	名詞
＠りゅうひのくすりびん	《龍火の薬瓶》	名詞
