＠あ	《圧点》	名詞
＠あっ	《圧点》	名詞
＠あって	《圧点》	名詞
＠あってん	《圧点》	名詞
＠う	《うろつくフェリダー》	名詞
＠うろ	《うろつくフェリダー》	名詞
＠うろつ	《うろつくフェリダー》	名詞
＠うろつく	《うろつくフェリダー》	名詞
＠うろつくふ	《うろつくフェリダー》	名詞
＠うろつくふぇ	《うろつくフェリダー》	名詞
＠うろつくふぇり	《うろつくフェリダー》	名詞
＠うろつくふぇりだ	《うろつくフェリダー》	名詞
＠うろつくふぇりだー	《うろつくフェリダー》	名詞
＠え	《英雄たちの世話人》	名詞
＠えい	《英雄たちの世話人》	名詞
＠えいゆ	《英雄たちの世話人》	名詞
＠えいゆう	《英雄たちの世話人》	名詞
＠えいゆうた	《英雄たちの世話人》	名詞
＠えいゆうたち	《英雄たちの世話人》	名詞
＠えいゆうたちの	《英雄たちの世話人》	名詞
＠えいゆうたちのせ	《英雄たちの世話人》	名詞
＠えいゆうたちのせわ	《英雄たちの世話人》	名詞
＠えいゆうたちのせわに	《英雄たちの世話人》	名詞
＠えいゆうたちのせわにん	《英雄たちの世話人》	名詞
＠お	《大物潰し》	名詞
＠おお	《大物潰し》	名詞
＠おおも	《大物潰し》	名詞
＠おおもの	《大物潰し》	名詞
＠おおものつ	《大物潰し》	名詞
＠おおものつぶ	《大物潰し》	名詞
＠おおものつぶし	《大物潰し》	名詞
＠か	《解呪》	名詞
＠かい	《解呪》	名詞
＠かいじ	《解呪》	名詞
＠かいじゅ	《解呪》	名詞
＠か	《海門の旗騎士》	名詞
＠かい	《海門の旗騎士》	名詞
＠かいも	《海門の旗騎士》	名詞
＠かいもん	《海門の旗騎士》	名詞
＠かいもんの	《海門の旗騎士》	名詞
＠かいもんのは	《海門の旗騎士》	名詞
＠かいもんのはた	《海門の旗騎士》	名詞
＠かいもんのはたき	《海門の旗騎士》	名詞
＠かいもんのはたきし	《海門の旗騎士》	名詞
＠か	《カビーラの先導》	名詞
＠かび	《カビーラの先導》	名詞
＠かびー	《カビーラの先導》	名詞
＠かびーら	《カビーラの先導》	名詞
＠かびーらの	《カビーラの先導》	名詞
＠かびーらのせ	《カビーラの先導》	名詞
＠かびーらのせん	《カビーラの先導》	名詞
＠かびーらのせんど	《カビーラの先導》	名詞
＠かびーらのせんどう	《カビーラの先導》	名詞
＠が	《岸壁安息所の売剣》	名詞
＠がん	《岸壁安息所の売剣》	名詞
＠がんぺ	《岸壁安息所の売剣》	名詞
＠がんぺき	《岸壁安息所の売剣》	名詞
＠がんぺきあ	《岸壁安息所の売剣》	名詞
＠がんぺきあん	《岸壁安息所の売剣》	名詞
＠がんぺきあんそ	《岸壁安息所の売剣》	名詞
＠がんぺきあんそく	《岸壁安息所の売剣》	名詞
＠がんぺきあんそくじ	《岸壁安息所の売剣》	名詞
＠がんぺきあんそくじょ	《岸壁安息所の売剣》	名詞
＠がんぺきあんそくじょの	《岸壁安息所の売剣》	名詞
＠がんぺきあんそくじょのば	《岸壁安息所の売剣》	名詞
＠がんぺきあんそくじょのばい	《岸壁安息所の売剣》	名詞
＠がんぺきあんそくじょのばいけ	《岸壁安息所の売剣》	名詞
＠がんぺきあんそくじょのばいけん	《岸壁安息所の売剣》	名詞
＠き	《毅然たる一撃》	名詞
＠きぜ	《毅然たる一撃》	名詞
＠きぜん	《毅然たる一撃》	名詞
＠きぜんた	《毅然たる一撃》	名詞
＠きぜんたる	《毅然たる一撃》	名詞
＠きぜんたるい	《毅然たる一撃》	名詞
＠きぜんたるいち	《毅然たる一撃》	名詞
＠きぜんたるいちげ	《毅然たる一撃》	名詞
＠きぜんたるいちげき	《毅然たる一撃》	名詞
＠く	《訓練された戦術》	名詞
＠くん	《訓練された戦術》	名詞
＠くんれ	《訓練された戦術》	名詞
＠くんれん	《訓練された戦術》	名詞
＠くんれんさ	《訓練された戦術》	名詞
＠くんれんされ	《訓練された戦術》	名詞
＠くんれんされた	《訓練された戦術》	名詞
＠くんれんされたせ	《訓練された戦術》	名詞
＠くんれんされたせん	《訓練された戦術》	名詞
＠くんれんされたせんじ	《訓練された戦術》	名詞
＠くんれんされたせんじゅ	《訓練された戦術》	名詞
＠くんれんされたせんじゅつ	《訓練された戦術》	名詞
＠こ	《コーの祝賀者》	名詞
＠こー	《コーの祝賀者》	名詞
＠こーの	《コーの祝賀者》	名詞
＠こーのし	《コーの祝賀者》	名詞
＠こーのしゅ	《コーの祝賀者》	名詞
＠こーのしゅく	《コーの祝賀者》	名詞
＠こーのしゅくが	《コーの祝賀者》	名詞
＠こーのしゅくがし	《コーの祝賀者》	名詞
＠こーのしゅくがしゃ	《コーの祝賀者》	名詞
＠だ	《台地のオオヤマネコ》	名詞
＠だい	《台地のオオヤマネコ》	名詞
＠だいち	《台地のオオヤマネコ》	名詞
＠だいちの	《台地のオオヤマネコ》	名詞
＠だいちのお	《台地のオオヤマネコ》	名詞
＠だいちのおお	《台地のオオヤマネコ》	名詞
＠だいちのおおや	《台地のオオヤマネコ》	名詞
＠だいちのおおやま	《台地のオオヤマネコ》	名詞
＠だいちのおおやまね	《台地のオオヤマネコ》	名詞
＠だいちのおおやまねこ	《台地のオオヤマネコ》	名詞
＠た	《タジームの猛禽》	名詞
＠たじ	《タジームの猛禽》	名詞
＠たじー	《タジームの猛禽》	名詞
＠たじーむ	《タジームの猛禽》	名詞
＠たじーむの	《タジームの猛禽》	名詞
＠たじーむのも	《タジームの猛禽》	名詞
＠たじーむのもう	《タジームの猛禽》	名詞
＠たじーむのもうき	《タジームの猛禽》	名詞
＠たじーむのもうきん	《タジームの猛禽》	名詞
＠た	《探検隊の癒し手》	名詞
＠たん	《探検隊の癒し手》	名詞
＠たんけ	《探検隊の癒し手》	名詞
＠たんけん	《探検隊の癒し手》	名詞
＠たんけんた	《探検隊の癒し手》	名詞
＠たんけんたい	《探検隊の癒し手》	名詞
＠たんけんたいの	《探検隊の癒し手》	名詞
＠たんけんたいのい	《探検隊の癒し手》	名詞
＠たんけんたいのいや	《探検隊の癒し手》	名詞
＠たんけんたいのいやし	《探検隊の癒し手》	名詞
＠たんけんたいのいやして	《探検隊の癒し手》	名詞
＠て	《天使心の守護者》	名詞
＠てん	《天使心の守護者》	名詞
＠てんし	《天使心の守護者》	名詞
＠てんしし	《天使心の守護者》	名詞
＠てんししん	《天使心の守護者》	名詞
＠てんししんの	《天使心の守護者》	名詞
＠てんししんのし	《天使心の守護者》	名詞
＠てんししんのしゅ	《天使心の守護者》	名詞
＠てんししんのしゅご	《天使心の守護者》	名詞
＠てんししんのしゅごし	《天使心の守護者》	名詞
＠てんししんのしゅごしゃ	《天使心の守護者》	名詞
＠と	《遠見の達人》	名詞
＠とお	《遠見の達人》	名詞
＠とおみ	《遠見の達人》	名詞
＠とおみの	《遠見の達人》	名詞
＠とおみのた	《遠見の達人》	名詞
＠とおみのたつ	《遠見の達人》	名詞
＠とおみのたつじ	《遠見の達人》	名詞
＠とおみのたつじん	《遠見の達人》	名詞
＠な	《ナヒリの束縛》	名詞
＠なひ	《ナヒリの束縛》	名詞
＠なひり	《ナヒリの束縛》	名詞
＠なひりの	《ナヒリの束縛》	名詞
＠なひりのそ	《ナヒリの束縛》	名詞
＠なひりのそく	《ナヒリの束縛》	名詞
＠なひりのそくば	《ナヒリの束縛》	名詞
＠なひりのそくばく	《ナヒリの束縛》	名詞
＠ふ	《不屈の団結》	名詞
＠ふく	《不屈の団結》	名詞
＠ふくつ	《不屈の団結》	名詞
＠ふくつの	《不屈の団結》	名詞
＠ふくつのだ	《不屈の団結》	名詞
＠ふくつのだん	《不屈の団結》	名詞
＠ふくつのだんけ	《不屈の団結》	名詞
＠ふくつのだんけつ	《不屈の団結》	名詞
＠ま	《マキンディの雄牛》	名詞
＠まき	《マキンディの雄牛》	名詞
＠まきん	《マキンディの雄牛》	名詞
＠まきんで	《マキンディの雄牛》	名詞
＠まきんでぃ	《マキンディの雄牛》	名詞
＠まきんでぃの	《マキンディの雄牛》	名詞
＠まきんでぃのお	《マキンディの雄牛》	名詞
＠まきんでぃのおう	《マキンディの雄牛》	名詞
＠まきんでぃのおうし	《マキンディの雄牛》	名詞
＠え	《エメリアの隊長》	名詞
＠えめ	《エメリアの隊長》	名詞
＠えめり	《エメリアの隊長》	名詞
＠えめりあ	《エメリアの隊長》	名詞
＠えめりあの	《エメリアの隊長》	名詞
＠えめりあのた	《エメリアの隊長》	名詞
＠えめりあのたい	《エメリアの隊長》	名詞
＠えめりあのたいち	《エメリアの隊長》	名詞
＠えめりあのたいちょ	《エメリアの隊長》	名詞
＠えめりあのたいちょう	《エメリアの隊長》	名詞
＠お	《恐れなき雛》	名詞
＠おそ	《恐れなき雛》	名詞
＠おそれ	《恐れなき雛》	名詞
＠おそれな	《恐れなき雛》	名詞
＠おそれなき	《恐れなき雛》	名詞
＠おそれなきひ	《恐れなき雛》	名詞
＠おそれなきひな	《恐れなき雛》	名詞
＠か	《カビーラの叩き伏せ／カビーラの高原》	名詞
＠かび	《カビーラの叩き伏せ／カビーラの高原》	名詞
＠かびー	《カビーラの叩き伏せ／カビーラの高原》	名詞
＠かびーら	《カビーラの叩き伏せ／カビーラの高原》	名詞
＠かびーらの	《カビーラの叩き伏せ／カビーラの高原》	名詞
＠かびーらのた	《カビーラの叩き伏せ／カビーラの高原》	名詞
＠かびーらのたた	《カビーラの叩き伏せ／カビーラの高原》	名詞
＠かびーらのたたき	《カビーラの叩き伏せ／カビーラの高原》	名詞
＠かびーらのたたきふ	《カビーラの叩き伏せ／カビーラの高原》	名詞
＠かびーらのたたきふせ	《カビーラの叩き伏せ／カビーラの高原》	名詞
＠か	《カビーラの叩き伏せ／カビーラの高原》	名詞
＠かび	《カビーラの叩き伏せ／カビーラの高原》	名詞
＠かびー	《カビーラの叩き伏せ／カビーラの高原》	名詞
＠かびーら	《カビーラの叩き伏せ／カビーラの高原》	名詞
＠かびーらの	《カビーラの叩き伏せ／カビーラの高原》	名詞
＠かびーらのこ	《カビーラの叩き伏せ／カビーラの高原》	名詞
＠かびーらのこう	《カビーラの叩き伏せ／カビーラの高原》	名詞
＠かびーらのこうげ	《カビーラの叩き伏せ／カビーラの高原》	名詞
＠かびーらのこうげん	《カビーラの叩き伏せ／カビーラの高原》	名詞
＠き	《峡谷のトビネズミ》	名詞
＠きょ	《峡谷のトビネズミ》	名詞
＠きょう	《峡谷のトビネズミ》	名詞
＠きょうこ	《峡谷のトビネズミ》	名詞
＠きょうこく	《峡谷のトビネズミ》	名詞
＠きょうこくの	《峡谷のトビネズミ》	名詞
＠きょうこくのと	《峡谷のトビネズミ》	名詞
＠きょうこくのとび	《峡谷のトビネズミ》	名詞
＠きょうこくのとびね	《峡谷のトビネズミ》	名詞
＠きょうこくのとびねず	《峡谷のトビネズミ》	名詞
＠きょうこくのとびねずみ	《峡谷のトビネズミ》	名詞
＠き	《共同突撃》	名詞
＠きょ	《共同突撃》	名詞
＠きょう	《共同突撃》	名詞
＠きょうど	《共同突撃》	名詞
＠きょうどう	《共同突撃》	名詞
＠きょうどうと	《共同突撃》	名詞
＠きょうどうとつ	《共同突撃》	名詞
＠きょうどうとつげ	《共同突撃》	名詞
＠きょうどうとつげき	《共同突撃》	名詞
＠こ	《コーの刃使い》	名詞
＠こー	《コーの刃使い》	名詞
＠こーの	《コーの刃使い》	名詞
＠こーのや	《コーの刃使い》	名詞
＠こーのやい	《コーの刃使い》	名詞
＠こーのやいば	《コーの刃使い》	名詞
＠こーのやいばつ	《コーの刃使い》	名詞
＠こーのやいばつか	《コーの刃使い》	名詞
＠こーのやいばつかい	《コーの刃使い》	名詞
＠じ	《従者つきの癒し手》	名詞
＠じゅ	《従者つきの癒し手》	名詞
＠じゅう	《従者つきの癒し手》	名詞
＠じゅうし	《従者つきの癒し手》	名詞
＠じゅうしゃ	《従者つきの癒し手》	名詞
＠じゅうしゃつ	《従者つきの癒し手》	名詞
＠じゅうしゃつき	《従者つきの癒し手》	名詞
＠じゅうしゃつきの	《従者つきの癒し手》	名詞
＠じゅうしゃつきのい	《従者つきの癒し手》	名詞
＠じゅうしゃつきのいや	《従者つきの癒し手》	名詞
＠じゅうしゃつきのいやし	《従者つきの癒し手》	名詞
＠じゅうしゃつきのいやして	《従者つきの癒し手》	名詞
＠す	《スカイクレイブの僧侶／スカイクレイブの列柱廟》	名詞
＠すか	《スカイクレイブの僧侶／スカイクレイブの列柱廟》	名詞
＠すかい	《スカイクレイブの僧侶／スカイクレイブの列柱廟》	名詞
＠すかいく	《スカイクレイブの僧侶／スカイクレイブの列柱廟》	名詞
＠すかいくれ	《スカイクレイブの僧侶／スカイクレイブの列柱廟》	名詞
＠すかいくれい	《スカイクレイブの僧侶／スカイクレイブの列柱廟》	名詞
＠すかいくれいぶ	《スカイクレイブの僧侶／スカイクレイブの列柱廟》	名詞
＠すかいくれいぶの	《スカイクレイブの僧侶／スカイクレイブの列柱廟》	名詞
＠すかいくれいぶのそ	《スカイクレイブの僧侶／スカイクレイブの列柱廟》	名詞
＠すかいくれいぶのそう	《スカイクレイブの僧侶／スカイクレイブの列柱廟》	名詞
＠すかいくれいぶのそうり	《スカイクレイブの僧侶／スカイクレイブの列柱廟》	名詞
＠すかいくれいぶのそうりょ	《スカイクレイブの僧侶／スカイクレイブの列柱廟》	名詞
＠す	《スカイクレイブの僧侶／スカイクレイブの列柱廟》	名詞
＠すか	《スカイクレイブの僧侶／スカイクレイブの列柱廟》	名詞
＠すかい	《スカイクレイブの僧侶／スカイクレイブの列柱廟》	名詞
＠すかいく	《スカイクレイブの僧侶／スカイクレイブの列柱廟》	名詞
＠すかいくれ	《スカイクレイブの僧侶／スカイクレイブの列柱廟》	名詞
＠すかいくれい	《スカイクレイブの僧侶／スカイクレイブの列柱廟》	名詞
＠すかいくれいぶ	《スカイクレイブの僧侶／スカイクレイブの列柱廟》	名詞
＠すかいくれいぶの	《スカイクレイブの僧侶／スカイクレイブの列柱廟》	名詞
＠すかいくれいぶのれ	《スカイクレイブの僧侶／スカイクレイブの列柱廟》	名詞
＠すかいくれいぶのれっ	《スカイクレイブの僧侶／スカイクレイブの列柱廟》	名詞
＠すかいくれいぶのれっち	《スカイクレイブの僧侶／スカイクレイブの列柱廟》	名詞
＠すかいくれいぶのれっちゅ	《スカイクレイブの僧侶／スカイクレイブの列柱廟》	名詞
＠すかいくれいぶのれっちゅう	《スカイクレイブの僧侶／スカイクレイブの列柱廟》	名詞
＠すかいくれいぶのれっちゅうび	《スカイクレイブの僧侶／スカイクレイブの列柱廟》	名詞
＠すかいくれいぶのれっちゅうびょ	《スカイクレイブの僧侶／スカイクレイブの列柱廟》	名詞
＠すかいくれいぶのれっちゅうびょう	《スカイクレイブの僧侶／スカイクレイブの列柱廟》	名詞
＠せ	《セジーリの防護／セジーリの氷河》	名詞
＠せじ	《セジーリの防護／セジーリの氷河》	名詞
＠せじー	《セジーリの防護／セジーリの氷河》	名詞
＠せじーり	《セジーリの防護／セジーリの氷河》	名詞
＠せじーりの	《セジーリの防護／セジーリの氷河》	名詞
＠せじーりのぼ	《セジーリの防護／セジーリの氷河》	名詞
＠せじーりのぼう	《セジーリの防護／セジーリの氷河》	名詞
＠せじーりのぼうご	《セジーリの防護／セジーリの氷河》	名詞
＠せ	《セジーリの防護／セジーリの氷河》	名詞
＠せじ	《セジーリの防護／セジーリの氷河》	名詞
＠せじー	《セジーリの防護／セジーリの氷河》	名詞
＠せじーり	《セジーリの防護／セジーリの氷河》	名詞
＠せじーりの	《セジーリの防護／セジーリの氷河》	名詞
＠せじーりのひ	《セジーリの防護／セジーリの氷河》	名詞
＠せじーりのひょ	《セジーリの防護／セジーリの氷河》	名詞
＠せじーりのひょう	《セジーリの防護／セジーリの氷河》	名詞
＠せじーりのひょうが	《セジーリの防護／セジーリの氷河》	名詞
＠ふ	《二人組の戦術家》	名詞
＠ふた	《二人組の戦術家》	名詞
＠ふたり	《二人組の戦術家》	名詞
＠ふたりぐ	《二人組の戦術家》	名詞
＠ふたりぐみ	《二人組の戦術家》	名詞
＠ふたりぐみの	《二人組の戦術家》	名詞
＠ふたりぐみのせ	《二人組の戦術家》	名詞
＠ふたりぐみのせん	《二人組の戦術家》	名詞
＠ふたりぐみのせんじ	《二人組の戦術家》	名詞
＠ふたりぐみのせんじゅ	《二人組の戦術家》	名詞
＠ふたりぐみのせんじゅつ	《二人組の戦術家》	名詞
＠ふたりぐみのせんじゅつか	《二人組の戦術家》	名詞
＠ぼ	《忘却への旅》	名詞
＠ぼう	《忘却への旅》	名詞
＠ぼうき	《忘却への旅》	名詞
＠ぼうきゃ	《忘却への旅》	名詞
＠ぼうきゃく	《忘却への旅》	名詞
＠ぼうきゃくへ	《忘却への旅》	名詞
＠ぼうきゃくへの	《忘却への旅》	名詞
＠ぼうきゃくへのた	《忘却への旅》	名詞
＠ぼうきゃくへのたび	《忘却への旅》	名詞
＠ほ	《帆凧の僧侶》	名詞
＠ほだ	《帆凧の僧侶》	名詞
＠ほだこ	《帆凧の僧侶》	名詞
＠ほだこの	《帆凧の僧侶》	名詞
＠ほだこのそ	《帆凧の僧侶》	名詞
＠ほだこのそう	《帆凧の僧侶》	名詞
＠ほだこのそうり	《帆凧の僧侶》	名詞
＠ほだこのそうりょ	《帆凧の僧侶》	名詞
＠ま	《マキンディの暴走／マキンディの台地》	名詞
＠まき	《マキンディの暴走／マキンディの台地》	名詞
＠まきん	《マキンディの暴走／マキンディの台地》	名詞
＠まきんで	《マキンディの暴走／マキンディの台地》	名詞
＠まきんでぃ	《マキンディの暴走／マキンディの台地》	名詞
＠まきんでぃの	《マキンディの暴走／マキンディの台地》	名詞
＠まきんでぃのぼ	《マキンディの暴走／マキンディの台地》	名詞
＠まきんでぃのぼう	《マキンディの暴走／マキンディの台地》	名詞
＠まきんでぃのぼうそ	《マキンディの暴走／マキンディの台地》	名詞
＠まきんでぃのぼうそう	《マキンディの暴走／マキンディの台地》	名詞
＠ま	《マキンディの暴走／マキンディの台地》	名詞
＠まき	《マキンディの暴走／マキンディの台地》	名詞
＠まきん	《マキンディの暴走／マキンディの台地》	名詞
＠まきんで	《マキンディの暴走／マキンディの台地》	名詞
＠まきんでぃ	《マキンディの暴走／マキンディの台地》	名詞
＠まきんでぃの	《マキンディの暴走／マキンディの台地》	名詞
＠まきんでぃのだ	《マキンディの暴走／マキンディの台地》	名詞
＠まきんでぃのだい	《マキンディの暴走／マキンディの台地》	名詞
＠まきんでぃのだいち	《マキンディの暴走／マキンディの台地》	名詞
＠い	《イオナの大司祭》	名詞
＠いお	《イオナの大司祭》	名詞
＠いおな	《イオナの大司祭》	名詞
＠いおなの	《イオナの大司祭》	名詞
＠いおなのだ	《イオナの大司祭》	名詞
＠いおなのだい	《イオナの大司祭》	名詞
＠いおなのだいし	《イオナの大司祭》	名詞
＠いおなのだいしさ	《イオナの大司祭》	名詞
＠いおなのだいしさい	《イオナの大司祭》	名詞
＠え	《エメリアのアルコン》	名詞
＠えめ	《エメリアのアルコン》	名詞
＠えめり	《エメリアのアルコン》	名詞
＠えめりあ	《エメリアのアルコン》	名詞
＠えめりあの	《エメリアのアルコン》	名詞
＠えめりあのあ	《エメリアのアルコン》	名詞
＠えめりあのある	《エメリアのアルコン》	名詞
＠えめりあのあるこ	《エメリアのアルコン》	名詞
＠えめりあのあるこん	《エメリアのアルコン》	名詞
＠お	《オンドゥの転置／オンドゥの空遺跡》	名詞
＠おん	《オンドゥの転置／オンドゥの空遺跡》	名詞
＠おんど	《オンドゥの転置／オンドゥの空遺跡》	名詞
＠おんどぅ	《オンドゥの転置／オンドゥの空遺跡》	名詞
＠おんどぅの	《オンドゥの転置／オンドゥの空遺跡》	名詞
＠おんどぅのて	《オンドゥの転置／オンドゥの空遺跡》	名詞
＠おんどぅのてん	《オンドゥの転置／オンドゥの空遺跡》	名詞
＠おんどぅのてんち	《オンドゥの転置／オンドゥの空遺跡》	名詞
＠お	《オンドゥの転置／オンドゥの空遺跡》	名詞
＠おん	《オンドゥの転置／オンドゥの空遺跡》	名詞
＠おんど	《オンドゥの転置／オンドゥの空遺跡》	名詞
＠おんどぅ	《オンドゥの転置／オンドゥの空遺跡》	名詞
＠おんどぅの	《オンドゥの転置／オンドゥの空遺跡》	名詞
＠おんどぅのそ	《オンドゥの転置／オンドゥの空遺跡》	名詞
＠おんどぅのそら	《オンドゥの転置／オンドゥの空遺跡》	名詞
＠おんどぅのそらい	《オンドゥの転置／オンドゥの空遺跡》	名詞
＠おんどぅのそらいせ	《オンドゥの転置／オンドゥの空遺跡》	名詞
＠おんどぅのそらいせき	《オンドゥの転置／オンドゥの空遺跡》	名詞
＠ぐ	《軍団の天使》	名詞
＠ぐん	《軍団の天使》	名詞
＠ぐんだ	《軍団の天使》	名詞
＠ぐんだん	《軍団の天使》	名詞
＠ぐんだんの	《軍団の天使》	名詞
＠ぐんだんのて	《軍団の天使》	名詞
＠ぐんだんのてん	《軍団の天使》	名詞
＠ぐんだんのてんし	《軍団の天使》	名詞
＠こ	《光輝王の野心家》	名詞
＠こう	《光輝王の野心家》	名詞
＠こうき	《光輝王の野心家》	名詞
＠こうきお	《光輝王の野心家》	名詞
＠こうきおう	《光輝王の野心家》	名詞
＠こうきおうの	《光輝王の野心家》	名詞
＠こうきおうのや	《光輝王の野心家》	名詞
＠こうきおうのやし	《光輝王の野心家》	名詞
＠こうきおうのやしん	《光輝王の野心家》	名詞
＠こうきおうのやしんか	《光輝王の野心家》	名詞
＠す	《スカイクレイブの大鎚》	名詞
＠すか	《スカイクレイブの大鎚》	名詞
＠すかい	《スカイクレイブの大鎚》	名詞
＠すかいく	《スカイクレイブの大鎚》	名詞
＠すかいくれ	《スカイクレイブの大鎚》	名詞
＠すかいくれい	《スカイクレイブの大鎚》	名詞
＠すかいくれいぶ	《スカイクレイブの大鎚》	名詞
＠すかいくれいぶの	《スカイクレイブの大鎚》	名詞
＠すかいくれいぶのだ	《スカイクレイブの大鎚》	名詞
＠すかいくれいぶのだい	《スカイクレイブの大鎚》	名詞
＠すかいくれいぶのだいつ	《スカイクレイブの大鎚》	名詞
＠すかいくれいぶのだいつち	《スカイクレイブの大鎚》	名詞
＠す	《スカイクレイブの亡霊》	名詞
＠すか	《スカイクレイブの亡霊》	名詞
＠すかい	《スカイクレイブの亡霊》	名詞
＠すかいく	《スカイクレイブの亡霊》	名詞
＠すかいくれ	《スカイクレイブの亡霊》	名詞
＠すかいくれい	《スカイクレイブの亡霊》	名詞
＠すかいくれいぶ	《スカイクレイブの亡霊》	名詞
＠すかいくれいぶの	《スカイクレイブの亡霊》	名詞
＠すかいくれいぶのぼ	《スカイクレイブの亡霊》	名詞
＠すかいくれいぶのぼう	《スカイクレイブの亡霊》	名詞
＠すかいくれいぶのぼうれ	《スカイクレイブの亡霊》	名詞
＠すかいくれいぶのぼうれい	《スカイクレイブの亡霊》	名詞
＠ふ	《フェリダーの撤退》	名詞
＠ふぇ	《フェリダーの撤退》	名詞
＠ふぇり	《フェリダーの撤退》	名詞
＠ふぇりだ	《フェリダーの撤退》	名詞
＠ふぇりだー	《フェリダーの撤退》	名詞
＠ふぇりだーの	《フェリダーの撤退》	名詞
＠ふぇりだーのて	《フェリダーの撤退》	名詞
＠ふぇりだーのてっ	《フェリダーの撤退》	名詞
＠ふぇりだーのてった	《フェリダーの撤退》	名詞
＠ふぇりだーのてったい	《フェリダーの撤退》	名詞
＠へ	《兵団の統率者》	名詞
＠へい	《兵団の統率者》	名詞
＠へいだ	《兵団の統率者》	名詞
＠へいだん	《兵団の統率者》	名詞
＠へいだんの	《兵団の統率者》	名詞
＠へいだんのと	《兵団の統率者》	名詞
＠へいだんのとう	《兵団の統率者》	名詞
＠へいだんのとうそ	《兵団の統率者》	名詞
＠へいだんのとうそつ	《兵団の統率者》	名詞
＠へいだんのとうそつし	《兵団の統率者》	名詞
＠へいだんのとうそつしゃ	《兵団の統率者》	名詞
＠う	《運命の天使》	名詞
＠うん	《運命の天使》	名詞
＠うんめ	《運命の天使》	名詞
＠うんめい	《運命の天使》	名詞
＠うんめいの	《運命の天使》	名詞
＠うんめいのて	《運命の天使》	名詞
＠うんめいのてん	《運命の天使》	名詞
＠うんめいのてんし	《運命の天使》	名詞
＠え	《エメリアの呼び声／砕け散ったスカイクレイブ、エメリア》	名詞
＠えめ	《エメリアの呼び声／砕け散ったスカイクレイブ、エメリア》	名詞
＠えめり	《エメリアの呼び声／砕け散ったスカイクレイブ、エメリア》	名詞
＠えめりあ	《エメリアの呼び声／砕け散ったスカイクレイブ、エメリア》	名詞
＠えめりあの	《エメリアの呼び声／砕け散ったスカイクレイブ、エメリア》	名詞
＠えめりあのよ	《エメリアの呼び声／砕け散ったスカイクレイブ、エメリア》	名詞
＠えめりあのよび	《エメリアの呼び声／砕け散ったスカイクレイブ、エメリア》	名詞
＠えめりあのよびご	《エメリアの呼び声／砕け散ったスカイクレイブ、エメリア》	名詞
＠えめりあのよびごえ	《エメリアの呼び声／砕け散ったスカイクレイブ、エメリア》	名詞
＠く	《エメリアの呼び声／砕け散ったスカイクレイブ、エメリア》	名詞
＠くだ	《エメリアの呼び声／砕け散ったスカイクレイブ、エメリア》	名詞
＠くだけ	《エメリアの呼び声／砕け散ったスカイクレイブ、エメリア》	名詞
＠くだけち	《エメリアの呼び声／砕け散ったスカイクレイブ、エメリア》	名詞
＠くだけちっ	《エメリアの呼び声／砕け散ったスカイクレイブ、エメリア》	名詞
＠くだけちった	《エメリアの呼び声／砕け散ったスカイクレイブ、エメリア》	名詞
＠くだけちったす	《エメリアの呼び声／砕け散ったスカイクレイブ、エメリア》	名詞
＠くだけちったすか	《エメリアの呼び声／砕け散ったスカイクレイブ、エメリア》	名詞
＠くだけちったすかい	《エメリアの呼び声／砕け散ったスカイクレイブ、エメリア》	名詞
＠くだけちったすかいく	《エメリアの呼び声／砕け散ったスカイクレイブ、エメリア》	名詞
＠くだけちったすかいくれ	《エメリアの呼び声／砕け散ったスカイクレイブ、エメリア》	名詞
＠くだけちったすかいくれい	《エメリアの呼び声／砕け散ったスカイクレイブ、エメリア》	名詞
＠くだけちったすかいくれいぶ	《エメリアの呼び声／砕け散ったスカイクレイブ、エメリア》	名詞
＠くだけちったすかいくれいぶ、	《エメリアの呼び声／砕け散ったスカイクレイブ、エメリア》	名詞
＠くだけちったすかいくれいぶ、え	《エメリアの呼び声／砕け散ったスカイクレイブ、エメリア》	名詞
＠くだけちったすかいくれいぶ、えめ	《エメリアの呼び声／砕け散ったスカイクレイブ、エメリア》	名詞
＠くだけちったすかいくれいぶ、えめり	《エメリアの呼び声／砕け散ったスカイクレイブ、エメリア》	名詞
＠くだけちったすかいくれいぶ、えめりあ	《エメリアの呼び声／砕け散ったスカイクレイブ、エメリア》	名詞
＠だ	《団結の標、タズリ》	名詞
＠だん	《団結の標、タズリ》	名詞
＠だんけ	《団結の標、タズリ》	名詞
＠だんけつ	《団結の標、タズリ》	名詞
＠だんけつの	《団結の標、タズリ》	名詞
＠だんけつのし	《団結の標、タズリ》	名詞
＠だんけつのしる	《団結の標、タズリ》	名詞
＠だんけつのしるべ	《団結の標、タズリ》	名詞
＠だんけつのしるべ、	《団結の標、タズリ》	名詞
＠た	《団結の標、タズリ》	名詞
＠たず	《団結の標、タズリ》	名詞
＠たずり	《団結の標、タズリ》	名詞
＠い	《生ける嵐》	名詞
＠いけ	《生ける嵐》	名詞
＠いける	《生ける嵐》	名詞
＠いけるあ	《生ける嵐》	名詞
＠いけるあら	《生ける嵐》	名詞
＠いけるあらし	《生ける嵐》	名詞
＠あ	《泡の罠》	名詞
＠あわ	《泡の罠》	名詞
＠あわの	《泡の罠》	名詞
＠あわのわ	《泡の罠》	名詞
＠あわのわな	《泡の罠》	名詞
＠か	《海底の忍び寄り》	名詞
＠かい	《海底の忍び寄り》	名詞
＠かいて	《海底の忍び寄り》	名詞
＠かいてい	《海底の忍び寄り》	名詞
＠かいていの	《海底の忍び寄り》	名詞
＠かいていのし	《海底の忍び寄り》	名詞
＠かいていのしの	《海底の忍び寄り》	名詞
＠かいていのしのび	《海底の忍び寄り》	名詞
＠かいていのしのびよ	《海底の忍び寄り》	名詞
＠かいていのしのびより	《海底の忍び寄り》	名詞
＠こ	《狡猾な泉魔道士》	名詞
＠こう	《狡猾な泉魔道士》	名詞
＠こうか	《狡猾な泉魔道士》	名詞
＠こうかつ	《狡猾な泉魔道士》	名詞
＠こうかつな	《狡猾な泉魔道士》	名詞
＠こうかつない	《狡猾な泉魔道士》	名詞
＠こうかつないず	《狡猾な泉魔道士》	名詞
＠こうかつないずみ	《狡猾な泉魔道士》	名詞
＠こうかつないずみま	《狡猾な泉魔道士》	名詞
＠こうかつないずみまど	《狡猾な泉魔道士》	名詞
＠こうかつないずみまどう	《狡猾な泉魔道士》	名詞
＠こうかつないずみまどうし	《狡猾な泉魔道士》	名詞
＠こ	《甲羅の盾》	名詞
＠こう	《甲羅の盾》	名詞
＠こうら	《甲羅の盾》	名詞
＠こうらの	《甲羅の盾》	名詞
＠こうらのた	《甲羅の盾》	名詞
＠こうらのたて	《甲羅の盾》	名詞
＠こ	《凍える罠》	名詞
＠こご	《凍える罠》	名詞
＠こごえ	《凍える罠》	名詞
＠こごえる	《凍える罠》	名詞
＠こごえるわ	《凍える罠》	名詞
＠こごえるわな	《凍える罠》	名詞
＠じ	《実地研究》	名詞
＠じっ	《実地研究》	名詞
＠じっち	《実地研究》	名詞
＠じっちけ	《実地研究》	名詞
＠じっちけん	《実地研究》	名詞
＠じっちけんき	《実地研究》	名詞
＠じっちけんきゅ	《実地研究》	名詞
＠じっちけんきゅう	《実地研究》	名詞
＠じ	《熟考》	名詞
＠じゅ	《熟考》	名詞
＠じゅっ	《熟考》	名詞
＠じゅっこ	《熟考》	名詞
＠じゅっこう	《熟考》	名詞
＠ず	《ズーラポートの決闘者》	名詞
＠ずー	《ズーラポートの決闘者》	名詞
＠ずーら	《ズーラポートの決闘者》	名詞
＠ずーらぽ	《ズーラポートの決闘者》	名詞
＠ずーらぽー	《ズーラポートの決闘者》	名詞
＠ずーらぽーと	《ズーラポートの決闘者》	名詞
＠ずーらぽーとの	《ズーラポートの決闘者》	名詞
＠ずーらぽーとのけ	《ズーラポートの決闘者》	名詞
＠ずーらぽーとのけっ	《ズーラポートの決闘者》	名詞
＠ずーらぽーとのけっと	《ズーラポートの決闘者》	名詞
＠ずーらぽーとのけっとう	《ズーラポートの決闘者》	名詞
＠ずーらぽーとのけっとうし	《ズーラポートの決闘者》	名詞
＠ずーらぽーとのけっとうしゃ	《ズーラポートの決闘者》	名詞
＠す	《スカイクレイブのイカ》	名詞
＠すか	《スカイクレイブのイカ》	名詞
＠すかい	《スカイクレイブのイカ》	名詞
＠すかいく	《スカイクレイブのイカ》	名詞
＠すかいくれ	《スカイクレイブのイカ》	名詞
＠すかいくれい	《スカイクレイブのイカ》	名詞
＠すかいくれいぶ	《スカイクレイブのイカ》	名詞
＠すかいくれいぶの	《スカイクレイブのイカ》	名詞
＠すかいくれいぶのい	《スカイクレイブのイカ》	名詞
＠すかいくれいぶのいか	《スカイクレイブのイカ》	名詞
＠た	《滝の予見者》	名詞
＠たき	《滝の予見者》	名詞
＠たきの	《滝の予見者》	名詞
＠たきのよ	《滝の予見者》	名詞
＠たきのよけ	《滝の予見者》	名詞
＠たきのよけん	《滝の予見者》	名詞
＠たきのよけんし	《滝の予見者》	名詞
＠たきのよけんしゃ	《滝の予見者》	名詞
＠た	《タジームの乱動魔道士》	名詞
＠たじ	《タジームの乱動魔道士》	名詞
＠たじー	《タジームの乱動魔道士》	名詞
＠たじーむ	《タジームの乱動魔道士》	名詞
＠たじーむの	《タジームの乱動魔道士》	名詞
＠たじーむのら	《タジームの乱動魔道士》	名詞
＠たじーむのらん	《タジームの乱動魔道士》	名詞
＠たじーむのらんど	《タジームの乱動魔道士》	名詞
＠たじーむのらんどう	《タジームの乱動魔道士》	名詞
＠たじーむのらんどうま	《タジームの乱動魔道士》	名詞
＠たじーむのらんどうまど	《タジームの乱動魔道士》	名詞
＠たじーむのらんどうまどう	《タジームの乱動魔道士》	名詞
＠たじーむのらんどうまどうし	《タジームの乱動魔道士》	名詞
＠た	《探検隊の占者》	名詞
＠たん	《探検隊の占者》	名詞
＠たんけ	《探検隊の占者》	名詞
＠たんけん	《探検隊の占者》	名詞
＠たんけんた	《探検隊の占者》	名詞
＠たんけんたい	《探検隊の占者》	名詞
＠たんけんたいの	《探検隊の占者》	名詞
＠たんけんたいのせ	《探検隊の占者》	名詞
＠たんけんたいのせん	《探検隊の占者》	名詞
＠たんけんたいのせんじ	《探検隊の占者》	名詞
＠たんけんたいのせんじゃ	《探検隊の占者》	名詞
＠つ	《冷たき深淵の僧侶》	名詞
＠つめ	《冷たき深淵の僧侶》	名詞
＠つめた	《冷たき深淵の僧侶》	名詞
＠つめたき	《冷たき深淵の僧侶》	名詞
＠つめたきし	《冷たき深淵の僧侶》	名詞
＠つめたきしん	《冷たき深淵の僧侶》	名詞
＠つめたきしんえ	《冷たき深淵の僧侶》	名詞
＠つめたきしんえん	《冷たき深淵の僧侶》	名詞
＠つめたきしんえんの	《冷たき深淵の僧侶》	名詞
＠つめたきしんえんのそ	《冷たき深淵の僧侶》	名詞
＠つめたきしんえんのそう	《冷たき深淵の僧侶》	名詞
＠つめたきしんえんのそうり	《冷たき深淵の僧侶》	名詞
＠つめたきしんえんのそうりょ	《冷たき深淵の僧侶》	名詞
＠に	《認識否定》	名詞
＠にん	《認識否定》	名詞
＠にんし	《認識否定》	名詞
＠にんしき	《認識否定》	名詞
＠にんしきひ	《認識否定》	名詞
＠にんしきひて	《認識否定》	名詞
＠にんしきひてい	《認識否定》	名詞
＠ひ	《否認》	名詞
＠ひに	《否認》	名詞
＠ひにん	《否認》	名詞
＠ひ	《氷河の掌握》	名詞
＠ひょ	《氷河の掌握》	名詞
＠ひょう	《氷河の掌握》	名詞
＠ひょうが	《氷河の掌握》	名詞
＠ひょうがの	《氷河の掌握》	名詞
＠ひょうがのし	《氷河の掌握》	名詞
＠ひょうがのしょ	《氷河の掌握》	名詞
＠ひょうがのしょう	《氷河の掌握》	名詞
＠ひょうがのしょうあ	《氷河の掌握》	名詞
＠ひょうがのしょうあく	《氷河の掌握》	名詞
＠め	《目覚めし激浪》	名詞
＠めざ	《目覚めし激浪》	名詞
＠めざめ	《目覚めし激浪》	名詞
＠めざめし	《目覚めし激浪》	名詞
＠めざめしげ	《目覚めし激浪》	名詞
＠めざめしげき	《目覚めし激浪》	名詞
＠めざめしげきろ	《目覚めし激浪》	名詞
＠めざめしげきろう	《目覚めし激浪》	名詞
＠ら	《乱動への突入》	名詞
＠らん	《乱動への突入》	名詞
＠らんど	《乱動への突入》	名詞
＠らんどう	《乱動への突入》	名詞
＠らんどうへ	《乱動への突入》	名詞
＠らんどうへの	《乱動への突入》	名詞
＠らんどうへのと	《乱動への突入》	名詞
＠らんどうへのとつ	《乱動への突入》	名詞
＠らんどうへのとつに	《乱動への突入》	名詞
＠らんどうへのとつにゅ	《乱動への突入》	名詞
＠らんどうへのとつにゅう	《乱動への突入》	名詞
＠い	《遺跡ガニ》	名詞
＠いせ	《遺跡ガニ》	名詞
＠いせき	《遺跡ガニ》	名詞
＠いせきが	《遺跡ガニ》	名詞
＠いせきがに	《遺跡ガニ》	名詞
＠い	《一枚岩の防衛》	名詞
＠いち	《一枚岩の防衛》	名詞
＠いちま	《一枚岩の防衛》	名詞
＠いちまい	《一枚岩の防衛》	名詞
＠いちまいい	《一枚岩の防衛》	名詞
＠いちまいいわ	《一枚岩の防衛》	名詞
＠いちまいいわの	《一枚岩の防衛》	名詞
＠いちまいいわのぼ	《一枚岩の防衛》	名詞
＠いちまいいわのぼう	《一枚岩の防衛》	名詞
＠いちまいいわのぼうえ	《一枚岩の防衛》	名詞
＠いちまいいわのぼうえい	《一枚岩の防衛》	名詞
＠う	《ウマーラの魔術師／ウマーラの空滝》	名詞
＠うま	《ウマーラの魔術師／ウマーラの空滝》	名詞
＠うまー	《ウマーラの魔術師／ウマーラの空滝》	名詞
＠うまーら	《ウマーラの魔術師／ウマーラの空滝》	名詞
＠うまーらの	《ウマーラの魔術師／ウマーラの空滝》	名詞
＠うまーらのま	《ウマーラの魔術師／ウマーラの空滝》	名詞
＠うまーらのまじ	《ウマーラの魔術師／ウマーラの空滝》	名詞
＠うまーらのまじゅ	《ウマーラの魔術師／ウマーラの空滝》	名詞
＠うまーらのまじゅつ	《ウマーラの魔術師／ウマーラの空滝》	名詞
＠うまーらのまじゅつし	《ウマーラの魔術師／ウマーラの空滝》	名詞
＠う	《ウマーラの魔術師／ウマーラの空滝》	名詞
＠うま	《ウマーラの魔術師／ウマーラの空滝》	名詞
＠うまー	《ウマーラの魔術師／ウマーラの空滝》	名詞
＠うまーら	《ウマーラの魔術師／ウマーラの空滝》	名詞
＠うまーらの	《ウマーラの魔術師／ウマーラの空滝》	名詞
＠うまーらのそ	《ウマーラの魔術師／ウマーラの空滝》	名詞
＠うまーらのそら	《ウマーラの魔術師／ウマーラの空滝》	名詞
＠うまーらのそらた	《ウマーラの魔術師／ウマーラの空滝》	名詞
＠うまーらのそらたき	《ウマーラの魔術師／ウマーラの空滝》	名詞
＠か	《確実な潜入者》	名詞
＠かく	《確実な潜入者》	名詞
＠かくじ	《確実な潜入者》	名詞
＠かくじつ	《確実な潜入者》	名詞
＠かくじつな	《確実な潜入者》	名詞
＠かくじつなせ	《確実な潜入者》	名詞
＠かくじつなせん	《確実な潜入者》	名詞
＠かくじつなせんに	《確実な潜入者》	名詞
＠かくじつなせんにゅ	《確実な潜入者》	名詞
＠かくじつなせんにゅう	《確実な潜入者》	名詞
＠かくじつなせんにゅうし	《確実な潜入者》	名詞
＠かくじつなせんにゅうしゃ	《確実な潜入者》	名詞
＠か	《風乗りの魔術師》	名詞
＠かぜ	《風乗りの魔術師》	名詞
＠かぜの	《風乗りの魔術師》	名詞
＠かぜのり	《風乗りの魔術師》	名詞
＠かぜのりの	《風乗りの魔術師》	名詞
＠かぜのりのま	《風乗りの魔術師》	名詞
＠かぜのりのまじ	《風乗りの魔術師》	名詞
＠かぜのりのまじゅ	《風乗りの魔術師》	名詞
＠かぜのりのまじゅつ	《風乗りの魔術師》	名詞
＠かぜのりのまじゅつし	《風乗りの魔術師》	名詞
＠じ	《ジュワー島の撹乱／ジュワー島の遺跡》	名詞
＠じゅ	《ジュワー島の撹乱／ジュワー島の遺跡》	名詞
＠じゅわ	《ジュワー島の撹乱／ジュワー島の遺跡》	名詞
＠じゅわー	《ジュワー島の撹乱／ジュワー島の遺跡》	名詞
＠じゅわーと	《ジュワー島の撹乱／ジュワー島の遺跡》	名詞
＠じゅわーとう	《ジュワー島の撹乱／ジュワー島の遺跡》	名詞
＠じゅわーとうの	《ジュワー島の撹乱／ジュワー島の遺跡》	名詞
＠じゅわーとうのか	《ジュワー島の撹乱／ジュワー島の遺跡》	名詞
＠じゅわーとうのかく	《ジュワー島の撹乱／ジュワー島の遺跡》	名詞
＠じゅわーとうのかくら	《ジュワー島の撹乱／ジュワー島の遺跡》	名詞
＠じゅわーとうのかくらん	《ジュワー島の撹乱／ジュワー島の遺跡》	名詞
＠じ	《ジュワー島の撹乱／ジュワー島の遺跡》	名詞
＠じゅ	《ジュワー島の撹乱／ジュワー島の遺跡》	名詞
＠じゅわ	《ジュワー島の撹乱／ジュワー島の遺跡》	名詞
＠じゅわー	《ジュワー島の撹乱／ジュワー島の遺跡》	名詞
＠じゅわーと	《ジュワー島の撹乱／ジュワー島の遺跡》	名詞
＠じゅわーとう	《ジュワー島の撹乱／ジュワー島の遺跡》	名詞
＠じゅわーとうの	《ジュワー島の撹乱／ジュワー島の遺跡》	名詞
＠じゅわーとうのい	《ジュワー島の撹乱／ジュワー島の遺跡》	名詞
＠じゅわーとうのいせ	《ジュワー島の撹乱／ジュワー島の遺跡》	名詞
＠じゅわーとうのいせき	《ジュワー島の撹乱／ジュワー島の遺跡》	名詞
＠し	《シルンディの幻視／シルンディの島嶼》	名詞
＠しる	《シルンディの幻視／シルンディの島嶼》	名詞
＠しるん	《シルンディの幻視／シルンディの島嶼》	名詞
＠しるんで	《シルンディの幻視／シルンディの島嶼》	名詞
＠しるんでぃ	《シルンディの幻視／シルンディの島嶼》	名詞
＠しるんでぃの	《シルンディの幻視／シルンディの島嶼》	名詞
＠しるんでぃのげ	《シルンディの幻視／シルンディの島嶼》	名詞
＠しるんでぃのげん	《シルンディの幻視／シルンディの島嶼》	名詞
＠しるんでぃのげんし	《シルンディの幻視／シルンディの島嶼》	名詞
＠し	《シルンディの幻視／シルンディの島嶼》	名詞
＠しる	《シルンディの幻視／シルンディの島嶼》	名詞
＠しるん	《シルンディの幻視／シルンディの島嶼》	名詞
＠しるんで	《シルンディの幻視／シルンディの島嶼》	名詞
＠しるんでぃ	《シルンディの幻視／シルンディの島嶼》	名詞
＠しるんでぃの	《シルンディの幻視／シルンディの島嶼》	名詞
＠しるんでぃのと	《シルンディの幻視／シルンディの島嶼》	名詞
＠しるんでぃのとう	《シルンディの幻視／シルンディの島嶼》	名詞
＠しるんでぃのとうし	《シルンディの幻視／シルンディの島嶼》	名詞
＠しるんでぃのとうしょ	《シルンディの幻視／シルンディの島嶼》	名詞
＠す	《スカイクレイブの略奪》	名詞
＠すか	《スカイクレイブの略奪》	名詞
＠すかい	《スカイクレイブの略奪》	名詞
＠すかいく	《スカイクレイブの略奪》	名詞
＠すかいくれ	《スカイクレイブの略奪》	名詞
＠すかいくれい	《スカイクレイブの略奪》	名詞
＠すかいくれいぶ	《スカイクレイブの略奪》	名詞
＠すかいくれいぶの	《スカイクレイブの略奪》	名詞
＠すかいくれいぶのり	《スカイクレイブの略奪》	名詞
＠すかいくれいぶのりゃ	《スカイクレイブの略奪》	名詞
＠すかいくれいぶのりゃく	《スカイクレイブの略奪》	名詞
＠すかいくれいぶのりゃくだ	《スカイクレイブの略奪》	名詞
＠すかいくれいぶのりゃくだつ	《スカイクレイブの略奪》	名詞
＠ど	《ドレイクの休息地》	名詞
＠どれ	《ドレイクの休息地》	名詞
＠どれい	《ドレイクの休息地》	名詞
＠どれいく	《ドレイクの休息地》	名詞
＠どれいくの	《ドレイクの休息地》	名詞
＠どれいくのき	《ドレイクの休息地》	名詞
＠どれいくのきゅ	《ドレイクの休息地》	名詞
＠どれいくのきゅう	《ドレイクの休息地》	名詞
＠どれいくのきゅうそ	《ドレイクの休息地》	名詞
＠どれいくのきゅうそく	《ドレイクの休息地》	名詞
＠どれいくのきゅうそくち	《ドレイクの休息地》	名詞
＠な	《凪魔道士の威圧》	名詞
＠なぎ	《凪魔道士の威圧》	名詞
＠なぎま	《凪魔道士の威圧》	名詞
＠なぎまど	《凪魔道士の威圧》	名詞
＠なぎまどう	《凪魔道士の威圧》	名詞
＠なぎまどうし	《凪魔道士の威圧》	名詞
＠なぎまどうしの	《凪魔道士の威圧》	名詞
＠なぎまどうしのい	《凪魔道士の威圧》	名詞
＠なぎまどうしのいあ	《凪魔道士の威圧》	名詞
＠なぎまどうしのいあつ	《凪魔道士の威圧》	名詞
＠べ	《ベイーンのヴェール／ベイーンの沿岸》	名詞
＠べい	《ベイーンのヴェール／ベイーンの沿岸》	名詞
＠べいー	《ベイーンのヴェール／ベイーンの沿岸》	名詞
＠べいーん	《ベイーンのヴェール／ベイーンの沿岸》	名詞
＠べいーんの	《ベイーンのヴェール／ベイーンの沿岸》	名詞
＠べいーんのヴ	《ベイーンのヴェール／ベイーンの沿岸》	名詞
＠べいーんのヴぇ	《ベイーンのヴェール／ベイーンの沿岸》	名詞
＠べいーんのヴぇー	《ベイーンのヴェール／ベイーンの沿岸》	名詞
＠べいーんのヴぇーる	《ベイーンのヴェール／ベイーンの沿岸》	名詞
＠べ	《ベイーンのヴェール／ベイーンの沿岸》	名詞
＠べい	《ベイーンのヴェール／ベイーンの沿岸》	名詞
＠べいー	《ベイーンのヴェール／ベイーンの沿岸》	名詞
＠べいーん	《ベイーンのヴェール／ベイーンの沿岸》	名詞
＠べいーんの	《ベイーンのヴェール／ベイーンの沿岸》	名詞
＠べいーんのえ	《ベイーンのヴェール／ベイーンの沿岸》	名詞
＠べいーんのえん	《ベイーンのヴェール／ベイーンの沿岸》	名詞
＠べいーんのえんが	《ベイーンのヴェール／ベイーンの沿岸》	名詞
＠べいーんのえんがん	《ベイーンのヴェール／ベイーンの沿岸》	名詞
＠ま	《マーフォークの風泥棒》	名詞
＠まー	《マーフォークの風泥棒》	名詞
＠まーふ	《マーフォークの風泥棒》	名詞
＠まーふぉ	《マーフォークの風泥棒》	名詞
＠まーふぉー	《マーフォークの風泥棒》	名詞
＠まーふぉーく	《マーフォークの風泥棒》	名詞
＠まーふぉーくの	《マーフォークの風泥棒》	名詞
＠まーふぉーくのか	《マーフォークの風泥棒》	名詞
＠まーふぉーくのかぜ	《マーフォークの風泥棒》	名詞
＠まーふぉーくのかぜど	《マーフォークの風泥棒》	名詞
＠まーふぉーくのかぜどろ	《マーフォークの風泥棒》	名詞
＠まーふぉーくのかぜどろぼ	《マーフォークの風泥棒》	名詞
＠まーふぉーくのかぜどろぼう	《マーフォークの風泥棒》	名詞
＠ま	《マーフォークの鷹匠》	名詞
＠まー	《マーフォークの鷹匠》	名詞
＠まーふ	《マーフォークの鷹匠》	名詞
＠まーふぉ	《マーフォークの鷹匠》	名詞
＠まーふぉー	《マーフォークの鷹匠》	名詞
＠まーふぉーく	《マーフォークの鷹匠》	名詞
＠まーふぉーくの	《マーフォークの鷹匠》	名詞
＠まーふぉーくのた	《マーフォークの鷹匠》	名詞
＠まーふぉーくのたか	《マーフォークの鷹匠》	名詞
＠まーふぉーくのたかじ	《マーフォークの鷹匠》	名詞
＠まーふぉーくのたかじょ	《マーフォークの鷹匠》	名詞
＠まーふぉーくのたかじょう	《マーフォークの鷹匠》	名詞
＠い	《怒り狂う島嶼、キャリクス》	名詞
＠いか	《怒り狂う島嶼、キャリクス》	名詞
＠いかり	《怒り狂う島嶼、キャリクス》	名詞
＠いかりく	《怒り狂う島嶼、キャリクス》	名詞
＠いかりくる	《怒り狂う島嶼、キャリクス》	名詞
＠いかりくるう	《怒り狂う島嶼、キャリクス》	名詞
＠いかりくるうと	《怒り狂う島嶼、キャリクス》	名詞
＠いかりくるうとう	《怒り狂う島嶼、キャリクス》	名詞
＠いかりくるうとうし	《怒り狂う島嶼、キャリクス》	名詞
＠いかりくるうとうしょ	《怒り狂う島嶼、キャリクス》	名詞
＠いかりくるうとうしょ、	《怒り狂う島嶼、キャリクス》	名詞
＠いかりくるうとうしょ、き	《怒り狂う島嶼、キャリクス》	名詞
＠いかりくるうとうしょ、きゃ	《怒り狂う島嶼、キャリクス》	名詞
＠いかりくるうとうしょ、きゃり	《怒り狂う島嶼、キャリクス》	名詞
＠いかりくるうとうしょ、きゃりく	《怒り狂う島嶼、キャリクス》	名詞
＠いかりくるうとうしょ、きゃりくす	《怒り狂う島嶼、キャリクス》	名詞
＠き	《怒り狂う島嶼、キャリクス》	名詞
＠きゃ	《怒り狂う島嶼、キャリクス》	名詞
＠きゃり	《怒り狂う島嶼、キャリクス》	名詞
＠きゃりく	《怒り狂う島嶼、キャリクス》	名詞
＠きゃりくす	《怒り狂う島嶼、キャリクス》	名詞
＠あ	《荒れ狂う騒音》	名詞
＠あれ	《荒れ狂う騒音》	名詞
＠あれく	《荒れ狂う騒音》	名詞
＠あれくる	《荒れ狂う騒音》	名詞
＠あれくるう	《荒れ狂う騒音》	名詞
＠あれくるうそ	《荒れ狂う騒音》	名詞
＠あれくるうそう	《荒れ狂う騒音》	名詞
＠あれくるうそうお	《荒れ狂う騒音》	名詞
＠あれくるうそうおん	《荒れ狂う騒音》	名詞
＠か	《風の達人》	名詞
＠かぜ	《風の達人》	名詞
＠かぜの	《風の達人》	名詞
＠かぜのた	《風の達人》	名詞
＠かぜのたつ	《風の達人》	名詞
＠かぜのたつじ	《風の達人》	名詞
＠かぜのたつじん	《風の達人》	名詞
＠さ	《珊瑚兜の年代記編者》	名詞
＠さん	《珊瑚兜の年代記編者》	名詞
＠さんご	《珊瑚兜の年代記編者》	名詞
＠さんごか	《珊瑚兜の年代記編者》	名詞
＠さんごかぶ	《珊瑚兜の年代記編者》	名詞
＠さんごかぶと	《珊瑚兜の年代記編者》	名詞
＠さんごかぶとの	《珊瑚兜の年代記編者》	名詞
＠さんごかぶとのね	《珊瑚兜の年代記編者》	名詞
＠さんごかぶとのねん	《珊瑚兜の年代記編者》	名詞
＠さんごかぶとのねんだ	《珊瑚兜の年代記編者》	名詞
＠さんごかぶとのねんだい	《珊瑚兜の年代記編者》	名詞
＠さんごかぶとのねんだいき	《珊瑚兜の年代記編者》	名詞
＠さんごかぶとのねんだいきへ	《珊瑚兜の年代記編者》	名詞
＠さんごかぶとのねんだいきへん	《珊瑚兜の年代記編者》	名詞
＠さんごかぶとのねんだいきへんし	《珊瑚兜の年代記編者》	名詞
＠さんごかぶとのねんだいきへんしゃ	《珊瑚兜の年代記編者》	名詞
＠ど	《洞察の碑文》	名詞
＠どう	《洞察の碑文》	名詞
＠どうさ	《洞察の碑文》	名詞
＠どうさつ	《洞察の碑文》	名詞
＠どうさつの	《洞察の碑文》	名詞
＠どうさつのひ	《洞察の碑文》	名詞
＠どうさつのひぶ	《洞察の碑文》	名詞
＠どうさつのひぶん	《洞察の碑文》	名詞
＠と	《当惑させる難題》	名詞
＠とう	《当惑させる難題》	名詞
＠とうわ	《当惑させる難題》	名詞
＠とうわく	《当惑させる難題》	名詞
＠とうわくさ	《当惑させる難題》	名詞
＠とうわくさせ	《当惑させる難題》	名詞
＠とうわくさせる	《当惑させる難題》	名詞
＠とうわくさせるな	《当惑させる難題》	名詞
＠とうわくさせるなん	《当惑させる難題》	名詞
＠とうわくさせるなんだ	《当惑させる難題》	名詞
＠とうわくさせるなんだい	《当惑させる難題》	名詞
＠ど	《泥棒スカイダイバー》	名詞
＠どろ	《泥棒スカイダイバー》	名詞
＠どろぼ	《泥棒スカイダイバー》	名詞
＠どろぼう	《泥棒スカイダイバー》	名詞
＠どろぼうす	《泥棒スカイダイバー》	名詞
＠どろぼうすか	《泥棒スカイダイバー》	名詞
＠どろぼうすかい	《泥棒スカイダイバー》	名詞
＠どろぼうすかいだ	《泥棒スカイダイバー》	名詞
＠どろぼうすかいだい	《泥棒スカイダイバー》	名詞
＠どろぼうすかいだいば	《泥棒スカイダイバー》	名詞
＠どろぼうすかいだいばー	《泥棒スカイダイバー》	名詞
＠は	《玻璃池のミミック／玻璃池の岸》	名詞
＠はり	《玻璃池のミミック／玻璃池の岸》	名詞
＠はりい	《玻璃池のミミック／玻璃池の岸》	名詞
＠はりいけ	《玻璃池のミミック／玻璃池の岸》	名詞
＠はりいけの	《玻璃池のミミック／玻璃池の岸》	名詞
＠はりいけのみ	《玻璃池のミミック／玻璃池の岸》	名詞
＠はりいけのみみ	《玻璃池のミミック／玻璃池の岸》	名詞
＠はりいけのみみっ	《玻璃池のミミック／玻璃池の岸》	名詞
＠はりいけのみみっく	《玻璃池のミミック／玻璃池の岸》	名詞
＠は	《玻璃池のミミック／玻璃池の岸》	名詞
＠はり	《玻璃池のミミック／玻璃池の岸》	名詞
＠はりい	《玻璃池のミミック／玻璃池の岸》	名詞
＠はりいけ	《玻璃池のミミック／玻璃池の岸》	名詞
＠はりいけの	《玻璃池のミミック／玻璃池の岸》	名詞
＠はりいけのき	《玻璃池のミミック／玻璃池の岸》	名詞
＠はりいけのきし	《玻璃池のミミック／玻璃池の岸》	名詞
＠び	《敏捷な罠探し》	名詞
＠びん	《敏捷な罠探し》	名詞
＠びんし	《敏捷な罠探し》	名詞
＠びんしょ	《敏捷な罠探し》	名詞
＠びんしょう	《敏捷な罠探し》	名詞
＠びんしょうな	《敏捷な罠探し》	名詞
＠びんしょうなわ	《敏捷な罠探し》	名詞
＠びんしょうなわな	《敏捷な罠探し》	名詞
＠びんしょうなわなさ	《敏捷な罠探し》	名詞
＠びんしょうなわなさが	《敏捷な罠探し》	名詞
＠びんしょうなわなさがし	《敏捷な罠探し》	名詞
＠か	《海門修復／再誕の海門》	名詞
＠かい	《海門修復／再誕の海門》	名詞
＠かいも	《海門修復／再誕の海門》	名詞
＠かいもん	《海門修復／再誕の海門》	名詞
＠かいもんし	《海門修復／再誕の海門》	名詞
＠かいもんしゅ	《海門修復／再誕の海門》	名詞
＠かいもんしゅう	《海門修復／再誕の海門》	名詞
＠かいもんしゅうふ	《海門修復／再誕の海門》	名詞
＠かいもんしゅうふく	《海門修復／再誕の海門》	名詞
＠さ	《海門修復／再誕の海門》	名詞
＠さい	《海門修復／再誕の海門》	名詞
＠さいた	《海門修復／再誕の海門》	名詞
＠さいたん	《海門修復／再誕の海門》	名詞
＠さいたんの	《海門修復／再誕の海門》	名詞
＠さいたんのか	《海門修復／再誕の海門》	名詞
＠さいたんのかい	《海門修復／再誕の海門》	名詞
＠さいたんのかいも	《海門修復／再誕の海門》	名詞
＠さいたんのかいもん	《海門修復／再誕の海門》	名詞
＠か	《海門の嵐呼び》	名詞
＠かい	《海門の嵐呼び》	名詞
＠かいも	《海門の嵐呼び》	名詞
＠かいもん	《海門の嵐呼び》	名詞
＠かいもんの	《海門の嵐呼び》	名詞
＠かいもんのあ	《海門の嵐呼び》	名詞
＠かいもんのあら	《海門の嵐呼び》	名詞
＠かいもんのあらし	《海門の嵐呼び》	名詞
＠かいもんのあらしよ	《海門の嵐呼び》	名詞
＠かいもんのあらしよび	《海門の嵐呼び》	名詞
＠き	《鏡映魔道士、ジェイス》	名詞
＠きょ	《鏡映魔道士、ジェイス》	名詞
＠きょう	《鏡映魔道士、ジェイス》	名詞
＠きょうえ	《鏡映魔道士、ジェイス》	名詞
＠きょうえい	《鏡映魔道士、ジェイス》	名詞
＠きょうえいま	《鏡映魔道士、ジェイス》	名詞
＠きょうえいまど	《鏡映魔道士、ジェイス》	名詞
＠きょうえいまどう	《鏡映魔道士、ジェイス》	名詞
＠きょうえいまどうし	《鏡映魔道士、ジェイス》	名詞
＠きょうえいまどうし、	《鏡映魔道士、ジェイス》	名詞
＠きょうえいまどうし、じ	《鏡映魔道士、ジェイス》	名詞
＠きょうえいまどうし、じぇ	《鏡映魔道士、ジェイス》	名詞
＠きょうえいまどうし、じぇい	《鏡映魔道士、ジェイス》	名詞
＠きょうえいまどうし、じぇいす	《鏡映魔道士、ジェイス》	名詞
＠じ	《鏡映魔道士、ジェイス》	名詞
＠じぇ	《鏡映魔道士、ジェイス》	名詞
＠じぇい	《鏡映魔道士、ジェイス》	名詞
＠じぇいす	《鏡映魔道士、ジェイス》	名詞
＠い	《命取りの協力》	名詞
＠いの	《命取りの協力》	名詞
＠いのち	《命取りの協力》	名詞
＠いのちと	《命取りの協力》	名詞
＠いのちとり	《命取りの協力》	名詞
＠いのちとりの	《命取りの協力》	名詞
＠いのちとりのき	《命取りの協力》	名詞
＠いのちとりのきょ	《命取りの協力》	名詞
＠いのちとりのきょう	《命取りの協力》	名詞
＠いのちとりのきょうり	《命取りの協力》	名詞
＠いのちとりのきょうりょ	《命取りの協力》	名詞
＠いのちとりのきょうりょく	《命取りの協力》	名詞
＠い	《隠然たる襲撃》	名詞
＠いん	《隠然たる襲撃》	名詞
＠いんぜ	《隠然たる襲撃》	名詞
＠いんぜん	《隠然たる襲撃》	名詞
＠いんぜんた	《隠然たる襲撃》	名詞
＠いんぜんたる	《隠然たる襲撃》	名詞
＠いんぜんたるし	《隠然たる襲撃》	名詞
＠いんぜんたるしゅ	《隠然たる襲撃》	名詞
＠いんぜんたるしゅう	《隠然たる襲撃》	名詞
＠いんぜんたるしゅうげ	《隠然たる襲撃》	名詞
＠いんぜんたるしゅうげき	《隠然たる襲撃》	名詞
＠き	《恐怖の薄暗狩り》	名詞
＠きょ	《恐怖の薄暗狩り》	名詞
＠きょう	《恐怖の薄暗狩り》	名詞
＠きょうふ	《恐怖の薄暗狩り》	名詞
＠きょうふの	《恐怖の薄暗狩り》	名詞
＠きょうふのう	《恐怖の薄暗狩り》	名詞
＠きょうふのうす	《恐怖の薄暗狩り》	名詞
＠きょうふのうすぐ	《恐怖の薄暗狩り》	名詞
＠きょうふのうすぐら	《恐怖の薄暗狩り》	名詞
＠きょうふのうすぐらか	《恐怖の薄暗狩り》	名詞
＠きょうふのうすぐらかり	《恐怖の薄暗狩り》	名詞
＠ぐ	《グール・ドラズの泥王》	名詞
＠ぐー	《グール・ドラズの泥王》	名詞
＠ぐーる	《グール・ドラズの泥王》	名詞
＠ぐーる・	《グール・ドラズの泥王》	名詞
＠ぐーる・ど	《グール・ドラズの泥王》	名詞
＠ぐーる・どら	《グール・ドラズの泥王》	名詞
＠ぐーる・どらず	《グール・ドラズの泥王》	名詞
＠ぐーる・どらずの	《グール・ドラズの泥王》	名詞
＠ぐーる・どらずのど	《グール・ドラズの泥王》	名詞
＠ぐーる・どらずのどろ	《グール・ドラズの泥王》	名詞
＠ぐーる・どらずのどろお	《グール・ドラズの泥王》	名詞
＠ぐーる・どらずのどろおう	《グール・ドラズの泥王》	名詞
＠じ	《弱者成敗》	名詞
＠じゃ	《弱者成敗》	名詞
＠じゃく	《弱者成敗》	名詞
＠じゃくし	《弱者成敗》	名詞
＠じゃくしゃ	《弱者成敗》	名詞
＠じゃくしゃせ	《弱者成敗》	名詞
＠じゃくしゃせい	《弱者成敗》	名詞
＠じゃくしゃせいば	《弱者成敗》	名詞
＠じゃくしゃせいばい	《弱者成敗》	名詞
＠せ	《精神流出》	名詞
＠せい	《精神流出》	名詞
＠せいし	《精神流出》	名詞
＠せいしん	《精神流出》	名詞
＠せいしんり	《精神流出》	名詞
＠せいしんりゅ	《精神流出》	名詞
＠せいしんりゅう	《精神流出》	名詞
＠せいしんりゅうし	《精神流出》	名詞
＠せいしんりゅうしゅ	《精神流出》	名詞
＠せいしんりゅうしゅつ	《精神流出》	名詞
＠せ	《戦慄ワーム》	名詞
＠せん	《戦慄ワーム》	名詞
＠せんり	《戦慄ワーム》	名詞
＠せんりつ	《戦慄ワーム》	名詞
＠せんりつわ	《戦慄ワーム》	名詞
＠せんりつわー	《戦慄ワーム》	名詞
＠せんりつわーむ	《戦慄ワーム》	名詞
＠た	《大群への給餌》	名詞
＠たい	《大群への給餌》	名詞
＠たいぐ	《大群への給餌》	名詞
＠たいぐん	《大群への給餌》	名詞
＠たいぐんへ	《大群への給餌》	名詞
＠たいぐんへの	《大群への給餌》	名詞
＠たいぐんへのき	《大群への給餌》	名詞
＠たいぐんへのきゅ	《大群への給餌》	名詞
＠たいぐんへのきゅう	《大群への給餌》	名詞
＠たいぐんへのきゅうじ	《大群への給餌》	名詞
＠た	《探検隊の潜伏者》	名詞
＠たん	《探検隊の潜伏者》	名詞
＠たんけ	《探検隊の潜伏者》	名詞
＠たんけん	《探検隊の潜伏者》	名詞
＠たんけんた	《探検隊の潜伏者》	名詞
＠たんけんたい	《探検隊の潜伏者》	名詞
＠たんけんたいの	《探検隊の潜伏者》	名詞
＠たんけんたいのせ	《探検隊の潜伏者》	名詞
＠たんけんたいのせん	《探検隊の潜伏者》	名詞
＠たんけんたいのせんぷ	《探検隊の潜伏者》	名詞
＠たんけんたいのせんぷく	《探検隊の潜伏者》	名詞
＠たんけんたいのせんぷくし	《探検隊の潜伏者》	名詞
＠たんけんたいのせんぷくしゃ	《探検隊の潜伏者》	名詞
＠ち	《血の対価》	名詞
＠ちの	《血の対価》	名詞
＠ちのた	《血の対価》	名詞
＠ちのたい	《血の対価》	名詞
＠ちのたいか	《血の対価》	名詞
＠ち	《血の招き》	名詞
＠ちの	《血の招き》	名詞
＠ちのま	《血の招き》	名詞
＠ちのまね	《血の招き》	名詞
＠ちのまねき	《血の招き》	名詞
＠ど	《ドラーナの口封じ》	名詞
＠どら	《ドラーナの口封じ》	名詞
＠どらー	《ドラーナの口封じ》	名詞
＠どらーな	《ドラーナの口封じ》	名詞
＠どらーなの	《ドラーナの口封じ》	名詞
＠どらーなのく	《ドラーナの口封じ》	名詞
＠どらーなのくち	《ドラーナの口封じ》	名詞
＠どらーなのくちふ	《ドラーナの口封じ》	名詞
＠どらーなのくちふう	《ドラーナの口封じ》	名詞
＠どらーなのくちふうじ	《ドラーナの口封じ》	名詞
＠に	《ニマーナの忍び歩く者》	名詞
＠にま	《ニマーナの忍び歩く者》	名詞
＠にまー	《ニマーナの忍び歩く者》	名詞
＠にまーな	《ニマーナの忍び歩く者》	名詞
＠にまーなの	《ニマーナの忍び歩く者》	名詞
＠にまーなのし	《ニマーナの忍び歩く者》	名詞
＠にまーなのしの	《ニマーナの忍び歩く者》	名詞
＠にまーなのしのび	《ニマーナの忍び歩く者》	名詞
＠にまーなのしのびあ	《ニマーナの忍び歩く者》	名詞
＠にまーなのしのびある	《ニマーナの忍び歩く者》	名詞
＠にまーなのしのびあるく	《ニマーナの忍び歩く者》	名詞
＠にまーなのしのびあるくも	《ニマーナの忍び歩く者》	名詞
＠にまーなのしのびあるくもの	《ニマーナの忍び歩く者》	名詞
＠に	《ニマーナの空踊り》	名詞
＠にま	《ニマーナの空踊り》	名詞
＠にまー	《ニマーナの空踊り》	名詞
＠にまーな	《ニマーナの空踊り》	名詞
＠にまーなの	《ニマーナの空踊り》	名詞
＠にまーなのそ	《ニマーナの空踊り》	名詞
＠にまーなのそら	《ニマーナの空踊り》	名詞
＠にまーなのそらお	《ニマーナの空踊り》	名詞
＠にまーなのそらおど	《ニマーナの空踊り》	名詞
＠にまーなのそらおどり	《ニマーナの空踊り》	名詞
＠は	《ハグラの締めつけ蛇》	名詞
＠はぐ	《ハグラの締めつけ蛇》	名詞
＠はぐら	《ハグラの締めつけ蛇》	名詞
＠はぐらの	《ハグラの締めつけ蛇》	名詞
＠はぐらのし	《ハグラの締めつけ蛇》	名詞
＠はぐらのしめ	《ハグラの締めつけ蛇》	名詞
＠はぐらのしめつ	《ハグラの締めつけ蛇》	名詞
＠はぐらのしめつけ	《ハグラの締めつけ蛇》	名詞
＠はぐらのしめつけへ	《ハグラの締めつけ蛇》	名詞
＠はぐらのしめつけへび	《ハグラの締めつけ蛇》	名詞
＠ぼ	《忘却の飢え》	名詞
＠ぼう	《忘却の飢え》	名詞
＠ぼうき	《忘却の飢え》	名詞
＠ぼうきゃ	《忘却の飢え》	名詞
＠ぼうきゃく	《忘却の飢え》	名詞
＠ぼうきゃくの	《忘却の飢え》	名詞
＠ぼうきゃくのう	《忘却の飢え》	名詞
＠ぼうきゃくのうえ	《忘却の飢え》	名詞
＠ま	《マラキールの血僧侶》	名詞
＠まら	《マラキールの血僧侶》	名詞
＠まらき	《マラキールの血僧侶》	名詞
＠まらきー	《マラキールの血僧侶》	名詞
＠まらきーる	《マラキールの血僧侶》	名詞
＠まらきーるの	《マラキールの血僧侶》	名詞
＠まらきーるのち	《マラキールの血僧侶》	名詞
＠まらきーるのちそ	《マラキールの血僧侶》	名詞
＠まらきーるのちそう	《マラキールの血僧侶》	名詞
＠まらきーるのちそうり	《マラキールの血僧侶》	名詞
＠まらきーるのちそうりょ	《マラキールの血僧侶》	名詞
＠め	《名門の吸血鬼》	名詞
＠めい	《名門の吸血鬼》	名詞
＠めいも	《名門の吸血鬼》	名詞
＠めいもん	《名門の吸血鬼》	名詞
＠めいもんの	《名門の吸血鬼》	名詞
＠めいもんのき	《名門の吸血鬼》	名詞
＠めいもんのきゅ	《名門の吸血鬼》	名詞
＠めいもんのきゅう	《名門の吸血鬼》	名詞
＠めいもんのきゅうけ	《名門の吸血鬼》	名詞
＠めいもんのきゅうけつ	《名門の吸血鬼》	名詞
＠めいもんのきゅうけつき	《名門の吸血鬼》	名詞
＠り	《略奪する破戒僧》	名詞
＠りゃ	《略奪する破戒僧》	名詞
＠りゃく	《略奪する破戒僧》	名詞
＠りゃくだ	《略奪する破戒僧》	名詞
＠りゃくだつ	《略奪する破戒僧》	名詞
＠りゃくだつす	《略奪する破戒僧》	名詞
＠りゃくだつする	《略奪する破戒僧》	名詞
＠りゃくだつするは	《略奪する破戒僧》	名詞
＠りゃくだつするはか	《略奪する破戒僧》	名詞
＠りゃくだつするはかい	《略奪する破戒僧》	名詞
＠りゃくだつするはかいそ	《略奪する破戒僧》	名詞
＠りゃくだつするはかいそう	《略奪する破戒僧》	名詞
＠あ	《悪魔の信奉者》	名詞
＠あく	《悪魔の信奉者》	名詞
＠あくま	《悪魔の信奉者》	名詞
＠あくまの	《悪魔の信奉者》	名詞
＠あくまのし	《悪魔の信奉者》	名詞
＠あくまのしん	《悪魔の信奉者》	名詞
＠あくまのしんぽ	《悪魔の信奉者》	名詞
＠あくまのしんぽう	《悪魔の信奉者》	名詞
＠あくまのしんぽうし	《悪魔の信奉者》	名詞
＠あくまのしんぽうしゃ	《悪魔の信奉者》	名詞
＠か	《影のとげ刺し》	名詞
＠かげ	《影のとげ刺し》	名詞
＠かげの	《影のとげ刺し》	名詞
＠かげのと	《影のとげ刺し》	名詞
＠かげのとげ	《影のとげ刺し》	名詞
＠かげのとげさ	《影のとげ刺し》	名詞
＠かげのとげさし	《影のとげ刺し》	名詞
＠し	《収得の熟練者》	名詞
＠しゅ	《収得の熟練者》	名詞
＠しゅう	《収得の熟練者》	名詞
＠しゅうと	《収得の熟練者》	名詞
＠しゅうとく	《収得の熟練者》	名詞
＠しゅうとくの	《収得の熟練者》	名詞
＠しゅうとくのじ	《収得の熟練者》	名詞
＠しゅうとくのじゅ	《収得の熟練者》	名詞
＠しゅうとくのじゅく	《収得の熟練者》	名詞
＠しゅうとくのじゅくれ	《収得の熟練者》	名詞
＠しゅうとくのじゅくれん	《収得の熟練者》	名詞
＠しゅうとくのじゅくれんし	《収得の熟練者》	名詞
＠しゅうとくのじゅくれんしゃ	《収得の熟練者》	名詞
＠す	《スカイクレイブの影猫》	名詞
＠すか	《スカイクレイブの影猫》	名詞
＠すかい	《スカイクレイブの影猫》	名詞
＠すかいく	《スカイクレイブの影猫》	名詞
＠すかいくれ	《スカイクレイブの影猫》	名詞
＠すかいくれい	《スカイクレイブの影猫》	名詞
＠すかいくれいぶ	《スカイクレイブの影猫》	名詞
＠すかいくれいぶの	《スカイクレイブの影猫》	名詞
＠すかいくれいぶのか	《スカイクレイブの影猫》	名詞
＠すかいくれいぶのかげ	《スカイクレイブの影猫》	名詞
＠すかいくれいぶのかげね	《スカイクレイブの影猫》	名詞
＠すかいくれいぶのかげねこ	《スカイクレイブの影猫》	名詞
＠せ	《精神削りの刃》	名詞
＠せい	《精神削りの刃》	名詞
＠せいし	《精神削りの刃》	名詞
＠せいしん	《精神削りの刃》	名詞
＠せいしんけ	《精神削りの刃》	名詞
＠せいしんけず	《精神削りの刃》	名詞
＠せいしんけずり	《精神削りの刃》	名詞
＠せいしんけずりの	《精神削りの刃》	名詞
＠せいしんけずりのや	《精神削りの刃》	名詞
＠せいしんけずりのやい	《精神削りの刃》	名詞
＠せいしんけずりのやいば	《精神削りの刃》	名詞
＠せ	《石成の荒廃》	名詞
＠せき	《石成の荒廃》	名詞
＠せきせ	《石成の荒廃》	名詞
＠せきせい	《石成の荒廃》	名詞
＠せきせいの	《石成の荒廃》	名詞
＠せきせいのこ	《石成の荒廃》	名詞
＠せきせいのこう	《石成の荒廃》	名詞
＠せきせいのこうは	《石成の荒廃》	名詞
＠せきせいのこうはい	《石成の荒廃》	名詞
＠ぞ	《ゾフの消耗／ゾフの血溜まり》	名詞
＠ぞふ	《ゾフの消耗／ゾフの血溜まり》	名詞
＠ぞふの	《ゾフの消耗／ゾフの血溜まり》	名詞
＠ぞふのし	《ゾフの消耗／ゾフの血溜まり》	名詞
＠ぞふのしょ	《ゾフの消耗／ゾフの血溜まり》	名詞
＠ぞふのしょう	《ゾフの消耗／ゾフの血溜まり》	名詞
＠ぞふのしょうも	《ゾフの消耗／ゾフの血溜まり》	名詞
＠ぞふのしょうもう	《ゾフの消耗／ゾフの血溜まり》	名詞
＠ぞ	《ゾフの消耗／ゾフの血溜まり》	名詞
＠ぞふ	《ゾフの消耗／ゾフの血溜まり》	名詞
＠ぞふの	《ゾフの消耗／ゾフの血溜まり》	名詞
＠ぞふのち	《ゾフの消耗／ゾフの血溜まり》	名詞
＠ぞふのちだ	《ゾフの消耗／ゾフの血溜まり》	名詞
＠ぞふのちだま	《ゾフの消耗／ゾフの血溜まり》	名詞
＠ぞふのちだまり	《ゾフの消耗／ゾフの血溜まり》	名詞
＠ち	《血の長の渇き》	名詞
＠ちの	《血の長の渇き》	名詞
＠ちのお	《血の長の渇き》	名詞
＠ちのおさ	《血の長の渇き》	名詞
＠ちのおさの	《血の長の渇き》	名詞
＠ちのおさのか	《血の長の渇き》	名詞
＠ちのおさのかわ	《血の長の渇き》	名詞
＠ちのおさのかわき	《血の長の渇き》	名詞
＠む	《群れの末裔》	名詞
＠むれ	《群れの末裔》	名詞
＠むれの	《群れの末裔》	名詞
＠むれのま	《群れの末裔》	名詞
＠むれのまつ	《群れの末裔》	名詞
＠むれのまつえ	《群れの末裔》	名詞
＠むれのまつえい	《群れの末裔》	名詞
＠は	《墓入りの妨害》	名詞
＠はか	《墓入りの妨害》	名詞
＠はかい	《墓入りの妨害》	名詞
＠はかいり	《墓入りの妨害》	名詞
＠はかいりの	《墓入りの妨害》	名詞
＠はかいりのぼ	《墓入りの妨害》	名詞
＠はかいりのぼう	《墓入りの妨害》	名詞
＠はかいりのぼうが	《墓入りの妨害》	名詞
＠はかいりのぼうがい	《墓入りの妨害》	名詞
＠ぶ	《ブラックブルームのならず者／ブラックブルームの沼》	名詞
＠ぶら	《ブラックブルームのならず者／ブラックブルームの沼》	名詞
＠ぶらっ	《ブラックブルームのならず者／ブラックブルームの沼》	名詞
＠ぶらっく	《ブラックブルームのならず者／ブラックブルームの沼》	名詞
＠ぶらっくぶ	《ブラックブルームのならず者／ブラックブルームの沼》	名詞
＠ぶらっくぶる	《ブラックブルームのならず者／ブラックブルームの沼》	名詞
＠ぶらっくぶるー	《ブラックブルームのならず者／ブラックブルームの沼》	名詞
＠ぶらっくぶるーむ	《ブラックブルームのならず者／ブラックブルームの沼》	名詞
＠ぶらっくぶるーむの	《ブラックブルームのならず者／ブラックブルームの沼》	名詞
＠ぶらっくぶるーむのな	《ブラックブルームのならず者／ブラックブルームの沼》	名詞
＠ぶらっくぶるーむのなら	《ブラックブルームのならず者／ブラックブルームの沼》	名詞
＠ぶらっくぶるーむのならず	《ブラックブルームのならず者／ブラックブルームの沼》	名詞
＠ぶらっくぶるーむのならずも	《ブラックブルームのならず者／ブラックブルームの沼》	名詞
＠ぶらっくぶるーむのならずもの	《ブラックブルームのならず者／ブラックブルームの沼》	名詞
＠ぶ	《ブラックブルームのならず者／ブラックブルームの沼》	名詞
＠ぶら	《ブラックブルームのならず者／ブラックブルームの沼》	名詞
＠ぶらっ	《ブラックブルームのならず者／ブラックブルームの沼》	名詞
＠ぶらっく	《ブラックブルームのならず者／ブラックブルームの沼》	名詞
＠ぶらっくぶ	《ブラックブルームのならず者／ブラックブルームの沼》	名詞
＠ぶらっくぶる	《ブラックブルームのならず者／ブラックブルームの沼》	名詞
＠ぶらっくぶるー	《ブラックブルームのならず者／ブラックブルームの沼》	名詞
＠ぶらっくぶるーむ	《ブラックブルームのならず者／ブラックブルームの沼》	名詞
＠ぶらっくぶるーむの	《ブラックブルームのならず者／ブラックブルームの沼》	名詞
＠ぶらっくぶるーむのぬ	《ブラックブルームのならず者／ブラックブルームの沼》	名詞
＠ぶらっくぶるーむのぬま	《ブラックブルームのならず者／ブラックブルームの沼》	名詞
＠ぺ	《ペラッカの捕食／ペラッカの洞窟》	名詞
＠ぺら	《ペラッカの捕食／ペラッカの洞窟》	名詞
＠ぺらっ	《ペラッカの捕食／ペラッカの洞窟》	名詞
＠ぺらっか	《ペラッカの捕食／ペラッカの洞窟》	名詞
＠ぺらっかの	《ペラッカの捕食／ペラッカの洞窟》	名詞
＠ぺらっかのほ	《ペラッカの捕食／ペラッカの洞窟》	名詞
＠ぺらっかのほし	《ペラッカの捕食／ペラッカの洞窟》	名詞
＠ぺらっかのほしょ	《ペラッカの捕食／ペラッカの洞窟》	名詞
＠ぺらっかのほしょく	《ペラッカの捕食／ペラッカの洞窟》	名詞
＠ぺ	《ペラッカの捕食／ペラッカの洞窟》	名詞
＠ぺら	《ペラッカの捕食／ペラッカの洞窟》	名詞
＠ぺらっ	《ペラッカの捕食／ペラッカの洞窟》	名詞
＠ぺらっか	《ペラッカの捕食／ペラッカの洞窟》	名詞
＠ぺらっかの	《ペラッカの捕食／ペラッカの洞窟》	名詞
＠ぺらっかのど	《ペラッカの捕食／ペラッカの洞窟》	名詞
＠ぺらっかのどう	《ペラッカの捕食／ペラッカの洞窟》	名詞
＠ぺらっかのどうく	《ペラッカの捕食／ペラッカの洞窟》	名詞
＠ぺらっかのどうくつ	《ペラッカの捕食／ペラッカの洞窟》	名詞
＠ま	《マラキールの再誕／マラキールのぬかるみ》	名詞
＠まら	《マラキールの再誕／マラキールのぬかるみ》	名詞
＠まらき	《マラキールの再誕／マラキールのぬかるみ》	名詞
＠まらきー	《マラキールの再誕／マラキールのぬかるみ》	名詞
＠まらきーる	《マラキールの再誕／マラキールのぬかるみ》	名詞
＠まらきーるの	《マラキールの再誕／マラキールのぬかるみ》	名詞
＠まらきーるのさ	《マラキールの再誕／マラキールのぬかるみ》	名詞
＠まらきーるのさい	《マラキールの再誕／マラキールのぬかるみ》	名詞
＠まらきーるのさいた	《マラキールの再誕／マラキールのぬかるみ》	名詞
＠まらきーるのさいたん	《マラキールの再誕／マラキールのぬかるみ》	名詞
＠ま	《マラキールの再誕／マラキールのぬかるみ》	名詞
＠まら	《マラキールの再誕／マラキールのぬかるみ》	名詞
＠まらき	《マラキールの再誕／マラキールのぬかるみ》	名詞
＠まらきー	《マラキールの再誕／マラキールのぬかるみ》	名詞
＠まらきーる	《マラキールの再誕／マラキールのぬかるみ》	名詞
＠まらきーるの	《マラキールの再誕／マラキールのぬかるみ》	名詞
＠まらきーるのぬ	《マラキールの再誕／マラキールのぬかるみ》	名詞
＠まらきーるのぬか	《マラキールの再誕／マラキールのぬかるみ》	名詞
＠まらきーるのぬかる	《マラキールの再誕／マラキールのぬかるみ》	名詞
＠まらきーるのぬかるみ	《マラキールの再誕／マラキールのぬかるみ》	名詞
＠い	《遺跡の碑文》	名詞
＠いせ	《遺跡の碑文》	名詞
＠いせき	《遺跡の碑文》	名詞
＠いせきの	《遺跡の碑文》	名詞
＠いせきのひ	《遺跡の碑文》	名詞
＠いせきのひぶ	《遺跡の碑文》	名詞
＠いせきのひぶん	《遺跡の碑文》	名詞
＠か	《影の評決》	名詞
＠かげ	《影の評決》	名詞
＠かげの	《影の評決》	名詞
＠かげのひ	《影の評決》	名詞
＠かげのひょ	《影の評決》	名詞
＠かげのひょう	《影の評決》	名詞
＠かげのひょうけ	《影の評決》	名詞
＠かげのひょうけつ	《影の評決》	名詞
＠き	《希望の死、タボラックス》	名詞
＠きぼ	《希望の死、タボラックス》	名詞
＠きぼう	《希望の死、タボラックス》	名詞
＠きぼうの	《希望の死、タボラックス》	名詞
＠きぼうのし	《希望の死、タボラックス》	名詞
＠きぼうのし、	《希望の死、タボラックス》	名詞
＠きぼうのし、た	《希望の死、タボラックス》	名詞
＠きぼうのし、たぼ	《希望の死、タボラックス》	名詞
＠きぼうのし、たぼら	《希望の死、タボラックス》	名詞
＠きぼうのし、たぼらっ	《希望の死、タボラックス》	名詞
＠きぼうのし、たぼらっく	《希望の死、タボラックス》	名詞
＠きぼうのし、たぼらっくす	《希望の死、タボラックス》	名詞
＠た	《希望の死、タボラックス》	名詞
＠たぼ	《希望の死、タボラックス》	名詞
＠たぼら	《希望の死、タボラックス》	名詞
＠たぼらっ	《希望の死、タボラックス》	名詞
＠たぼらっく	《希望の死、タボラックス》	名詞
＠たぼらっくす	《希望の死、タボラックス》	名詞
＠す	《スカイクレイブの影》	名詞
＠すか	《スカイクレイブの影》	名詞
＠すかい	《スカイクレイブの影》	名詞
＠すかいく	《スカイクレイブの影》	名詞
＠すかいくれ	《スカイクレイブの影》	名詞
＠すかいくれい	《スカイクレイブの影》	名詞
＠すかいくれいぶ	《スカイクレイブの影》	名詞
＠すかいくれいぶの	《スカイクレイブの影》	名詞
＠すかいくれいぶのか	《スカイクレイブの影》	名詞
＠すかいくれいぶのかげ	《スカイクレイブの影》	名詞
＠せ	《切望の報奨》	名詞
＠せつ	《切望の報奨》	名詞
＠せつぼ	《切望の報奨》	名詞
＠せつぼう	《切望の報奨》	名詞
＠せつぼうの	《切望の報奨》	名詞
＠せつぼうのほ	《切望の報奨》	名詞
＠せつぼうのほう	《切望の報奨》	名詞
＠せつぼうのほうし	《切望の報奨》	名詞
＠せつぼうのほうしょ	《切望の報奨》	名詞
＠せつぼうのほうしょう	《切望の報奨》	名詞
＠た	《魂の粉砕》	名詞
＠たま	《魂の粉砕》	名詞
＠たまし	《魂の粉砕》	名詞
＠たましい	《魂の粉砕》	名詞
＠たましいの	《魂の粉砕》	名詞
＠たましいのふ	《魂の粉砕》	名詞
＠たましいのふん	《魂の粉砕》	名詞
＠たましいのふんさ	《魂の粉砕》	名詞
＠たましいのふんさい	《魂の粉砕》	名詞
＠は	《ハグラの噛み殺し／ハグラの群れ穴》	名詞
＠はぐ	《ハグラの噛み殺し／ハグラの群れ穴》	名詞
＠はぐら	《ハグラの噛み殺し／ハグラの群れ穴》	名詞
＠はぐらの	《ハグラの噛み殺し／ハグラの群れ穴》	名詞
＠はぐらのか	《ハグラの噛み殺し／ハグラの群れ穴》	名詞
＠はぐらのかみ	《ハグラの噛み殺し／ハグラの群れ穴》	名詞
＠はぐらのかみこ	《ハグラの噛み殺し／ハグラの群れ穴》	名詞
＠はぐらのかみころ	《ハグラの噛み殺し／ハグラの群れ穴》	名詞
＠はぐらのかみころし	《ハグラの噛み殺し／ハグラの群れ穴》	名詞
＠は	《ハグラの噛み殺し／ハグラの群れ穴》	名詞
＠はぐ	《ハグラの噛み殺し／ハグラの群れ穴》	名詞
＠はぐら	《ハグラの噛み殺し／ハグラの群れ穴》	名詞
＠はぐらの	《ハグラの噛み殺し／ハグラの群れ穴》	名詞
＠はぐらのむ	《ハグラの噛み殺し／ハグラの群れ穴》	名詞
＠はぐらのむれ	《ハグラの噛み殺し／ハグラの群れ穴》	名詞
＠はぐらのむれあ	《ハグラの噛み殺し／ハグラの群れ穴》	名詞
＠はぐらのむれあな	《ハグラの噛み殺し／ハグラの群れ穴》	名詞
＠ぼ	《忘却の虚僧》	名詞
＠ぼう	《忘却の虚僧》	名詞
＠ぼうき	《忘却の虚僧》	名詞
＠ぼうきゃ	《忘却の虚僧》	名詞
＠ぼうきゃく	《忘却の虚僧》	名詞
＠ぼうきゃくの	《忘却の虚僧》	名詞
＠ぼうきゃくのき	《忘却の虚僧》	名詞
＠ぼうきゃくのきょ	《忘却の虚僧》	名詞
＠ぼうきゃくのきょそ	《忘却の虚僧》	名詞
＠ぼうきゃくのきょそう	《忘却の虚僧》	名詞
＠よ	《夜鷲のあさり屋》	名詞
＠よる	《夜鷲のあさり屋》	名詞
＠よるわ	《夜鷲のあさり屋》	名詞
＠よるわし	《夜鷲のあさり屋》	名詞
＠よるわしの	《夜鷲のあさり屋》	名詞
＠よるわしのあ	《夜鷲のあさり屋》	名詞
＠よるわしのあさ	《夜鷲のあさり屋》	名詞
＠よるわしのあさり	《夜鷲のあさり屋》	名詞
＠よるわしのあさりや	《夜鷲のあさり屋》	名詞
＠あ	《アガディームの覚醒／地下遺跡、アガディーム》	名詞
＠あが	《アガディームの覚醒／地下遺跡、アガディーム》	名詞
＠あがで	《アガディームの覚醒／地下遺跡、アガディーム》	名詞
＠あがでぃ	《アガディームの覚醒／地下遺跡、アガディーム》	名詞
＠あがでぃー	《アガディームの覚醒／地下遺跡、アガディーム》	名詞
＠あがでぃーむ	《アガディームの覚醒／地下遺跡、アガディーム》	名詞
＠あがでぃーむの	《アガディームの覚醒／地下遺跡、アガディーム》	名詞
＠あがでぃーむのか	《アガディームの覚醒／地下遺跡、アガディーム》	名詞
＠あがでぃーむのかく	《アガディームの覚醒／地下遺跡、アガディーム》	名詞
＠あがでぃーむのかくせ	《アガディームの覚醒／地下遺跡、アガディーム》	名詞
＠あがでぃーむのかくせい	《アガディームの覚醒／地下遺跡、アガディーム》	名詞
＠ち	《アガディームの覚醒／地下遺跡、アガディーム》	名詞
＠ちか	《アガディームの覚醒／地下遺跡、アガディーム》	名詞
＠ちかい	《アガディームの覚醒／地下遺跡、アガディーム》	名詞
＠ちかいせ	《アガディームの覚醒／地下遺跡、アガディーム》	名詞
＠ちかいせき	《アガディームの覚醒／地下遺跡、アガディーム》	名詞
＠ちかいせき、	《アガディームの覚醒／地下遺跡、アガディーム》	名詞
＠ちかいせき、あ	《アガディームの覚醒／地下遺跡、アガディーム》	名詞
＠ちかいせき、あが	《アガディームの覚醒／地下遺跡、アガディーム》	名詞
＠ちかいせき、あがで	《アガディームの覚醒／地下遺跡、アガディーム》	名詞
＠ちかいせき、あがでぃ	《アガディームの覚醒／地下遺跡、アガディーム》	名詞
＠ちかいせき、あがでぃー	《アガディームの覚醒／地下遺跡、アガディーム》	名詞
＠ちかいせき、あがでぃーむ	《アガディームの覚醒／地下遺跡、アガディーム》	名詞
＠す	《スカイクレイブの災い魔》	名詞
＠すか	《スカイクレイブの災い魔》	名詞
＠すかい	《スカイクレイブの災い魔》	名詞
＠すかいく	《スカイクレイブの災い魔》	名詞
＠すかいくれ	《スカイクレイブの災い魔》	名詞
＠すかいくれい	《スカイクレイブの災い魔》	名詞
＠すかいくれいぶ	《スカイクレイブの災い魔》	名詞
＠すかいくれいぶの	《スカイクレイブの災い魔》	名詞
＠すかいくれいぶのわ	《スカイクレイブの災い魔》	名詞
＠すかいくれいぶのわざ	《スカイクレイブの災い魔》	名詞
＠すかいくれいぶのわざわ	《スカイクレイブの災い魔》	名詞
＠すかいくれいぶのわざわい	《スカイクレイブの災い魔》	名詞
＠すかいくれいぶのわざわいま	《スカイクレイブの災い魔》	名詞
＠さ	《最後の血の長、ドラーナ》	名詞
＠さい	《最後の血の長、ドラーナ》	名詞
＠さいご	《最後の血の長、ドラーナ》	名詞
＠さいごの	《最後の血の長、ドラーナ》	名詞
＠さいごのち	《最後の血の長、ドラーナ》	名詞
＠さいごのちの	《最後の血の長、ドラーナ》	名詞
＠さいごのちのお	《最後の血の長、ドラーナ》	名詞
＠さいごのちのおさ	《最後の血の長、ドラーナ》	名詞
＠さいごのちのおさ、	《最後の血の長、ドラーナ》	名詞
＠さいごのちのおさ、ど	《最後の血の長、ドラーナ》	名詞
＠さいごのちのおさ、どら	《最後の血の長、ドラーナ》	名詞
＠さいごのちのおさ、どらー	《最後の血の長、ドラーナ》	名詞
＠さいごのちのおさ、どらーな	《最後の血の長、ドラーナ》	名詞
＠ど	《最後の血の長、ドラーナ》	名詞
＠どら	《最後の血の長、ドラーナ》	名詞
＠どらー	《最後の血の長、ドラーナ》	名詞
＠どらーな	《最後の血の長、ドラーナ》	名詞
＠あ	《アクームのヘルハウンド》	名詞
＠あく	《アクームのヘルハウンド》	名詞
＠あくー	《アクームのヘルハウンド》	名詞
＠あくーむ	《アクームのヘルハウンド》	名詞
＠あくーむの	《アクームのヘルハウンド》	名詞
＠あくーむのへ	《アクームのヘルハウンド》	名詞
＠あくーむのへる	《アクームのヘルハウンド》	名詞
＠あくーむのへるは	《アクームのヘルハウンド》	名詞
＠あくーむのへるはう	《アクームのヘルハウンド》	名詞
＠あくーむのへるはうん	《アクームのヘルハウンド》	名詞
＠あくーむのへるはうんど	《アクームのヘルハウンド》	名詞
＠い	《異常な怒り》	名詞
＠いじ	《異常な怒り》	名詞
＠いじょ	《異常な怒り》	名詞
＠いじょう	《異常な怒り》	名詞
＠いじょうな	《異常な怒り》	名詞
＠いじょうない	《異常な怒り》	名詞
＠いじょうないか	《異常な怒り》	名詞
＠いじょうないかり	《異常な怒り》	名詞
＠か	《火砕のヘリオン》	名詞
＠かさ	《火砕のヘリオン》	名詞
＠かさい	《火砕のヘリオン》	名詞
＠かさいの	《火砕のヘリオン》	名詞
＠かさいのへ	《火砕のヘリオン》	名詞
＠かさいのへり	《火砕のヘリオン》	名詞
＠かさいのへりお	《火砕のヘリオン》	名詞
＠かさいのへりおん	《火砕のヘリオン》	名詞
＠ぐ	《ぐらつく峰の伏兵》	名詞
＠ぐら	《ぐらつく峰の伏兵》	名詞
＠ぐらつ	《ぐらつく峰の伏兵》	名詞
＠ぐらつく	《ぐらつく峰の伏兵》	名詞
＠ぐらつくみ	《ぐらつく峰の伏兵》	名詞
＠ぐらつくみね	《ぐらつく峰の伏兵》	名詞
＠ぐらつくみねの	《ぐらつく峰の伏兵》	名詞
＠ぐらつくみねのふ	《ぐらつく峰の伏兵》	名詞
＠ぐらつくみねのふく	《ぐらつく峰の伏兵》	名詞
＠ぐらつくみねのふくへ	《ぐらつく峰の伏兵》	名詞
＠ぐらつくみねのふくへい	《ぐらつく峰の伏兵》	名詞
＠く	《苦しめる声》	名詞
＠くる	《苦しめる声》	名詞
＠くるし	《苦しめる声》	名詞
＠くるしめ	《苦しめる声》	名詞
＠くるしめる	《苦しめる声》	名詞
＠くるしめるこ	《苦しめる声》	名詞
＠くるしめるこえ	《苦しめる声》	名詞
＠ぐ	《グロータグの虫捕り》	名詞
＠ぐろ	《グロータグの虫捕り》	名詞
＠ぐろー	《グロータグの虫捕り》	名詞
＠ぐろーた	《グロータグの虫捕り》	名詞
＠ぐろーたぐ	《グロータグの虫捕り》	名詞
＠ぐろーたぐの	《グロータグの虫捕り》	名詞
＠ぐろーたぐのむ	《グロータグの虫捕り》	名詞
＠ぐろーたぐのむし	《グロータグの虫捕り》	名詞
＠ぐろーたぐのむしと	《グロータグの虫捕り》	名詞
＠ぐろーたぐのむしとり	《グロータグの虫捕り》	名詞
＠け	《献身的な電術師》	名詞
＠けん	《献身的な電術師》	名詞
＠けんし	《献身的な電術師》	名詞
＠けんしん	《献身的な電術師》	名詞
＠けんしんて	《献身的な電術師》	名詞
＠けんしんてき	《献身的な電術師》	名詞
＠けんしんてきな	《献身的な電術師》	名詞
＠けんしんてきなで	《献身的な電術師》	名詞
＠けんしんてきなでん	《献身的な電術師》	名詞
＠けんしんてきなでんじ	《献身的な電術師》	名詞
＠けんしんてきなでんじゅ	《献身的な電術師》	名詞
＠けんしんてきなでんじゅつ	《献身的な電術師》	名詞
＠けんしんてきなでんじゅつし	《献身的な電術師》	名詞
＠こ	《焦がし乗り》	名詞
＠こが	《焦がし乗り》	名詞
＠こがし	《焦がし乗り》	名詞
＠こがしの	《焦がし乗り》	名詞
＠こがしのり	《焦がし乗り》	名詞
＠じ	《浄化の野火》	名詞
＠じょ	《浄化の野火》	名詞
＠じょう	《浄化の野火》	名詞
＠じょうか	《浄化の野火》	名詞
＠じょうかの	《浄化の野火》	名詞
＠じょうかのの	《浄化の野火》	名詞
＠じょうかののび	《浄化の野火》	名詞
＠た	《タクタクの瓦礫砦》	名詞
＠たく	《タクタクの瓦礫砦》	名詞
＠たくた	《タクタクの瓦礫砦》	名詞
＠たくたく	《タクタクの瓦礫砦》	名詞
＠たくたくの	《タクタクの瓦礫砦》	名詞
＠たくたくのが	《タクタクの瓦礫砦》	名詞
＠たくたくのがれ	《タクタクの瓦礫砦》	名詞
＠たくたくのがれき	《タクタクの瓦礫砦》	名詞
＠たくたくのがれきと	《タクタクの瓦礫砦》	名詞
＠たくたくのがれきとり	《タクタクの瓦礫砦》	名詞
＠たくたくのがれきとりで	《タクタクの瓦礫砦》	名詞
＠た	《探検隊の勇者》	名詞
＠たん	《探検隊の勇者》	名詞
＠たんけ	《探検隊の勇者》	名詞
＠たんけん	《探検隊の勇者》	名詞
＠たんけんた	《探検隊の勇者》	名詞
＠たんけんたい	《探検隊の勇者》	名詞
＠たんけんたいの	《探検隊の勇者》	名詞
＠たんけんたいのゆ	《探検隊の勇者》	名詞
＠たんけんたいのゆう	《探検隊の勇者》	名詞
＠たんけんたいのゆうし	《探検隊の勇者》	名詞
＠たんけんたいのゆうしゃ	《探検隊の勇者》	名詞
＠じ	《地割れの魔術師》	名詞
＠じわ	《地割れの魔術師》	名詞
＠じわれ	《地割れの魔術師》	名詞
＠じわれの	《地割れの魔術師》	名詞
＠じわれのま	《地割れの魔術師》	名詞
＠じわれのまじ	《地割れの魔術師》	名詞
＠じわれのまじゅ	《地割れの魔術師》	名詞
＠じわれのまじゅつ	《地割れの魔術師》	名詞
＠じわれのまじゅつし	《地割れの魔術師》	名詞
＠ど	《同期した魔術》	名詞
＠どう	《同期した魔術》	名詞
＠どうき	《同期した魔術》	名詞
＠どうきし	《同期した魔術》	名詞
＠どうきした	《同期した魔術》	名詞
＠どうきしたま	《同期した魔術》	名詞
＠どうきしたまじ	《同期した魔術》	名詞
＠どうきしたまじゅ	《同期した魔術》	名詞
＠どうきしたまじゅつ	《同期した魔術》	名詞
＠ひ	《火吐きラガーク》	名詞
＠ひは	《火吐きラガーク》	名詞
＠ひはき	《火吐きラガーク》	名詞
＠ひはきら	《火吐きラガーク》	名詞
＠ひはきらが	《火吐きラガーク》	名詞
＠ひはきらがー	《火吐きラガーク》	名詞
＠ひはきらがーく	《火吐きラガーク》	名詞
＠ひ	《拾った刃》	名詞
＠ひろ	《拾った刃》	名詞
＠ひろっ	《拾った刃》	名詞
＠ひろった	《拾った刃》	名詞
＠ひろったや	《拾った刃》	名詞
＠ひろったやい	《拾った刃》	名詞
＠ひろったやいば	《拾った刃》	名詞
＠み	《密行する案内人》	名詞
＠みっ	《密行する案内人》	名詞
＠みっこ	《密行する案内人》	名詞
＠みっこう	《密行する案内人》	名詞
＠みっこうす	《密行する案内人》	名詞
＠みっこうする	《密行する案内人》	名詞
＠みっこうするあ	《密行する案内人》	名詞
＠みっこうするあん	《密行する案内人》	名詞
＠みっこうするあんな	《密行する案内人》	名詞
＠みっこうするあんない	《密行する案内人》	名詞
＠みっこうするあんないに	《密行する案内人》	名詞
＠みっこうするあんないにん	《密行する案内人》	名詞
＠も	《猛炎の連射》	名詞
＠もう	《猛炎の連射》	名詞
＠もうえ	《猛炎の連射》	名詞
＠もうえん	《猛炎の連射》	名詞
＠もうえんの	《猛炎の連射》	名詞
＠もうえんのれ	《猛炎の連射》	名詞
＠もうえんのれん	《猛炎の連射》	名詞
＠もうえんのれんし	《猛炎の連射》	名詞
＠もうえんのれんしゃ	《猛炎の連射》	名詞
＠よ	《溶鉄破》	名詞
＠よう	《溶鉄破》	名詞
＠ようて	《溶鉄破》	名詞
＠ようてつ	《溶鉄破》	名詞
＠ようてつは	《溶鉄破》	名詞
＠ら	《乱動の噴火》	名詞
＠らん	《乱動の噴火》	名詞
＠らんど	《乱動の噴火》	名詞
＠らんどう	《乱動の噴火》	名詞
＠らんどうの	《乱動の噴火》	名詞
＠らんどうのふ	《乱動の噴火》	名詞
＠らんどうのふん	《乱動の噴火》	名詞
＠らんどうのふんか	《乱動の噴火》	名詞
＠あ	《アクームの戦士／アクームの歯》	名詞
＠あく	《アクームの戦士／アクームの歯》	名詞
＠あくー	《アクームの戦士／アクームの歯》	名詞
＠あくーむ	《アクームの戦士／アクームの歯》	名詞
＠あくーむの	《アクームの戦士／アクームの歯》	名詞
＠あくーむのせ	《アクームの戦士／アクームの歯》	名詞
＠あくーむのせん	《アクームの戦士／アクームの歯》	名詞
＠あくーむのせんし	《アクームの戦士／アクームの歯》	名詞
＠あ	《アクームの戦士／アクームの歯》	名詞
＠あく	《アクームの戦士／アクームの歯》	名詞
＠あくー	《アクームの戦士／アクームの歯》	名詞
＠あくーむ	《アクームの戦士／アクームの歯》	名詞
＠あくーむの	《アクームの戦士／アクームの歯》	名詞
＠あくーむのは	《アクームの戦士／アクームの歯》	名詞
＠う	《歌狂いの裏切り／歌狂いの遺跡》	名詞
＠うた	《歌狂いの裏切り／歌狂いの遺跡》	名詞
＠うたぐ	《歌狂いの裏切り／歌狂いの遺跡》	名詞
＠うたぐる	《歌狂いの裏切り／歌狂いの遺跡》	名詞
＠うたぐるい	《歌狂いの裏切り／歌狂いの遺跡》	名詞
＠うたぐるいの	《歌狂いの裏切り／歌狂いの遺跡》	名詞
＠うたぐるいのう	《歌狂いの裏切り／歌狂いの遺跡》	名詞
＠うたぐるいのうら	《歌狂いの裏切り／歌狂いの遺跡》	名詞
＠うたぐるいのうらぎ	《歌狂いの裏切り／歌狂いの遺跡》	名詞
＠うたぐるいのうらぎり	《歌狂いの裏切り／歌狂いの遺跡》	名詞
＠う	《歌狂いの裏切り／歌狂いの遺跡》	名詞
＠うた	《歌狂いの裏切り／歌狂いの遺跡》	名詞
＠うたぐ	《歌狂いの裏切り／歌狂いの遺跡》	名詞
＠うたぐる	《歌狂いの裏切り／歌狂いの遺跡》	名詞
＠うたぐるい	《歌狂いの裏切り／歌狂いの遺跡》	名詞
＠うたぐるいの	《歌狂いの裏切り／歌狂いの遺跡》	名詞
＠うたぐるいのい	《歌狂いの裏切り／歌狂いの遺跡》	名詞
＠うたぐるいのいせ	《歌狂いの裏切り／歌狂いの遺跡》	名詞
＠うたぐるいのいせき	《歌狂いの裏切り／歌狂いの遺跡》	名詞
＠が	《崖崩れの魔術師》	名詞
＠がけ	《崖崩れの魔術師》	名詞
＠がけく	《崖崩れの魔術師》	名詞
＠がけくず	《崖崩れの魔術師》	名詞
＠がけくずれ	《崖崩れの魔術師》	名詞
＠がけくずれの	《崖崩れの魔術師》	名詞
＠がけくずれのま	《崖崩れの魔術師》	名詞
＠がけくずれのまじ	《崖崩れの魔術師》	名詞
＠がけくずれのまじゅ	《崖崩れの魔術師》	名詞
＠がけくずれのまじゅつ	《崖崩れの魔術師》	名詞
＠がけくずれのまじゅつし	《崖崩れの魔術師》	名詞
＠か	《カズールの憤怒／カズールの崖》	名詞
＠かず	《カズールの憤怒／カズールの崖》	名詞
＠かずー	《カズールの憤怒／カズールの崖》	名詞
＠かずーる	《カズールの憤怒／カズールの崖》	名詞
＠かずーるの	《カズールの憤怒／カズールの崖》	名詞
＠かずーるのふ	《カズールの憤怒／カズールの崖》	名詞
＠かずーるのふん	《カズールの憤怒／カズールの崖》	名詞
＠かずーるのふんぬ	《カズールの憤怒／カズールの崖》	名詞
＠か	《カズールの憤怒／カズールの崖》	名詞
＠かず	《カズールの憤怒／カズールの崖》	名詞
＠かずー	《カズールの憤怒／カズールの崖》	名詞
＠かずーる	《カズールの憤怒／カズールの崖》	名詞
＠かずーるの	《カズールの憤怒／カズールの崖》	名詞
＠かずーるのが	《カズールの憤怒／カズールの崖》	名詞
＠かずーるのがけ	《カズールの憤怒／カズールの崖》	名詞
＠ぐ	《グロータグの夜走り》	名詞
＠ぐろ	《グロータグの夜走り》	名詞
＠ぐろー	《グロータグの夜走り》	名詞
＠ぐろーた	《グロータグの夜走り》	名詞
＠ぐろーたぐ	《グロータグの夜走り》	名詞
＠ぐろーたぐの	《グロータグの夜走り》	名詞
＠ぐろーたぐのよ	《グロータグの夜走り》	名詞
＠ぐろーたぐのよば	《グロータグの夜走り》	名詞
＠ぐろーたぐのよばし	《グロータグの夜走り》	名詞
＠ぐろーたぐのよばしり	《グロータグの夜走り》	名詞
＠ご	《ゴーマ・ファーダの先兵》	名詞
＠ごー	《ゴーマ・ファーダの先兵》	名詞
＠ごーま	《ゴーマ・ファーダの先兵》	名詞
＠ごーま・	《ゴーマ・ファーダの先兵》	名詞
＠ごーま・ふ	《ゴーマ・ファーダの先兵》	名詞
＠ごーま・ふぁ	《ゴーマ・ファーダの先兵》	名詞
＠ごーま・ふぁー	《ゴーマ・ファーダの先兵》	名詞
＠ごーま・ふぁーだ	《ゴーマ・ファーダの先兵》	名詞
＠ごーま・ふぁーだの	《ゴーマ・ファーダの先兵》	名詞
＠ごーま・ふぁーだのせ	《ゴーマ・ファーダの先兵》	名詞
＠ごーま・ふぁーだのせん	《ゴーマ・ファーダの先兵》	名詞
＠ごーま・ふぁーだのせんぺ	《ゴーマ・ファーダの先兵》	名詞
＠ごーま・ふぁーだのせんぺい	《ゴーマ・ファーダの先兵》	名詞
＠す	《スカイクレイブの土百足》	名詞
＠すか	《スカイクレイブの土百足》	名詞
＠すかい	《スカイクレイブの土百足》	名詞
＠すかいく	《スカイクレイブの土百足》	名詞
＠すかいくれ	《スカイクレイブの土百足》	名詞
＠すかいくれい	《スカイクレイブの土百足》	名詞
＠すかいくれいぶ	《スカイクレイブの土百足》	名詞
＠すかいくれいぶの	《スカイクレイブの土百足》	名詞
＠すかいくれいぶのつ	《スカイクレイブの土百足》	名詞
＠すかいくれいぶのつち	《スカイクレイブの土百足》	名詞
＠すかいくれいぶのつちむ	《スカイクレイブの土百足》	名詞
＠すかいくれいぶのつちむか	《スカイクレイブの土百足》	名詞
＠すかいくれいぶのつちむかで	《スカイクレイブの土百足》	名詞
＠ど	《髑髏砕きのミノタウルス》	名詞
＠どく	《髑髏砕きのミノタウルス》	名詞
＠どくろ	《髑髏砕きのミノタウルス》	名詞
＠どくろく	《髑髏砕きのミノタウルス》	名詞
＠どくろくだ	《髑髏砕きのミノタウルス》	名詞
＠どくろくだき	《髑髏砕きのミノタウルス》	名詞
＠どくろくだきの	《髑髏砕きのミノタウルス》	名詞
＠どくろくだきのみ	《髑髏砕きのミノタウルス》	名詞
＠どくろくだきのみの	《髑髏砕きのミノタウルス》	名詞
＠どくろくだきのみのた	《髑髏砕きのミノタウルス》	名詞
＠どくろくだきのみのたう	《髑髏砕きのミノタウルス》	名詞
＠どくろくだきのみのたうる	《髑髏砕きのミノタウルス》	名詞
＠どくろくだきのみのたうるす	《髑髏砕きのミノタウルス》	名詞
＠と	《棘平原の危険／棘平原の洞窟》	名詞
＠とげ	《棘平原の危険／棘平原の洞窟》	名詞
＠とげへ	《棘平原の危険／棘平原の洞窟》	名詞
＠とげへい	《棘平原の危険／棘平原の洞窟》	名詞
＠とげへいげ	《棘平原の危険／棘平原の洞窟》	名詞
＠とげへいげん	《棘平原の危険／棘平原の洞窟》	名詞
＠とげへいげんの	《棘平原の危険／棘平原の洞窟》	名詞
＠とげへいげんのき	《棘平原の危険／棘平原の洞窟》	名詞
＠とげへいげんのきけ	《棘平原の危険／棘平原の洞窟》	名詞
＠とげへいげんのきけん	《棘平原の危険／棘平原の洞窟》	名詞
＠と	《棘平原の危険／棘平原の洞窟》	名詞
＠とげ	《棘平原の危険／棘平原の洞窟》	名詞
＠とげへ	《棘平原の危険／棘平原の洞窟》	名詞
＠とげへい	《棘平原の危険／棘平原の洞窟》	名詞
＠とげへいげ	《棘平原の危険／棘平原の洞窟》	名詞
＠とげへいげん	《棘平原の危険／棘平原の洞窟》	名詞
＠とげへいげんの	《棘平原の危険／棘平原の洞窟》	名詞
＠とげへいげんのど	《棘平原の危険／棘平原の洞窟》	名詞
＠とげへいげんのどう	《棘平原の危険／棘平原の洞窟》	名詞
＠とげへいげんのどうく	《棘平原の危険／棘平原の洞窟》	名詞
＠とげへいげんのどうくつ	《棘平原の危険／棘平原の洞窟》	名詞
＠と	《轟く叱責》	名詞
＠とど	《轟く叱責》	名詞
＠とどろ	《轟く叱責》	名詞
＠とどろく	《轟く叱責》	名詞
＠とどろくし	《轟く叱責》	名詞
＠とどろくしっ	《轟く叱責》	名詞
＠とどろくしっせ	《轟く叱責》	名詞
＠とどろくしっせき	《轟く叱責》	名詞
＠と	《轟く火花魔道士》	名詞
＠とど	《轟く火花魔道士》	名詞
＠とどろ	《轟く火花魔道士》	名詞
＠とどろく	《轟く火花魔道士》	名詞
＠とどろくひ	《轟く火花魔道士》	名詞
＠とどろくひば	《轟く火花魔道士》	名詞
＠とどろくひばな	《轟く火花魔道士》	名詞
＠とどろくひばなま	《轟く火花魔道士》	名詞
＠とどろくひばなまど	《轟く火花魔道士》	名詞
＠とどろくひばなまどう	《轟く火花魔道士》	名詞
＠とどろくひばなまどうし	《轟く火花魔道士》	名詞
＠ひ	《火刃の突撃者》	名詞
＠ひや	《火刃の突撃者》	名詞
＠ひやい	《火刃の突撃者》	名詞
＠ひやいば	《火刃の突撃者》	名詞
＠ひやいばの	《火刃の突撃者》	名詞
＠ひやいばのと	《火刃の突撃者》	名詞
＠ひやいばのとつ	《火刃の突撃者》	名詞
＠ひやいばのとつげ	《火刃の突撃者》	名詞
＠ひやいばのとつげき	《火刃の突撃者》	名詞
＠ひやいばのとつげきし	《火刃の突撃者》	名詞
＠ひやいばのとつげきしゃ	《火刃の突撃者》	名詞
＠も	《燃えがら地獄》	名詞
＠もえ	《燃えがら地獄》	名詞
＠もえが	《燃えがら地獄》	名詞
＠もえがら	《燃えがら地獄》	名詞
＠もえがらじ	《燃えがら地獄》	名詞
＠もえがらじご	《燃えがら地獄》	名詞
＠もえがらじごく	《燃えがら地獄》	名詞
＠ヴ	《ヴァラクートの覚醒／ヴァラクートの石鍛冶場》	名詞
＠ヴぁ	《ヴァラクートの覚醒／ヴァラクートの石鍛冶場》	名詞
＠ヴぁら	《ヴァラクートの覚醒／ヴァラクートの石鍛冶場》	名詞
＠ヴぁらく	《ヴァラクートの覚醒／ヴァラクートの石鍛冶場》	名詞
＠ヴぁらくー	《ヴァラクートの覚醒／ヴァラクートの石鍛冶場》	名詞
＠ヴぁらくーと	《ヴァラクートの覚醒／ヴァラクートの石鍛冶場》	名詞
＠ヴぁらくーとの	《ヴァラクートの覚醒／ヴァラクートの石鍛冶場》	名詞
＠ヴぁらくーとのか	《ヴァラクートの覚醒／ヴァラクートの石鍛冶場》	名詞
＠ヴぁらくーとのかく	《ヴァラクートの覚醒／ヴァラクートの石鍛冶場》	名詞
＠ヴぁらくーとのかくせ	《ヴァラクートの覚醒／ヴァラクートの石鍛冶場》	名詞
＠ヴぁらくーとのかくせい	《ヴァラクートの覚醒／ヴァラクートの石鍛冶場》	名詞
＠ヴ	《ヴァラクートの覚醒／ヴァラクートの石鍛冶場》	名詞
＠ヴぁ	《ヴァラクートの覚醒／ヴァラクートの石鍛冶場》	名詞
＠ヴぁら	《ヴァラクートの覚醒／ヴァラクートの石鍛冶場》	名詞
＠ヴぁらく	《ヴァラクートの覚醒／ヴァラクートの石鍛冶場》	名詞
＠ヴぁらくー	《ヴァラクートの覚醒／ヴァラクートの石鍛冶場》	名詞
＠ヴぁらくーと	《ヴァラクートの覚醒／ヴァラクートの石鍛冶場》	名詞
＠ヴぁらくーとの	《ヴァラクートの覚醒／ヴァラクートの石鍛冶場》	名詞
＠ヴぁらくーとのい	《ヴァラクートの覚醒／ヴァラクートの石鍛冶場》	名詞
＠ヴぁらくーとのいし	《ヴァラクートの覚醒／ヴァラクートの石鍛冶場》	名詞
＠ヴぁらくーとのいしか	《ヴァラクートの覚醒／ヴァラクートの石鍛冶場》	名詞
＠ヴぁらくーとのいしかじ	《ヴァラクートの覚醒／ヴァラクートの石鍛冶場》	名詞
＠ヴぁらくーとのいしかじじ	《ヴァラクートの覚醒／ヴァラクートの石鍛冶場》	名詞
＠ヴぁらくーとのいしかじじょ	《ヴァラクートの覚醒／ヴァラクートの石鍛冶場》	名詞
＠ヴぁらくーとのいしかじじょう	《ヴァラクートの覚醒／ヴァラクートの石鍛冶場》	名詞
＠ヴ	《ヴァラクートの探検》	名詞
＠ヴぁ	《ヴァラクートの探検》	名詞
＠ヴぁら	《ヴァラクートの探検》	名詞
＠ヴぁらく	《ヴァラクートの探検》	名詞
＠ヴぁらくー	《ヴァラクートの探検》	名詞
＠ヴぁらくーと	《ヴァラクートの探検》	名詞
＠ヴぁらくーとの	《ヴァラクートの探検》	名詞
＠ヴぁらくーとのた	《ヴァラクートの探検》	名詞
＠ヴぁらくーとのたん	《ヴァラクートの探検》	名詞
＠ヴぁらくーとのたんけ	《ヴァラクートの探検》	名詞
＠ヴぁらくーとのたんけん	《ヴァラクートの探検》	名詞
＠か	《カルガの威嚇者》	名詞
＠かる	《カルガの威嚇者》	名詞
＠かるが	《カルガの威嚇者》	名詞
＠かるがの	《カルガの威嚇者》	名詞
＠かるがのい	《カルガの威嚇者》	名詞
＠かるがのいか	《カルガの威嚇者》	名詞
＠かるがのいかく	《カルガの威嚇者》	名詞
＠かるがのいかくし	《カルガの威嚇者》	名詞
＠かるがのいかくしゃ	《カルガの威嚇者》	名詞
＠ど	《髑髏砕きの突撃者》	名詞
＠どく	《髑髏砕きの突撃者》	名詞
＠どくろ	《髑髏砕きの突撃者》	名詞
＠どくろく	《髑髏砕きの突撃者》	名詞
＠どくろくだ	《髑髏砕きの突撃者》	名詞
＠どくろくだき	《髑髏砕きの突撃者》	名詞
＠どくろくだきの	《髑髏砕きの突撃者》	名詞
＠どくろくだきのと	《髑髏砕きの突撃者》	名詞
＠どくろくだきのとつ	《髑髏砕きの突撃者》	名詞
＠どくろくだきのとつげ	《髑髏砕きの突撃者》	名詞
＠どくろくだきのとつげき	《髑髏砕きの突撃者》	名詞
＠どくろくだきのとつげきし	《髑髏砕きの突撃者》	名詞
＠どくろくだきのとつげきしゃ	《髑髏砕きの突撃者》	名詞
＠な	《ナヒリの石成術》	名詞
＠なひ	《ナヒリの石成術》	名詞
＠なひり	《ナヒリの石成術》	名詞
＠なひりの	《ナヒリの石成術》	名詞
＠なひりのせ	《ナヒリの石成術》	名詞
＠なひりのせき	《ナヒリの石成術》	名詞
＠なひりのせきせ	《ナヒリの石成術》	名詞
＠なひりのせきせい	《ナヒリの石成術》	名詞
＠なひりのせきせいじ	《ナヒリの石成術》	名詞
＠なひりのせきせいじゅ	《ナヒリの石成術》	名詞
＠なひりのせきせいじゅつ	《ナヒリの石成術》	名詞
＠ひ	《秘宝荒らし》	名詞
＠ひほ	《秘宝荒らし》	名詞
＠ひほう	《秘宝荒らし》	名詞
＠ひほうあ	《秘宝荒らし》	名詞
＠ひほうあら	《秘宝荒らし》	名詞
＠ひほうあらし	《秘宝荒らし》	名詞
＠ま	《マグマの媒介者》	名詞
＠まぐ	《マグマの媒介者》	名詞
＠まぐま	《マグマの媒介者》	名詞
＠まぐまの	《マグマの媒介者》	名詞
＠まぐまのば	《マグマの媒介者》	名詞
＠まぐまのばい	《マグマの媒介者》	名詞
＠まぐまのばいか	《マグマの媒介者》	名詞
＠まぐまのばいかい	《マグマの媒介者》	名詞
＠まぐまのばいかいし	《マグマの媒介者》	名詞
＠まぐまのばいかいしゃ	《マグマの媒介者》	名詞
＠む	《むら気な猛導獣》	名詞
＠むら	《むら気な猛導獣》	名詞
＠むらき	《むら気な猛導獣》	名詞
＠むらきな	《むら気な猛導獣》	名詞
＠むらきなも	《むら気な猛導獣》	名詞
＠むらきなもう	《むら気な猛導獣》	名詞
＠むらきなもうど	《むら気な猛導獣》	名詞
＠むらきなもうどう	《むら気な猛導獣》	名詞
＠むらきなもうどうじ	《むら気な猛導獣》	名詞
＠むらきなもうどうじゅ	《むら気な猛導獣》	名詞
＠むらきなもうどうじゅう	《むら気な猛導獣》	名詞
＠ら	《乱動する渦》	名詞
＠らん	《乱動する渦》	名詞
＠らんど	《乱動する渦》	名詞
＠らんどう	《乱動する渦》	名詞
＠らんどうす	《乱動する渦》	名詞
＠らんどうする	《乱動する渦》	名詞
＠らんどうするう	《乱動する渦》	名詞
＠らんどうするうず	《乱動する渦》	名詞
＠あ	《アクームの怒り、モラウグ》	名詞
＠あく	《アクームの怒り、モラウグ》	名詞
＠あくー	《アクームの怒り、モラウグ》	名詞
＠あくーむ	《アクームの怒り、モラウグ》	名詞
＠あくーむの	《アクームの怒り、モラウグ》	名詞
＠あくーむのい	《アクームの怒り、モラウグ》	名詞
＠あくーむのいか	《アクームの怒り、モラウグ》	名詞
＠あくーむのいかり	《アクームの怒り、モラウグ》	名詞
＠あくーむのいかり、	《アクームの怒り、モラウグ》	名詞
＠あくーむのいかり、も	《アクームの怒り、モラウグ》	名詞
＠あくーむのいかり、もら	《アクームの怒り、モラウグ》	名詞
＠あくーむのいかり、もらう	《アクームの怒り、モラウグ》	名詞
＠あくーむのいかり、もらうぐ	《アクームの怒り、モラウグ》	名詞
＠も	《アクームの怒り、モラウグ》	名詞
＠もら	《アクームの怒り、モラウグ》	名詞
＠もらう	《アクームの怒り、モラウグ》	名詞
＠もらうぐ	《アクームの怒り、モラウグ》	名詞
＠ど	《髑髏砕きの一撃／鎚の山道、髑髏砕き》	名詞
＠どく	《髑髏砕きの一撃／鎚の山道、髑髏砕き》	名詞
＠どくろ	《髑髏砕きの一撃／鎚の山道、髑髏砕き》	名詞
＠どくろく	《髑髏砕きの一撃／鎚の山道、髑髏砕き》	名詞
＠どくろくだ	《髑髏砕きの一撃／鎚の山道、髑髏砕き》	名詞
＠どくろくだき	《髑髏砕きの一撃／鎚の山道、髑髏砕き》	名詞
＠どくろくだきの	《髑髏砕きの一撃／鎚の山道、髑髏砕き》	名詞
＠どくろくだきのい	《髑髏砕きの一撃／鎚の山道、髑髏砕き》	名詞
＠どくろくだきのいち	《髑髏砕きの一撃／鎚の山道、髑髏砕き》	名詞
＠どくろくだきのいちげ	《髑髏砕きの一撃／鎚の山道、髑髏砕き》	名詞
＠どくろくだきのいちげき	《髑髏砕きの一撃／鎚の山道、髑髏砕き》	名詞
＠つ	《髑髏砕きの一撃／鎚の山道、髑髏砕き》	名詞
＠つち	《髑髏砕きの一撃／鎚の山道、髑髏砕き》	名詞
＠つちの	《髑髏砕きの一撃／鎚の山道、髑髏砕き》	名詞
＠つちのや	《髑髏砕きの一撃／鎚の山道、髑髏砕き》	名詞
＠つちのやま	《髑髏砕きの一撃／鎚の山道、髑髏砕き》	名詞
＠つちのやまみ	《髑髏砕きの一撃／鎚の山道、髑髏砕き》	名詞
＠つちのやまみち	《髑髏砕きの一撃／鎚の山道、髑髏砕き》	名詞
＠つちのやまみち、	《髑髏砕きの一撃／鎚の山道、髑髏砕き》	名詞
＠つちのやまみち、ど	《髑髏砕きの一撃／鎚の山道、髑髏砕き》	名詞
＠つちのやまみち、どく	《髑髏砕きの一撃／鎚の山道、髑髏砕き》	名詞
＠つちのやまみち、どくろ	《髑髏砕きの一撃／鎚の山道、髑髏砕き》	名詞
＠つちのやまみち、どくろく	《髑髏砕きの一撃／鎚の山道、髑髏砕き》	名詞
＠つちのやまみち、どくろくだ	《髑髏砕きの一撃／鎚の山道、髑髏砕き》	名詞
＠つちのやまみち、どくろくだき	《髑髏砕きの一撃／鎚の山道、髑髏砕き》	名詞
＠り	《力線の暴君》	名詞
＠りき	《力線の暴君》	名詞
＠りきせ	《力線の暴君》	名詞
＠りきせん	《力線の暴君》	名詞
＠りきせんの	《力線の暴君》	名詞
＠りきせんのぼ	《力線の暴君》	名詞
＠りきせんのぼう	《力線の暴君》	名詞
＠りきせんのぼうく	《力線の暴君》	名詞
＠りきせんのぼうくん	《力線の暴君》	名詞
＠あ	《荒地の開墾》	名詞
＠あれ	《荒地の開墾》	名詞
＠あれち	《荒地の開墾》	名詞
＠あれちの	《荒地の開墾》	名詞
＠あれちのか	《荒地の開墾》	名詞
＠あれちのかい	《荒地の開墾》	名詞
＠あれちのかいこ	《荒地の開墾》	名詞
＠あれちのかいこん	《荒地の開墾》	名詞
＠な	《縄張り持ちの大鎌猫》	名詞
＠なわ	《縄張り持ちの大鎌猫》	名詞
＠なわば	《縄張り持ちの大鎌猫》	名詞
＠なわばり	《縄張り持ちの大鎌猫》	名詞
＠なわばりも	《縄張り持ちの大鎌猫》	名詞
＠なわばりもち	《縄張り持ちの大鎌猫》	名詞
＠なわばりもちの	《縄張り持ちの大鎌猫》	名詞
＠なわばりもちのお	《縄張り持ちの大鎌猫》	名詞
＠なわばりもちのおお	《縄張り持ちの大鎌猫》	名詞
＠なわばりもちのおおか	《縄張り持ちの大鎌猫》	名詞
＠なわばりもちのおおかま	《縄張り持ちの大鎌猫》	名詞
＠なわばりもちのおおかまね	《縄張り持ちの大鎌猫》	名詞
＠なわばりもちのおおかまねこ	《縄張り持ちの大鎌猫》	名詞
＠か	《カザンドゥの踏みつけ》	名詞
＠かざ	《カザンドゥの踏みつけ》	名詞
＠かざん	《カザンドゥの踏みつけ》	名詞
＠かざんど	《カザンドゥの踏みつけ》	名詞
＠かざんどぅ	《カザンドゥの踏みつけ》	名詞
＠かざんどぅの	《カザンドゥの踏みつけ》	名詞
＠かざんどぅのふ	《カザンドゥの踏みつけ》	名詞
＠かざんどぅのふみ	《カザンドゥの踏みつけ》	名詞
＠かざんどぅのふみつ	《カザンドゥの踏みつけ》	名詞
＠かざんどぅのふみつけ	《カザンドゥの踏みつけ》	名詞
＠か	《カザンドゥの蜜壺虫》	名詞
＠かざ	《カザンドゥの蜜壺虫》	名詞
＠かざん	《カザンドゥの蜜壺虫》	名詞
＠かざんど	《カザンドゥの蜜壺虫》	名詞
＠かざんどぅ	《カザンドゥの蜜壺虫》	名詞
＠かざんどぅの	《カザンドゥの蜜壺虫》	名詞
＠かざんどぅのみ	《カザンドゥの蜜壺虫》	名詞
＠かざんどぅのみつ	《カザンドゥの蜜壺虫》	名詞
＠かざんどぅのみつつ	《カザンドゥの蜜壺虫》	名詞
＠かざんどぅのみつつぼ	《カザンドゥの蜜壺虫》	名詞
＠かざんどぅのみつつぼむ	《カザンドゥの蜜壺虫》	名詞
＠かざんどぅのみつつぼむし	《カザンドゥの蜜壺虫》	名詞
＠か	《変わり樹の苦行者》	名詞
＠かわ	《変わり樹の苦行者》	名詞
＠かわり	《変わり樹の苦行者》	名詞
＠かわりぎ	《変わり樹の苦行者》	名詞
＠かわりぎの	《変わり樹の苦行者》	名詞
＠かわりぎのく	《変わり樹の苦行者》	名詞
＠かわりぎのくぎ	《変わり樹の苦行者》	名詞
＠かわりぎのくぎょ	《変わり樹の苦行者》	名詞
＠かわりぎのくぎょう	《変わり樹の苦行者》	名詞
＠かわりぎのくぎょうし	《変わり樹の苦行者》	名詞
＠かわりぎのくぎょうしゃ	《変わり樹の苦行者》	名詞
＠き	《狂気の一咬み》	名詞
＠きょ	《狂気の一咬み》	名詞
＠きょう	《狂気の一咬み》	名詞
＠きょうき	《狂気の一咬み》	名詞
＠きょうきの	《狂気の一咬み》	名詞
＠きょうきのか	《狂気の一咬み》	名詞
＠きょうきのかみ	《狂気の一咬み》	名詞
＠け	《結束の力》	名詞
＠けっ	《結束の力》	名詞
＠けっそ	《結束の力》	名詞
＠けっそく	《結束の力》	名詞
＠けっそくの	《結束の力》	名詞
＠けっそくのち	《結束の力》	名詞
＠けっそくのちか	《結束の力》	名詞
＠けっそくのちから	《結束の力》	名詞
＠こ	《高所の追求》	名詞
＠こう	《高所の追求》	名詞
＠こうし	《高所の追求》	名詞
＠こうしょ	《高所の追求》	名詞
＠こうしょの	《高所の追求》	名詞
＠こうしょのつ	《高所の追求》	名詞
＠こうしょのつい	《高所の追求》	名詞
＠こうしょのついき	《高所の追求》	名詞
＠こうしょのついきゅ	《高所の追求》	名詞
＠こうしょのついきゅう	《高所の追求》	名詞
＠こ	《梢のベイロス》	名詞
＠こず	《梢のベイロス》	名詞
＠こずえ	《梢のベイロス》	名詞
＠こずえの	《梢のベイロス》	名詞
＠こずえのべ	《梢のベイロス》	名詞
＠こずえのべい	《梢のベイロス》	名詞
＠こずえのべいろ	《梢のベイロス》	名詞
＠こずえのべいろす	《梢のベイロス》	名詞
＠こ	《壊れた翼》	名詞
＠こわ	《壊れた翼》	名詞
＠こわれ	《壊れた翼》	名詞
＠こわれた	《壊れた翼》	名詞
＠こわれたつ	《壊れた翼》	名詞
＠こわれたつば	《壊れた翼》	名詞
＠こわれたつばさ	《壊れた翼》	名詞
＠じ	《ジョラーガの幻想家》	名詞
＠じょ	《ジョラーガの幻想家》	名詞
＠じょら	《ジョラーガの幻想家》	名詞
＠じょらー	《ジョラーガの幻想家》	名詞
＠じょらーが	《ジョラーガの幻想家》	名詞
＠じょらーがの	《ジョラーガの幻想家》	名詞
＠じょらーがのげ	《ジョラーガの幻想家》	名詞
＠じょらーがのげん	《ジョラーガの幻想家》	名詞
＠じょらーがのげんそ	《ジョラーガの幻想家》	名詞
＠じょらーがのげんそう	《ジョラーガの幻想家》	名詞
＠じょらーがのげんそうい	《ジョラーガの幻想家》	名詞
＠じょらーがのげんそういえ	《ジョラーガの幻想家》	名詞
＠た	《タジュールの荒廃刃》	名詞
＠たじ	《タジュールの荒廃刃》	名詞
＠たじゅ	《タジュールの荒廃刃》	名詞
＠たじゅー	《タジュールの荒廃刃》	名詞
＠たじゅーる	《タジュールの荒廃刃》	名詞
＠たじゅーるの	《タジュールの荒廃刃》	名詞
＠たじゅーるのこ	《タジュールの荒廃刃》	名詞
＠たじゅーるのこう	《タジュールの荒廃刃》	名詞
＠たじゅーるのこうは	《タジュールの荒廃刃》	名詞
＠たじゅーるのこうはい	《タジュールの荒廃刃》	名詞
＠たじゅーるのこうはいや	《タジュールの荒廃刃》	名詞
＠たじゅーるのこうはいやい	《タジュールの荒廃刃》	名詞
＠たじゅーるのこうはいやいば	《タジュールの荒廃刃》	名詞
＠た	《タジュールの投網使い》	名詞
＠たじ	《タジュールの投網使い》	名詞
＠たじゅ	《タジュールの投網使い》	名詞
＠たじゅー	《タジュールの投網使い》	名詞
＠たじゅーる	《タジュールの投網使い》	名詞
＠たじゅーるの	《タジュールの投網使い》	名詞
＠たじゅーるのと	《タジュールの投網使い》	名詞
＠たじゅーるのとあ	《タジュールの投網使い》	名詞
＠たじゅーるのとあみ	《タジュールの投網使い》	名詞
＠たじゅーるのとあみつ	《タジュールの投網使い》	名詞
＠たじゅーるのとあみつか	《タジュールの投網使い》	名詞
＠たじゅーるのとあみつかい	《タジュールの投網使い》	名詞
＠な	《ナーリッドの群棲》	名詞
＠なー	《ナーリッドの群棲》	名詞
＠なーり	《ナーリッドの群棲》	名詞
＠なーりっ	《ナーリッドの群棲》	名詞
＠なーりっど	《ナーリッドの群棲》	名詞
＠なーりっどの	《ナーリッドの群棲》	名詞
＠なーりっどのぐ	《ナーリッドの群棲》	名詞
＠なーりっどのぐん	《ナーリッドの群棲》	名詞
＠なーりっどのぐんせ	《ナーリッドの群棲》	名詞
＠なーりっどのぐんせい	《ナーリッドの群棲》	名詞
＠に	《ニッサのゼンディコン》	名詞
＠にっ	《ニッサのゼンディコン》	名詞
＠にっさ	《ニッサのゼンディコン》	名詞
＠にっさの	《ニッサのゼンディコン》	名詞
＠にっさのぜ	《ニッサのゼンディコン》	名詞
＠にっさのぜん	《ニッサのゼンディコン》	名詞
＠にっさのぜんで	《ニッサのゼンディコン》	名詞
＠にっさのぜんでぃ	《ニッサのゼンディコン》	名詞
＠にっさのぜんでぃこ	《ニッサのゼンディコン》	名詞
＠にっさのぜんでぃこん	《ニッサのゼンディコン》	名詞
＠ふ	《不屈の生存者》	名詞
＠ふく	《不屈の生存者》	名詞
＠ふくつ	《不屈の生存者》	名詞
＠ふくつの	《不屈の生存者》	名詞
＠ふくつのせ	《不屈の生存者》	名詞
＠ふくつのせい	《不屈の生存者》	名詞
＠ふくつのせいぞ	《不屈の生存者》	名詞
＠ふくつのせいぞん	《不屈の生存者》	名詞
＠ふくつのせいぞんし	《不屈の生存者》	名詞
＠ふくつのせいぞんしゃ	《不屈の生存者》	名詞
＠ま	《待ち受ける冒険》	名詞
＠まち	《待ち受ける冒険》	名詞
＠まちう	《待ち受ける冒険》	名詞
＠まちうけ	《待ち受ける冒険》	名詞
＠まちうける	《待ち受ける冒険》	名詞
＠まちうけるぼ	《待ち受ける冒険》	名詞
＠まちうけるぼう	《待ち受ける冒険》	名詞
＠まちうけるぼうけ	《待ち受ける冒険》	名詞
＠まちうけるぼうけん	《待ち受ける冒険》	名詞
＠む	《ムラーサの粗暴者》	名詞
＠むら	《ムラーサの粗暴者》	名詞
＠むらー	《ムラーサの粗暴者》	名詞
＠むらーさ	《ムラーサの粗暴者》	名詞
＠むらーさの	《ムラーサの粗暴者》	名詞
＠むらーさのそ	《ムラーサの粗暴者》	名詞
＠むらーさのそぼ	《ムラーサの粗暴者》	名詞
＠むらーさのそぼう	《ムラーサの粗暴者》	名詞
＠むらーさのそぼうし	《ムラーサの粗暴者》	名詞
＠むらーさのそぼうしゃ	《ムラーサの粗暴者》	名詞
＠む	《ムラーサの力》	名詞
＠むら	《ムラーサの力》	名詞
＠むらー	《ムラーサの力》	名詞
＠むらーさ	《ムラーサの力》	名詞
＠むらーさの	《ムラーサの力》	名詞
＠むらーさのち	《ムラーサの力》	名詞
＠むらーさのちか	《ムラーサの力》	名詞
＠むらーさのちから	《ムラーサの力》	名詞
＠あ	《嘲る樹木魔道士》	名詞
＠あざ	《嘲る樹木魔道士》	名詞
＠あざけ	《嘲る樹木魔道士》	名詞
＠あざける	《嘲る樹木魔道士》	名詞
＠あざけるじ	《嘲る樹木魔道士》	名詞
＠あざけるじゅ	《嘲る樹木魔道士》	名詞
＠あざけるじゅも	《嘲る樹木魔道士》	名詞
＠あざけるじゅもく	《嘲る樹木魔道士》	名詞
＠あざけるじゅもくま	《嘲る樹木魔道士》	名詞
＠あざけるじゅもくまど	《嘲る樹木魔道士》	名詞
＠あざけるじゅもくまどう	《嘲る樹木魔道士》	名詞
＠あざけるじゅもくまどうし	《嘲る樹木魔道士》	名詞
＠か	《絡みつく花面晶体／絡み谷》	名詞
＠から	《絡みつく花面晶体／絡み谷》	名詞
＠からみ	《絡みつく花面晶体／絡み谷》	名詞
＠からみつ	《絡みつく花面晶体／絡み谷》	名詞
＠からみつく	《絡みつく花面晶体／絡み谷》	名詞
＠からみつくは	《絡みつく花面晶体／絡み谷》	名詞
＠からみつくはな	《絡みつく花面晶体／絡み谷》	名詞
＠からみつくはなめ	《絡みつく花面晶体／絡み谷》	名詞
＠からみつくはなめん	《絡みつく花面晶体／絡み谷》	名詞
＠からみつくはなめんし	《絡みつく花面晶体／絡み谷》	名詞
＠からみつくはなめんしょ	《絡みつく花面晶体／絡み谷》	名詞
＠からみつくはなめんしょう	《絡みつく花面晶体／絡み谷》	名詞
＠からみつくはなめんしょうた	《絡みつく花面晶体／絡み谷》	名詞
＠からみつくはなめんしょうたい	《絡みつく花面晶体／絡み谷》	名詞
＠か	《絡みつく花面晶体／絡み谷》	名詞
＠から	《絡みつく花面晶体／絡み谷》	名詞
＠からみ	《絡みつく花面晶体／絡み谷》	名詞
＠からみだ	《絡みつく花面晶体／絡み谷》	名詞
＠からみだに	《絡みつく花面晶体／絡み谷》	名詞
＠か	《カルニの待ち伏せ／カルニの領域》	名詞
＠かる	《カルニの待ち伏せ／カルニの領域》	名詞
＠かるに	《カルニの待ち伏せ／カルニの領域》	名詞
＠かるにの	《カルニの待ち伏せ／カルニの領域》	名詞
＠かるにのま	《カルニの待ち伏せ／カルニの領域》	名詞
＠かるにのまち	《カルニの待ち伏せ／カルニの領域》	名詞
＠かるにのまちぶ	《カルニの待ち伏せ／カルニの領域》	名詞
＠かるにのまちぶせ	《カルニの待ち伏せ／カルニの領域》	名詞
＠か	《カルニの待ち伏せ／カルニの領域》	名詞
＠かる	《カルニの待ち伏せ／カルニの領域》	名詞
＠かるに	《カルニの待ち伏せ／カルニの領域》	名詞
＠かるにの	《カルニの待ち伏せ／カルニの領域》	名詞
＠かるにのり	《カルニの待ち伏せ／カルニの領域》	名詞
＠かるにのりょ	《カルニの待ち伏せ／カルニの領域》	名詞
＠かるにのりょう	《カルニの待ち伏せ／カルニの領域》	名詞
＠かるにのりょうい	《カルニの待ち伏せ／カルニの領域》	名詞
＠かるにのりょういき	《カルニの待ち伏せ／カルニの領域》	名詞
＠き	《巨森の波動》	名詞
＠きょ	《巨森の波動》	名詞
＠きょし	《巨森の波動》	名詞
＠きょしん	《巨森の波動》	名詞
＠きょしんの	《巨森の波動》	名詞
＠きょしんのは	《巨森の波動》	名詞
＠きょしんのはど	《巨森の波動》	名詞
＠きょしんのはどう	《巨森の波動》	名詞
＠き	《巨森の補強／巨森の茂み》	名詞
＠きょ	《巨森の補強／巨森の茂み》	名詞
＠きょし	《巨森の補強／巨森の茂み》	名詞
＠きょしん	《巨森の補強／巨森の茂み》	名詞
＠きょしんの	《巨森の補強／巨森の茂み》	名詞
＠きょしんのほ	《巨森の補強／巨森の茂み》	名詞
＠きょしんのほき	《巨森の補強／巨森の茂み》	名詞
＠きょしんのほきょ	《巨森の補強／巨森の茂み》	名詞
＠きょしんのほきょう	《巨森の補強／巨森の茂み》	名詞
＠き	《巨森の補強／巨森の茂み》	名詞
＠きょ	《巨森の補強／巨森の茂み》	名詞
＠きょも	《巨森の補強／巨森の茂み》	名詞
＠きょもり	《巨森の補強／巨森の茂み》	名詞
＠きょもりの	《巨森の補強／巨森の茂み》	名詞
＠きょもりのし	《巨森の補強／巨森の茂み》	名詞
＠きょもりのしげ	《巨森の補強／巨森の茂み》	名詞
＠きょもりのしげみ	《巨森の補強／巨森の茂み》	名詞
＠こ	《古参の冒険者》	名詞
＠こさ	《古参の冒険者》	名詞
＠こさん	《古参の冒険者》	名詞
＠こさんの	《古参の冒険者》	名詞
＠こさんのぼ	《古参の冒険者》	名詞
＠こさんのぼう	《古参の冒険者》	名詞
＠こさんのぼうけ	《古参の冒険者》	名詞
＠こさんのぼうけん	《古参の冒険者》	名詞
＠こさんのぼうけんし	《古参の冒険者》	名詞
＠こさんのぼうけんしゃ	《古参の冒険者》	名詞
＠す	《スカイクレイブの鶴嘴》	名詞
＠すか	《スカイクレイブの鶴嘴》	名詞
＠すかい	《スカイクレイブの鶴嘴》	名詞
＠すかいく	《スカイクレイブの鶴嘴》	名詞
＠すかいくれ	《スカイクレイブの鶴嘴》	名詞
＠すかいくれい	《スカイクレイブの鶴嘴》	名詞
＠すかいくれいぶ	《スカイクレイブの鶴嘴》	名詞
＠すかいくれいぶの	《スカイクレイブの鶴嘴》	名詞
＠すかいくれいぶのつ	《スカイクレイブの鶴嘴》	名詞
＠すかいくれいぶのつる	《スカイクレイブの鶴嘴》	名詞
＠すかいくれいぶのつるは	《スカイクレイブの鶴嘴》	名詞
＠すかいくれいぶのつるはし	《スカイクレイブの鶴嘴》	名詞
＠た	《玉虫色の角甲虫》	名詞
＠たま	《玉虫色の角甲虫》	名詞
＠たまむ	《玉虫色の角甲虫》	名詞
＠たまむし	《玉虫色の角甲虫》	名詞
＠たまむしい	《玉虫色の角甲虫》	名詞
＠たまむしいろ	《玉虫色の角甲虫》	名詞
＠たまむしいろの	《玉虫色の角甲虫》	名詞
＠たまむしいろのか	《玉虫色の角甲虫》	名詞
＠たまむしいろのかく	《玉虫色の角甲虫》	名詞
＠たまむしいろのかくこ	《玉虫色の角甲虫》	名詞
＠たまむしいろのかくこう	《玉虫色の角甲虫》	名詞
＠たまむしいろのかくこうち	《玉虫色の角甲虫》	名詞
＠たまむしいろのかくこうちゅ	《玉虫色の角甲虫》	名詞
＠たまむしいろのかくこうちゅう	《玉虫色の角甲虫》	名詞
＠つ	《蔦ヤモリ》	名詞
＠つた	《蔦ヤモリ》	名詞
＠つたや	《蔦ヤモリ》	名詞
＠つたやも	《蔦ヤモリ》	名詞
＠つたやもり	《蔦ヤモリ》	名詞
＠ば	《バーラ・ゲドの復活／バーラ・ゲドの聖域》	名詞
＠ばー	《バーラ・ゲドの復活／バーラ・ゲドの聖域》	名詞
＠ばーら	《バーラ・ゲドの復活／バーラ・ゲドの聖域》	名詞
＠ばーら・	《バーラ・ゲドの復活／バーラ・ゲドの聖域》	名詞
＠ばーら・げ	《バーラ・ゲドの復活／バーラ・ゲドの聖域》	名詞
＠ばーら・げど	《バーラ・ゲドの復活／バーラ・ゲドの聖域》	名詞
＠ばーら・げどの	《バーラ・ゲドの復活／バーラ・ゲドの聖域》	名詞
＠ばーら・げどのふ	《バーラ・ゲドの復活／バーラ・ゲドの聖域》	名詞
＠ばーら・げどのふっ	《バーラ・ゲドの復活／バーラ・ゲドの聖域》	名詞
＠ばーら・げどのふっか	《バーラ・ゲドの復活／バーラ・ゲドの聖域》	名詞
＠ばーら・げどのふっかつ	《バーラ・ゲドの復活／バーラ・ゲドの聖域》	名詞
＠ば	《バーラ・ゲドの復活／バーラ・ゲドの聖域》	名詞
＠ばー	《バーラ・ゲドの復活／バーラ・ゲドの聖域》	名詞
＠ばーら	《バーラ・ゲドの復活／バーラ・ゲドの聖域》	名詞
＠ばーら・	《バーラ・ゲドの復活／バーラ・ゲドの聖域》	名詞
＠ばーら・げ	《バーラ・ゲドの復活／バーラ・ゲドの聖域》	名詞
＠ばーら・げど	《バーラ・ゲドの復活／バーラ・ゲドの聖域》	名詞
＠ばーら・げどの	《バーラ・ゲドの復活／バーラ・ゲドの聖域》	名詞
＠ばーら・げどのせ	《バーラ・ゲドの復活／バーラ・ゲドの聖域》	名詞
＠ばーら・げどのせい	《バーラ・ゲドの復活／バーラ・ゲドの聖域》	名詞
＠ばーら・げどのせいい	《バーラ・ゲドの復活／バーラ・ゲドの聖域》	名詞
＠ばーら・げどのせいいき	《バーラ・ゲドの復活／バーラ・ゲドの聖域》	名詞
＠は	《春衣の僧侶》	名詞
＠はる	《春衣の僧侶》	名詞
＠はるご	《春衣の僧侶》	名詞
＠はるごろ	《春衣の僧侶》	名詞
＠はるごろも	《春衣の僧侶》	名詞
＠はるごろもの	《春衣の僧侶》	名詞
＠はるごろものそ	《春衣の僧侶》	名詞
＠はるごろものそう	《春衣の僧侶》	名詞
＠はるごろものそうり	《春衣の僧侶》	名詞
＠はるごろものそうりょ	《春衣の僧侶》	名詞
＠む	《ムラーサの発芽種》	名詞
＠むら	《ムラーサの発芽種》	名詞
＠むらー	《ムラーサの発芽種》	名詞
＠むらーさ	《ムラーサの発芽種》	名詞
＠むらーさの	《ムラーサの発芽種》	名詞
＠むらーさのは	《ムラーサの発芽種》	名詞
＠むらーさのはつ	《ムラーサの発芽種》	名詞
＠むらーさのはつが	《ムラーサの発芽種》	名詞
＠むらーさのはつがし	《ムラーサの発芽種》	名詞
＠むらーさのはつがしゅ	《ムラーサの発芽種》	名詞
＠ら	《乱動の再成長》	名詞
＠らん	《乱動の再成長》	名詞
＠らんど	《乱動の再成長》	名詞
＠らんどう	《乱動の再成長》	名詞
＠らんどうの	《乱動の再成長》	名詞
＠らんどうのさ	《乱動の再成長》	名詞
＠らんどうのさい	《乱動の再成長》	名詞
＠らんどうのさいせ	《乱動の再成長》	名詞
＠らんどうのさいせい	《乱動の再成長》	名詞
＠らんどうのさいせいち	《乱動の再成長》	名詞
＠らんどうのさいせいちょ	《乱動の再成長》	名詞
＠らんどうのさいせいちょう	《乱動の再成長》	名詞
＠い	《岩山鎧のベイロス》	名詞
＠いわ	《岩山鎧のベイロス》	名詞
＠いわや	《岩山鎧のベイロス》	名詞
＠いわやま	《岩山鎧のベイロス》	名詞
＠いわやまよ	《岩山鎧のベイロス》	名詞
＠いわやまよろ	《岩山鎧のベイロス》	名詞
＠いわやまよろい	《岩山鎧のベイロス》	名詞
＠いわやまよろいの	《岩山鎧のベイロス》	名詞
＠いわやまよろいのべ	《岩山鎧のベイロス》	名詞
＠いわやまよろいのべい	《岩山鎧のベイロス》	名詞
＠いわやまよろいのべいろ	《岩山鎧のベイロス》	名詞
＠いわやまよろいのべいろす	《岩山鎧のベイロス》	名詞
＠お	《オラン＝リーフの軟泥》	名詞
＠おら	《オラン＝リーフの軟泥》	名詞
＠おらん	《オラン＝リーフの軟泥》	名詞
＠おらん＝	《オラン＝リーフの軟泥》	名詞
＠おらん＝り	《オラン＝リーフの軟泥》	名詞
＠おらん＝りー	《オラン＝リーフの軟泥》	名詞
＠おらん＝りーふ	《オラン＝リーフの軟泥》	名詞
＠おらん＝りーふの	《オラン＝リーフの軟泥》	名詞
＠おらん＝りーふのな	《オラン＝リーフの軟泥》	名詞
＠おらん＝りーふのなん	《オラン＝リーフの軟泥》	名詞
＠おらん＝りーふのなんで	《オラン＝リーフの軟泥》	名詞
＠おらん＝りーふのなんでい	《オラン＝リーフの軟泥》	名詞
＠か	《カザンドゥのマンモス／カザンドゥの谷》	名詞
＠かざ	《カザンドゥのマンモス／カザンドゥの谷》	名詞
＠かざん	《カザンドゥのマンモス／カザンドゥの谷》	名詞
＠かざんど	《カザンドゥのマンモス／カザンドゥの谷》	名詞
＠かざんどぅ	《カザンドゥのマンモス／カザンドゥの谷》	名詞
＠かざんどぅの	《カザンドゥのマンモス／カザンドゥの谷》	名詞
＠かざんどぅのま	《カザンドゥのマンモス／カザンドゥの谷》	名詞
＠かざんどぅのまん	《カザンドゥのマンモス／カザンドゥの谷》	名詞
＠かざんどぅのまんも	《カザンドゥのマンモス／カザンドゥの谷》	名詞
＠かざんどぅのまんもす	《カザンドゥのマンモス／カザンドゥの谷》	名詞
＠か	《カザンドゥのマンモス／カザンドゥの谷》	名詞
＠かざ	《カザンドゥのマンモス／カザンドゥの谷》	名詞
＠かざん	《カザンドゥのマンモス／カザンドゥの谷》	名詞
＠かざんど	《カザンドゥのマンモス／カザンドゥの谷》	名詞
＠かざんどぅ	《カザンドゥのマンモス／カザンドゥの谷》	名詞
＠かざんどぅの	《カザンドゥのマンモス／カザンドゥの谷》	名詞
＠かざんどぅのた	《カザンドゥのマンモス／カザンドゥの谷》	名詞
＠かざんどぅのたに	《カザンドゥのマンモス／カザンドゥの谷》	名詞
＠か	《硬鎧の大群》	名詞
＠かた	《硬鎧の大群》	名詞
＠かたよ	《硬鎧の大群》	名詞
＠かたよろ	《硬鎧の大群》	名詞
＠かたよろい	《硬鎧の大群》	名詞
＠かたよろいの	《硬鎧の大群》	名詞
＠かたよろいのた	《硬鎧の大群》	名詞
＠かたよろいのたい	《硬鎧の大群》	名詞
＠かたよろいのたいぐ	《硬鎧の大群》	名詞
＠かたよろいのたいぐん	《硬鎧の大群》	名詞
＠す	《水蓮のコブラ》	名詞
＠すい	《水蓮のコブラ》	名詞
＠すいれ	《水蓮のコブラ》	名詞
＠すいれん	《水蓮のコブラ》	名詞
＠すいれんの	《水蓮のコブラ》	名詞
＠すいれんのこ	《水蓮のコブラ》	名詞
＠すいれんのこぶ	《水蓮のコブラ》	名詞
＠すいれんのこぶら	《水蓮のコブラ》	名詞
＠た	《タジュールの模範》	名詞
＠たじ	《タジュールの模範》	名詞
＠たじゅ	《タジュールの模範》	名詞
＠たじゅー	《タジュールの模範》	名詞
＠たじゅーる	《タジュールの模範》	名詞
＠たじゅーるの	《タジュールの模範》	名詞
＠たじゅーるのも	《タジュールの模範》	名詞
＠たじゅーるのもは	《タジュールの模範》	名詞
＠たじゅーるのもはん	《タジュールの模範》	名詞
＠ほ	《豊穣の碑文》	名詞
＠ほう	《豊穣の碑文》	名詞
＠ほうじ	《豊穣の碑文》	名詞
＠ほうじょ	《豊穣の碑文》	名詞
＠ほうじょう	《豊穣の碑文》	名詞
＠ほうじょうの	《豊穣の碑文》	名詞
＠ほうじょうのひ	《豊穣の碑文》	名詞
＠ほうじょうのひぶ	《豊穣の碑文》	名詞
＠ほうじょうのひぶん	《豊穣の碑文》	名詞
＠む	《群れのシャンブラー》	名詞
＠むれ	《群れのシャンブラー》	名詞
＠むれの	《群れのシャンブラー》	名詞
＠むれのし	《群れのシャンブラー》	名詞
＠むれのしゃ	《群れのシャンブラー》	名詞
＠むれのしゃん	《群れのシャンブラー》	名詞
＠むれのしゃんぶ	《群れのシャンブラー》	名詞
＠むれのしゃんぶら	《群れのシャンブラー》	名詞
＠むれのしゃんぶらー	《群れのシャンブラー》	名詞
＠い	《古の緑守り》	名詞
＠いに	《古の緑守り》	名詞
＠いにし	《古の緑守り》	名詞
＠いにしえ	《古の緑守り》	名詞
＠いにしえの	《古の緑守り》	名詞
＠いにしえのみ	《古の緑守り》	名詞
＠いにしえのみど	《古の緑守り》	名詞
＠いにしえのみどり	《古の緑守り》	名詞
＠いにしえのみどりま	《古の緑守り》	名詞
＠いにしえのみどりまも	《古の緑守り》	名詞
＠いにしえのみどりまもり	《古の緑守り》	名詞
＠か	《変わり樹の共生／うねる森、変わり樹》	名詞
＠かわ	《変わり樹の共生／うねる森、変わり樹》	名詞
＠かわり	《変わり樹の共生／うねる森、変わり樹》	名詞
＠かわりき	《変わり樹の共生／うねる森、変わり樹》	名詞
＠かわりきの	《変わり樹の共生／うねる森、変わり樹》	名詞
＠かわりきのき	《変わり樹の共生／うねる森、変わり樹》	名詞
＠かわりきのきょ	《変わり樹の共生／うねる森、変わり樹》	名詞
＠かわりきのきょう	《変わり樹の共生／うねる森、変わり樹》	名詞
＠かわりきのきょうせ	《変わり樹の共生／うねる森、変わり樹》	名詞
＠かわりきのきょうせい	《変わり樹の共生／うねる森、変わり樹》	名詞
＠う	《変わり樹の共生／うねる森、変わり樹》	名詞
＠うね	《変わり樹の共生／うねる森、変わり樹》	名詞
＠うねる	《変わり樹の共生／うねる森、変わり樹》	名詞
＠うねるも	《変わり樹の共生／うねる森、変わり樹》	名詞
＠うねるもり	《変わり樹の共生／うねる森、変わり樹》	名詞
＠うねるもり、	《変わり樹の共生／うねる森、変わり樹》	名詞
＠うねるもり、か	《変わり樹の共生／うねる森、変わり樹》	名詞
＠うねるもり、かわ	《変わり樹の共生／うねる森、変わり樹》	名詞
＠うねるもり、かわり	《変わり樹の共生／うねる森、変わり樹》	名詞
＠うねるもり、かわりぎ	《変わり樹の共生／うねる森、変わり樹》	名詞
＠や	《野生の魂、アシャヤ》	名詞
＠やせ	《野生の魂、アシャヤ》	名詞
＠やせい	《野生の魂、アシャヤ》	名詞
＠やせいの	《野生の魂、アシャヤ》	名詞
＠やせいのた	《野生の魂、アシャヤ》	名詞
＠やせいのたま	《野生の魂、アシャヤ》	名詞
＠やせいのたまし	《野生の魂、アシャヤ》	名詞
＠やせいのたましい	《野生の魂、アシャヤ》	名詞
＠やせいのたましい、	《野生の魂、アシャヤ》	名詞
＠やせいのたましい、あ	《野生の魂、アシャヤ》	名詞
＠やせいのたましい、あし	《野生の魂、アシャヤ》	名詞
＠やせいのたましい、あしゃ	《野生の魂、アシャヤ》	名詞
＠やせいのたましい、あしゃや	《野生の魂、アシャヤ》	名詞
＠あ	《野生の魂、アシャヤ》	名詞
＠あし	《野生の魂、アシャヤ》	名詞
＠あしゃ	《野生の魂、アシャヤ》	名詞
＠あしゃや	《野生の魂、アシャヤ》	名詞
＠ぼ	《冒険の戦利品》	名詞
＠ぼう	《冒険の戦利品》	名詞
＠ぼうけ	《冒険の戦利品》	名詞
＠ぼうけん	《冒険の戦利品》	名詞
＠ぼうけんの	《冒険の戦利品》	名詞
＠ぼうけんのせ	《冒険の戦利品》	名詞
＠ぼうけんのせん	《冒険の戦利品》	名詞
＠ぼうけんのせんり	《冒険の戦利品》	名詞
＠ぼうけんのせんりひ	《冒険の戦利品》	名詞
＠ぼうけんのせんりひん	《冒険の戦利品》	名詞
＠か	《海門の擁護者、リンヴァーラ》	名詞
＠かい	《海門の擁護者、リンヴァーラ》	名詞
＠かいも	《海門の擁護者、リンヴァーラ》	名詞
＠かいもん	《海門の擁護者、リンヴァーラ》	名詞
＠かいもんの	《海門の擁護者、リンヴァーラ》	名詞
＠かいもんのよ	《海門の擁護者、リンヴァーラ》	名詞
＠かいもんのよう	《海門の擁護者、リンヴァーラ》	名詞
＠かいもんのようご	《海門の擁護者、リンヴァーラ》	名詞
＠かいもんのようごし	《海門の擁護者、リンヴァーラ》	名詞
＠かいもんのようごしゃ	《海門の擁護者、リンヴァーラ》	名詞
＠かいもんのようごしゃ、	《海門の擁護者、リンヴァーラ》	名詞
＠かいもんのようごしゃ、り	《海門の擁護者、リンヴァーラ》	名詞
＠かいもんのようごしゃ、りん	《海門の擁護者、リンヴァーラ》	名詞
＠かいもんのようごしゃ、りんヴ	《海門の擁護者、リンヴァーラ》	名詞
＠かいもんのようごしゃ、りんヴぁ	《海門の擁護者、リンヴァーラ》	名詞
＠かいもんのようごしゃ、りんヴぁー	《海門の擁護者、リンヴァーラ》	名詞
＠かいもんのようごしゃ、りんヴぁーら	《海門の擁護者、リンヴァーラ》	名詞
＠り	《海門の擁護者、リンヴァーラ》	名詞
＠りん	《海門の擁護者、リンヴァーラ》	名詞
＠りんヴ	《海門の擁護者、リンヴァーラ》	名詞
＠りんヴぁ	《海門の擁護者、リンヴァーラ》	名詞
＠りんヴぁー	《海門の擁護者、リンヴァーラ》	名詞
＠りんヴぁーら	《海門の擁護者、リンヴァーラ》	名詞
＠せ	《生命の絆の僧侶》	名詞
＠せい	《生命の絆の僧侶》	名詞
＠せいめ	《生命の絆の僧侶》	名詞
＠せいめい	《生命の絆の僧侶》	名詞
＠せいめいの	《生命の絆の僧侶》	名詞
＠せいめいのき	《生命の絆の僧侶》	名詞
＠せいめいのきず	《生命の絆の僧侶》	名詞
＠せいめいのきずな	《生命の絆の僧侶》	名詞
＠せいめいのきずなの	《生命の絆の僧侶》	名詞
＠せいめいのきずなのそ	《生命の絆の僧侶》	名詞
＠せいめいのきずなのそう	《生命の絆の僧侶》	名詞
＠せいめいのきずなのそうり	《生命の絆の僧侶》	名詞
＠せいめいのきずなのそうりょ	《生命の絆の僧侶》	名詞
＠す	《スカイクレイブの秘儀司祭、オラー》	名詞
＠すか	《スカイクレイブの秘儀司祭、オラー》	名詞
＠すかい	《スカイクレイブの秘儀司祭、オラー》	名詞
＠すかいく	《スカイクレイブの秘儀司祭、オラー》	名詞
＠すかいくれ	《スカイクレイブの秘儀司祭、オラー》	名詞
＠すかいくれい	《スカイクレイブの秘儀司祭、オラー》	名詞
＠すかいくれいぶ	《スカイクレイブの秘儀司祭、オラー》	名詞
＠すかいくれいぶの	《スカイクレイブの秘儀司祭、オラー》	名詞
＠すかいくれいぶのひ	《スカイクレイブの秘儀司祭、オラー》	名詞
＠すかいくれいぶのひぎ	《スカイクレイブの秘儀司祭、オラー》	名詞
＠すかいくれいぶのひぎし	《スカイクレイブの秘儀司祭、オラー》	名詞
＠すかいくれいぶのひぎしさ	《スカイクレイブの秘儀司祭、オラー》	名詞
＠すかいくれいぶのひぎしさい	《スカイクレイブの秘儀司祭、オラー》	名詞
＠すかいくれいぶのひぎしさい、	《スカイクレイブの秘儀司祭、オラー》	名詞
＠すかいくれいぶのひぎしさい、お	《スカイクレイブの秘儀司祭、オラー》	名詞
＠すかいくれいぶのひぎしさい、おら	《スカイクレイブの秘儀司祭、オラー》	名詞
＠すかいくれいぶのひぎしさい、おらー	《スカイクレイブの秘儀司祭、オラー》	名詞
＠お	《スカイクレイブの秘儀司祭、オラー》	名詞
＠おら	《スカイクレイブの秘儀司祭、オラー》	名詞
＠おらー	《スカイクレイブの秘儀司祭、オラー》	名詞
＠ぞ	《空飛ぶ思考盗み》	名詞
＠ぞら	《空飛ぶ思考盗み》	名詞
＠ぞらと	《空飛ぶ思考盗み》	名詞
＠ぞらとぶ	《空飛ぶ思考盗み》	名詞
＠ぞらとぶし	《空飛ぶ思考盗み》	名詞
＠ぞらとぶしこ	《空飛ぶ思考盗み》	名詞
＠ぞらとぶしこう	《空飛ぶ思考盗み》	名詞
＠ぞらとぶしこうぬ	《空飛ぶ思考盗み》	名詞
＠ぞらとぶしこうぬす	《空飛ぶ思考盗み》	名詞
＠ぞらとぶしこうぬすみ	《空飛ぶ思考盗み》	名詞
＠と	《トリックスター、ザレス・サン》	名詞
＠とり	《トリックスター、ザレス・サン》	名詞
＠とりっ	《トリックスター、ザレス・サン》	名詞
＠とりっく	《トリックスター、ザレス・サン》	名詞
＠とりっくす	《トリックスター、ザレス・サン》	名詞
＠とりっくすた	《トリックスター、ザレス・サン》	名詞
＠とりっくすたー	《トリックスター、ザレス・サン》	名詞
＠とりっくすたー、	《トリックスター、ザレス・サン》	名詞
＠とりっくすたー、ざ	《トリックスター、ザレス・サン》	名詞
＠とりっくすたー、ざれ	《トリックスター、ザレス・サン》	名詞
＠とりっくすたー、ざれす	《トリックスター、ザレス・サン》	名詞
＠とりっくすたー、ざれす・	《トリックスター、ザレス・サン》	名詞
＠とりっくすたー、ざれす・さ	《トリックスター、ザレス・サン》	名詞
＠とりっくすたー、ざれす・さん	《トリックスター、ザレス・サン》	名詞
＠ざ	《トリックスター、ザレス・サン》	名詞
＠ざれ	《トリックスター、ザレス・サン》	名詞
＠ざれす	《トリックスター、ザレス・サン》	名詞
＠ざれす・	《トリックスター、ザレス・サン》	名詞
＠ざれす・さ	《トリックスター、ザレス・サン》	名詞
＠ざれす・さん	《トリックスター、ザレス・サン》	名詞
＠う	《ウマーラの神秘家》	名詞
＠うま	《ウマーラの神秘家》	名詞
＠うまー	《ウマーラの神秘家》	名詞
＠うまーら	《ウマーラの神秘家》	名詞
＠うまーらの	《ウマーラの神秘家》	名詞
＠うまーらのし	《ウマーラの神秘家》	名詞
＠うまーらのしん	《ウマーラの神秘家》	名詞
＠うまーらのしんぴ	《ウマーラの神秘家》	名詞
＠うまーらのしんぴか	《ウマーラの神秘家》	名詞
＠ら	《乱動追い、カーザ》	名詞
＠らん	《乱動追い、カーザ》	名詞
＠らんど	《乱動追い、カーザ》	名詞
＠らんどう	《乱動追い、カーザ》	名詞
＠らんどうお	《乱動追い、カーザ》	名詞
＠らんどうおい	《乱動追い、カーザ》	名詞
＠らんどうおい、	《乱動追い、カーザ》	名詞
＠らんどうおい、か	《乱動追い、カーザ》	名詞
＠らんどうおい、かー	《乱動追い、カーザ》	名詞
＠らんどうおい、かーざ	《乱動追い、カーザ》	名詞
＠か	《乱動追い、カーザ》	名詞
＠かー	《乱動追い、カーザ》	名詞
＠かーざ	《乱動追い、カーザ》	名詞
＠こ	《荒廃者の鎚鉾》	名詞
＠こう	《荒廃者の鎚鉾》	名詞
＠こうは	《荒廃者の鎚鉾》	名詞
＠こうはい	《荒廃者の鎚鉾》	名詞
＠こうはいし	《荒廃者の鎚鉾》	名詞
＠こうはいしゃ	《荒廃者の鎚鉾》	名詞
＠こうはいしゃの	《荒廃者の鎚鉾》	名詞
＠こうはいしゃのつ	《荒廃者の鎚鉾》	名詞
＠こうはいしゃのつち	《荒廃者の鎚鉾》	名詞
＠こうはいしゃのつちほ	《荒廃者の鎚鉾》	名詞
＠こうはいしゃのつちほこ	《荒廃者の鎚鉾》	名詞
＠こ	《鼓動盗み、ザグラス》	名詞
＠こど	《鼓動盗み、ザグラス》	名詞
＠こどう	《鼓動盗み、ザグラス》	名詞
＠こどうぬ	《鼓動盗み、ザグラス》	名詞
＠こどうぬす	《鼓動盗み、ザグラス》	名詞
＠こどうぬすみ	《鼓動盗み、ザグラス》	名詞
＠こどうぬすみ、	《鼓動盗み、ザグラス》	名詞
＠こどうぬすみ、ざ	《鼓動盗み、ザグラス》	名詞
＠こどうぬすみ、ざぐ	《鼓動盗み、ザグラス》	名詞
＠こどうぬすみ、ざぐら	《鼓動盗み、ザグラス》	名詞
＠こどうぬすみ、ざぐらす	《鼓動盗み、ザグラス》	名詞
＠ざ	《鼓動盗み、ザグラス》	名詞
＠ざぐ	《鼓動盗み、ザグラス》	名詞
＠ざぐら	《鼓動盗み、ザグラス》	名詞
＠ざぐらす	《鼓動盗み、ザグラス》	名詞
＠こ	《苔穴の骸骨》	名詞
＠こけ	《苔穴の骸骨》	名詞
＠こけあ	《苔穴の骸骨》	名詞
＠こけあな	《苔穴の骸骨》	名詞
＠こけあなの	《苔穴の骸骨》	名詞
＠こけあなのが	《苔穴の骸骨》	名詞
＠こけあなのがい	《苔穴の骸骨》	名詞
＠こけあなのがいこ	《苔穴の骸骨》	名詞
＠こけあなのがいこつ	《苔穴の骸骨》	名詞
＠す	《スカイクレイブの荒廃者、グラークマウ》	名詞
＠すか	《スカイクレイブの荒廃者、グラークマウ》	名詞
＠すかい	《スカイクレイブの荒廃者、グラークマウ》	名詞
＠すかいく	《スカイクレイブの荒廃者、グラークマウ》	名詞
＠すかいくれ	《スカイクレイブの荒廃者、グラークマウ》	名詞
＠すかいくれい	《スカイクレイブの荒廃者、グラークマウ》	名詞
＠すかいくれいぶ	《スカイクレイブの荒廃者、グラークマウ》	名詞
＠すかいくれいぶの	《スカイクレイブの荒廃者、グラークマウ》	名詞
＠すかいくれいぶのこ	《スカイクレイブの荒廃者、グラークマウ》	名詞
＠すかいくれいぶのこう	《スカイクレイブの荒廃者、グラークマウ》	名詞
＠すかいくれいぶのこうは	《スカイクレイブの荒廃者、グラークマウ》	名詞
＠すかいくれいぶのこうはい	《スカイクレイブの荒廃者、グラークマウ》	名詞
＠すかいくれいぶのこうはいし	《スカイクレイブの荒廃者、グラークマウ》	名詞
＠すかいくれいぶのこうはいしゃ	《スカイクレイブの荒廃者、グラークマウ》	名詞
＠すかいくれいぶのこうはいしゃ、	《スカイクレイブの荒廃者、グラークマウ》	名詞
＠すかいくれいぶのこうはいしゃ、ぐ	《スカイクレイブの荒廃者、グラークマウ》	名詞
＠すかいくれいぶのこうはいしゃ、ぐら	《スカイクレイブの荒廃者、グラークマウ》	名詞
＠すかいくれいぶのこうはいしゃ、ぐらー	《スカイクレイブの荒廃者、グラークマウ》	名詞
＠すかいくれいぶのこうはいしゃ、ぐらーく	《スカイクレイブの荒廃者、グラークマウ》	名詞
＠すかいくれいぶのこうはいしゃ、ぐらーくま	《スカイクレイブの荒廃者、グラークマウ》	名詞
＠すかいくれいぶのこうはいしゃ、ぐらーくまう	《スカイクレイブの荒廃者、グラークマウ》	名詞
＠ぐ	《スカイクレイブの荒廃者、グラークマウ》	名詞
＠ぐら	《スカイクレイブの荒廃者、グラークマウ》	名詞
＠ぐらー	《スカイクレイブの荒廃者、グラークマウ》	名詞
＠ぐらーく	《スカイクレイブの荒廃者、グラークマウ》	名詞
＠ぐらーくま	《スカイクレイブの荒廃者、グラークマウ》	名詞
＠ぐらーくまう	《スカイクレイブの荒廃者、グラークマウ》	名詞
＠か	《影さす太枝のニッサ》	名詞
＠かげ	《影さす太枝のニッサ》	名詞
＠かげさ	《影さす太枝のニッサ》	名詞
＠かげさす	《影さす太枝のニッサ》	名詞
＠かげさすふ	《影さす太枝のニッサ》	名詞
＠かげさすふと	《影さす太枝のニッサ》	名詞
＠かげさすふとえ	《影さす太枝のニッサ》	名詞
＠かげさすふとえだ	《影さす太枝のニッサ》	名詞
＠かげさすふとえだの	《影さす太枝のニッサ》	名詞
＠かげさすふとえだのに	《影さす太枝のニッサ》	名詞
＠かげさすふとえだのにっ	《影さす太枝のニッサ》	名詞
＠かげさすふとえだのにっさ	《影さす太枝のニッサ》	名詞
＠に	《影さす太枝のニッサ》	名詞
＠にっ	《影さす太枝のニッサ》	名詞
＠にっさ	《影さす太枝のニッサ》	名詞
＠にっさの	《影さす太枝のニッサ》	名詞
＠にっさのぜ	《影さす太枝のニッサ》	名詞
＠にっさのぜん	《影さす太枝のニッサ》	名詞
＠にっさのぜんで	《影さす太枝のニッサ》	名詞
＠にっさのぜんでぃ	《影さす太枝のニッサ》	名詞
＠にっさのぜんでぃこ	《影さす太枝のニッサ》	名詞
＠にっさのぜんでぃこん	《影さす太枝のニッサ》	名詞
＠や	《山火事の精霊》	名詞
＠やま	《山火事の精霊》	名詞
＠やまか	《山火事の精霊》	名詞
＠やまかじ	《山火事の精霊》	名詞
＠やまかじの	《山火事の精霊》	名詞
＠やまかじのせ	《山火事の精霊》	名詞
＠やまかじのせい	《山火事の精霊》	名詞
＠やまかじのせいれ	《山火事の精霊》	名詞
＠やまかじのせいれい	《山火事の精霊》	名詞
＠せ	《世界を彫る者、ファイラス》	名詞
＠せか	《世界を彫る者、ファイラス》	名詞
＠せかい	《世界を彫る者、ファイラス》	名詞
＠せかいを	《世界を彫る者、ファイラス》	名詞
＠せかいをほ	《世界を彫る者、ファイラス》	名詞
＠せかいをほる	《世界を彫る者、ファイラス》	名詞
＠せかいをほるも	《世界を彫る者、ファイラス》	名詞
＠せかいをほるもの	《世界を彫る者、ファイラス》	名詞
＠せかいをほるもの、	《世界を彫る者、ファイラス》	名詞
＠せかいをほるもの、ふ	《世界を彫る者、ファイラス》	名詞
＠せかいをほるもの、ふぁ	《世界を彫る者、ファイラス》	名詞
＠せかいをほるもの、ふぁい	《世界を彫る者、ファイラス》	名詞
＠せかいをほるもの、ふぁいら	《世界を彫る者、ファイラス》	名詞
＠せかいをほるもの、ふぁいらす	《世界を彫る者、ファイラス》	名詞
＠ふ	《世界を彫る者、ファイラス》	名詞
＠ふぁ	《世界を彫る者、ファイラス》	名詞
＠ふぁい	《世界を彫る者、ファイラス》	名詞
＠ふぁいら	《世界を彫る者、ファイラス》	名詞
＠ふぁいらす	《世界を彫る者、ファイラス》	名詞
＠か	《カルガの戦導者》	名詞
＠かる	《カルガの戦導者》	名詞
＠かるが	《カルガの戦導者》	名詞
＠かるがの	《カルガの戦導者》	名詞
＠かるがのせ	《カルガの戦導者》	名詞
＠かるがのせん	《カルガの戦導者》	名詞
＠かるがのせんど	《カルガの戦導者》	名詞
＠かるがのせんどう	《カルガの戦導者》	名詞
＠かるがのせんどうし	《カルガの戦導者》	名詞
＠かるがのせんどうしゃ	《カルガの戦導者》	名詞
＠お	《恐れなき探査者、アキリ》	名詞
＠おそ	《恐れなき探査者、アキリ》	名詞
＠おそれ	《恐れなき探査者、アキリ》	名詞
＠おそれな	《恐れなき探査者、アキリ》	名詞
＠おそれなき	《恐れなき探査者、アキリ》	名詞
＠おそれなきた	《恐れなき探査者、アキリ》	名詞
＠おそれなきたん	《恐れなき探査者、アキリ》	名詞
＠おそれなきたんさ	《恐れなき探査者、アキリ》	名詞
＠おそれなきたんさし	《恐れなき探査者、アキリ》	名詞
＠おそれなきたんさしゃ	《恐れなき探査者、アキリ》	名詞
＠おそれなきたんさしゃ、	《恐れなき探査者、アキリ》	名詞
＠おそれなきたんさしゃ、あ	《恐れなき探査者、アキリ》	名詞
＠おそれなきたんさしゃ、あき	《恐れなき探査者、アキリ》	名詞
＠おそれなきたんさしゃ、あきり	《恐れなき探査者、アキリ》	名詞
＠あ	《恐れなき探査者、アキリ》	名詞
＠あき	《恐れなき探査者、アキリ》	名詞
＠あきり	《恐れなき探査者、アキリ》	名詞
＠こ	《古代を継ぐ者、ナヒリ》	名詞
＠こだ	《古代を継ぐ者、ナヒリ》	名詞
＠こだい	《古代を継ぐ者、ナヒリ》	名詞
＠こだいを	《古代を継ぐ者、ナヒリ》	名詞
＠こだいをつ	《古代を継ぐ者、ナヒリ》	名詞
＠こだいをつぐ	《古代を継ぐ者、ナヒリ》	名詞
＠こだいをつぐも	《古代を継ぐ者、ナヒリ》	名詞
＠こだいをつぐもの	《古代を継ぐ者、ナヒリ》	名詞
＠こだいをつぐもの、	《古代を継ぐ者、ナヒリ》	名詞
＠こだいをつぐもの、な	《古代を継ぐ者、ナヒリ》	名詞
＠こだいをつぐもの、なひ	《古代を継ぐ者、ナヒリ》	名詞
＠こだいをつぐもの、なひり	《古代を継ぐ者、ナヒリ》	名詞
＠な	《古代を継ぐ者、ナヒリ》	名詞
＠なひ	《古代を継ぐ者、ナヒリ》	名詞
＠なひり	《古代を継ぐ者、ナヒリ》	名詞
＠む	《ムラーサの根食獣》	名詞
＠むら	《ムラーサの根食獣》	名詞
＠むらー	《ムラーサの根食獣》	名詞
＠むらーさ	《ムラーサの根食獣》	名詞
＠むらーさの	《ムラーサの根食獣》	名詞
＠むらーさのこ	《ムラーサの根食獣》	名詞
＠むらーさのこん	《ムラーサの根食獣》	名詞
＠むらーさのこんし	《ムラーサの根食獣》	名詞
＠むらーさのこんしょ	《ムラーサの根食獣》	名詞
＠むらーさのこんしょく	《ムラーサの根食獣》	名詞
＠むらーさのこんしょくじ	《ムラーサの根食獣》	名詞
＠むらーさのこんしょくじゅ	《ムラーサの根食獣》	名詞
＠むらーさのこんしょくじゅう	《ムラーサの根食獣》	名詞
＠し	《鎮まらぬ大地、ヤシャーン》	名詞
＠しず	《鎮まらぬ大地、ヤシャーン》	名詞
＠しずま	《鎮まらぬ大地、ヤシャーン》	名詞
＠しずまら	《鎮まらぬ大地、ヤシャーン》	名詞
＠しずまらぬ	《鎮まらぬ大地、ヤシャーン》	名詞
＠しずまらぬだ	《鎮まらぬ大地、ヤシャーン》	名詞
＠しずまらぬだい	《鎮まらぬ大地、ヤシャーン》	名詞
＠しずまらぬだいち	《鎮まらぬ大地、ヤシャーン》	名詞
＠しずまらぬだいち、	《鎮まらぬ大地、ヤシャーン》	名詞
＠しずまらぬだいち、や	《鎮まらぬ大地、ヤシャーン》	名詞
＠しずまらぬだいち、やし	《鎮まらぬ大地、ヤシャーン》	名詞
＠しずまらぬだいち、やしゃ	《鎮まらぬ大地、ヤシャーン》	名詞
＠しずまらぬだいち、やしゃー	《鎮まらぬ大地、ヤシャーン》	名詞
＠しずまらぬだいち、やしゃーん	《鎮まらぬ大地、ヤシャーン》	名詞
＠や	《鎮まらぬ大地、ヤシャーン》	名詞
＠やし	《鎮まらぬ大地、ヤシャーン》	名詞
＠やしゃ	《鎮まらぬ大地、ヤシャーン》	名詞
＠やしゃー	《鎮まらぬ大地、ヤシャーン》	名詞
＠やしゃーん	《鎮まらぬ大地、ヤシャーン》	名詞
＠な	《凪魔道士の使い魔》	名詞
＠なぎ	《凪魔道士の使い魔》	名詞
＠なぎま	《凪魔道士の使い魔》	名詞
＠なぎまど	《凪魔道士の使い魔》	名詞
＠なぎまどう	《凪魔道士の使い魔》	名詞
＠なぎまどうし	《凪魔道士の使い魔》	名詞
＠なぎまどうしの	《凪魔道士の使い魔》	名詞
＠なぎまどうしのつ	《凪魔道士の使い魔》	名詞
＠なぎまどうしのつか	《凪魔道士の使い魔》	名詞
＠なぎまどうしのつかい	《凪魔道士の使い魔》	名詞
＠なぎまどうしのつかいま	《凪魔道士の使い魔》	名詞
＠わ	《分かたれし水流、ヴェラゾール》	名詞
＠わか	《分かたれし水流、ヴェラゾール》	名詞
＠わかた	《分かたれし水流、ヴェラゾール》	名詞
＠わかたれ	《分かたれし水流、ヴェラゾール》	名詞
＠わかたれし	《分かたれし水流、ヴェラゾール》	名詞
＠わかたれしす	《分かたれし水流、ヴェラゾール》	名詞
＠わかたれしすい	《分かたれし水流、ヴェラゾール》	名詞
＠わかたれしすいり	《分かたれし水流、ヴェラゾール》	名詞
＠わかたれしすいりゅ	《分かたれし水流、ヴェラゾール》	名詞
＠わかたれしすいりゅう	《分かたれし水流、ヴェラゾール》	名詞
＠わかたれしすいりゅう、	《分かたれし水流、ヴェラゾール》	名詞
＠わかたれしすいりゅう、ヴ	《分かたれし水流、ヴェラゾール》	名詞
＠わかたれしすいりゅう、ヴぇ	《分かたれし水流、ヴェラゾール》	名詞
＠わかたれしすいりゅう、ヴぇら	《分かたれし水流、ヴェラゾール》	名詞
＠わかたれしすいりゅう、ヴぇらぞ	《分かたれし水流、ヴェラゾール》	名詞
＠わかたれしすいりゅう、ヴぇらぞー	《分かたれし水流、ヴェラゾール》	名詞
＠わかたれしすいりゅう、ヴぇらぞーる	《分かたれし水流、ヴェラゾール》	名詞
＠ヴ	《分かたれし水流、ヴェラゾール》	名詞
＠ヴぇ	《分かたれし水流、ヴェラゾール》	名詞
＠ヴぇら	《分かたれし水流、ヴェラゾール》	名詞
＠ヴぇらぞ	《分かたれし水流、ヴェラゾール》	名詞
＠ヴぇらぞー	《分かたれし水流、ヴェラゾール》	名詞
＠ヴぇらぞーる	《分かたれし水流、ヴェラゾール》	名詞
＠そ	《創造の座、オムナス》	名詞
＠そう	《創造の座、オムナス》	名詞
＠そうぞ	《創造の座、オムナス》	名詞
＠そうぞう	《創造の座、オムナス》	名詞
＠そうぞうの	《創造の座、オムナス》	名詞
＠そうぞうのざ	《創造の座、オムナス》	名詞
＠そうぞうのざ、	《創造の座、オムナス》	名詞
＠そうぞうのざ、お	《創造の座、オムナス》	名詞
＠そうぞうのざ、おむ	《創造の座、オムナス》	名詞
＠そうぞうのざ、おむな	《創造の座、オムナス》	名詞
＠そうぞうのざ、おむなす	《創造の座、オムナス》	名詞
＠お	《創造の座、オムナス》	名詞
＠おむ	《創造の座、オムナス》	名詞
＠おむな	《創造の座、オムナス》	名詞
＠おむなす	《創造の座、オムナス》	名詞
＠い	《石造りの荷役獣》	名詞
＠いし	《石造りの荷役獣》	名詞
＠いしづ	《石造りの荷役獣》	名詞
＠いしづく	《石造りの荷役獣》	名詞
＠いしづくり	《石造りの荷役獣》	名詞
＠いしづくりの	《石造りの荷役獣》	名詞
＠いしづくりのに	《石造りの荷役獣》	名詞
＠いしづくりのにや	《石造りの荷役獣》	名詞
＠いしづくりのにやく	《石造りの荷役獣》	名詞
＠いしづくりのにやくけ	《石造りの荷役獣》	名詞
＠いしづくりのにやくけも	《石造りの荷役獣》	名詞
＠いしづくりのにやくけもの	《石造りの荷役獣》	名詞
＠か	《海門の巨像》	名詞
＠かい	《海門の巨像》	名詞
＠かいも	《海門の巨像》	名詞
＠かいもん	《海門の巨像》	名詞
＠かいもんの	《海門の巨像》	名詞
＠かいもんのき	《海門の巨像》	名詞
＠かいもんのきょ	《海門の巨像》	名詞
＠かいもんのきょぞ	《海門の巨像》	名詞
＠かいもんのきょぞう	《海門の巨像》	名詞
＠が	《岸壁安息所の帆凧》	名詞
＠がん	《岸壁安息所の帆凧》	名詞
＠がんぺ	《岸壁安息所の帆凧》	名詞
＠がんぺき	《岸壁安息所の帆凧》	名詞
＠がんぺきあ	《岸壁安息所の帆凧》	名詞
＠がんぺきあん	《岸壁安息所の帆凧》	名詞
＠がんぺきあんそ	《岸壁安息所の帆凧》	名詞
＠がんぺきあんそく	《岸壁安息所の帆凧》	名詞
＠がんぺきあんそくじ	《岸壁安息所の帆凧》	名詞
＠がんぺきあんそくじょ	《岸壁安息所の帆凧》	名詞
＠がんぺきあんそくじょの	《岸壁安息所の帆凧》	名詞
＠がんぺきあんそくじょのほ	《岸壁安息所の帆凧》	名詞
＠がんぺきあんそくじょのほだ	《岸壁安息所の帆凧》	名詞
＠がんぺきあんそくじょのほだこ	《岸壁安息所の帆凧》	名詞
＠す	《スカイクレイブの歩哨》	名詞
＠すか	《スカイクレイブの歩哨》	名詞
＠すかい	《スカイクレイブの歩哨》	名詞
＠すかいく	《スカイクレイブの歩哨》	名詞
＠すかいくれ	《スカイクレイブの歩哨》	名詞
＠すかいくれい	《スカイクレイブの歩哨》	名詞
＠すかいくれいぶ	《スカイクレイブの歩哨》	名詞
＠すかいくれいぶの	《スカイクレイブの歩哨》	名詞
＠すかいくれいぶのほ	《スカイクレイブの歩哨》	名詞
＠すかいくれいぶのほし	《スカイクレイブの歩哨》	名詞
＠すかいくれいぶのほしょ	《スカイクレイブの歩哨》	名詞
＠すかいくれいぶのほしょう	《スカイクレイブの歩哨》	名詞
＠ば	《万能ナイフ》	名詞
＠ばん	《万能ナイフ》	名詞
＠ばんの	《万能ナイフ》	名詞
＠ばんのう	《万能ナイフ》	名詞
＠ばんのうな	《万能ナイフ》	名詞
＠ばんのうない	《万能ナイフ》	名詞
＠ばんのうないふ	《万能ナイフ》	名詞
＠よ	《予備物資》	名詞
＠よび	《予備物資》	名詞
＠よびぶ	《予備物資》	名詞
＠よびぶっ	《予備物資》	名詞
＠よびぶっし	《予備物資》	名詞
＠ひ	《秘宝の斧》	名詞
＠ひほ	《秘宝の斧》	名詞
＠ひほう	《秘宝の斧》	名詞
＠ひほうの	《秘宝の斧》	名詞
＠ひほうのお	《秘宝の斧》	名詞
＠ひほうのおの	《秘宝の斧》	名詞
＠ひ	《秘宝のゴーレム》	名詞
＠ひほ	《秘宝のゴーレム》	名詞
＠ひほう	《秘宝のゴーレム》	名詞
＠ひほうの	《秘宝のゴーレム》	名詞
＠ひほうのご	《秘宝のゴーレム》	名詞
＠ひほうのごー	《秘宝のゴーレム》	名詞
＠ひほうのごーれ	《秘宝のゴーレム》	名詞
＠ひほうのごーれむ	《秘宝のゴーレム》	名詞
＠ひ	《秘宝の護符》	名詞
＠ひほ	《秘宝の護符》	名詞
＠ひほう	《秘宝の護符》	名詞
＠ひほうの	《秘宝の護符》	名詞
＠ひほうのご	《秘宝の護符》	名詞
＠ひほうのごふ	《秘宝の護符》	名詞
＠ひ	《秘宝の薬瓶》	名詞
＠ひほ	《秘宝の薬瓶》	名詞
＠ひほう	《秘宝の薬瓶》	名詞
＠ひほうの	《秘宝の薬瓶》	名詞
＠ひほうのや	《秘宝の薬瓶》	名詞
＠ひほうのやく	《秘宝の薬瓶》	名詞
＠ひほうのやくび	《秘宝の薬瓶》	名詞
＠ひほうのやくびん	《秘宝の薬瓶》	名詞
＠す	《スカイクレイブの秘宝》	名詞
＠すか	《スカイクレイブの秘宝》	名詞
＠すかい	《スカイクレイブの秘宝》	名詞
＠すかいく	《スカイクレイブの秘宝》	名詞
＠すかいくれ	《スカイクレイブの秘宝》	名詞
＠すかいくれい	《スカイクレイブの秘宝》	名詞
＠すかいくれいぶ	《スカイクレイブの秘宝》	名詞
＠すかいくれいぶの	《スカイクレイブの秘宝》	名詞
＠すかいくれいぶのひ	《スカイクレイブの秘宝》	名詞
＠すかいくれいぶのひほ	《スカイクレイブの秘宝》	名詞
＠すかいくれいぶのひほう	《スカイクレイブの秘宝》	名詞
＠む	《無限の構築物》	名詞
＠むげ	《無限の構築物》	名詞
＠むげん	《無限の構築物》	名詞
＠むげんの	《無限の構築物》	名詞
＠むげんのこ	《無限の構築物》	名詞
＠むげんのこう	《無限の構築物》	名詞
＠むげんのこうち	《無限の構築物》	名詞
＠むげんのこうちく	《無限の構築物》	名詞
＠むげんのこうちくぶ	《無限の構築物》	名詞
＠むげんのこうちくぶつ	《無限の構築物》	名詞
＠せ	《石成エンジン》	名詞
＠せき	《石成エンジン》	名詞
＠せきせ	《石成エンジン》	名詞
＠せきせい	《石成エンジン》	名詞
＠せきせいえ	《石成エンジン》	名詞
＠せきせいえん	《石成エンジン》	名詞
＠せきせいえんじ	《石成エンジン》	名詞
＠せきせいえんじん	《石成エンジン》	名詞
＠み	《見捨てられた碑》	名詞
＠みす	《見捨てられた碑》	名詞
＠みすて	《見捨てられた碑》	名詞
＠みすてら	《見捨てられた碑》	名詞
＠みすてられ	《見捨てられた碑》	名詞
＠みすてられた	《見捨てられた碑》	名詞
＠みすてられたひ	《見捨てられた碑》	名詞
＠べ	《ベースキャンプ》	名詞
＠べー	《ベースキャンプ》	名詞
＠べーす	《ベースキャンプ》	名詞
＠べーすき	《ベースキャンプ》	名詞
＠べーすきゃ	《ベースキャンプ》	名詞
＠べーすきゃん	《ベースキャンプ》	名詞
＠べーすきゃんぷ	《ベースキャンプ》	名詞
＠い	《岩山被りの小道／樹木被りの小道》	名詞
＠いわ	《岩山被りの小道／樹木被りの小道》	名詞
＠いわや	《岩山被りの小道／樹木被りの小道》	名詞
＠いわやま	《岩山被りの小道／樹木被りの小道》	名詞
＠いわやまか	《岩山被りの小道／樹木被りの小道》	名詞
＠いわやまかぶ	《岩山被りの小道／樹木被りの小道》	名詞
＠いわやまかぶり	《岩山被りの小道／樹木被りの小道》	名詞
＠いわやまかぶりの	《岩山被りの小道／樹木被りの小道》	名詞
＠いわやまかぶりのこ	《岩山被りの小道／樹木被りの小道》	名詞
＠いわやまかぶりのこみ	《岩山被りの小道／樹木被りの小道》	名詞
＠いわやまかぶりのこみち	《岩山被りの小道／樹木被りの小道》	名詞
＠じ	《岩山被りの小道／樹木被りの小道》	名詞
＠じゅ	《岩山被りの小道／樹木被りの小道》	名詞
＠じゅも	《岩山被りの小道／樹木被りの小道》	名詞
＠じゅもく	《岩山被りの小道／樹木被りの小道》	名詞
＠じゅもくか	《岩山被りの小道／樹木被りの小道》	名詞
＠じゅもくかぶ	《岩山被りの小道／樹木被りの小道》	名詞
＠じゅもくかぶり	《岩山被りの小道／樹木被りの小道》	名詞
＠じゅもくかぶりの	《岩山被りの小道／樹木被りの小道》	名詞
＠じゅもくかぶりのこ	《岩山被りの小道／樹木被りの小道》	名詞
＠じゅもくかぶりのこみ	《岩山被りの小道／樹木被りの小道》	名詞
＠じゅもくかぶりのこみち	《岩山被りの小道／樹木被りの小道》	名詞
＠え	《枝重なる小道／石重なる小道》	名詞
＠えだ	《枝重なる小道／石重なる小道》	名詞
＠えだか	《枝重なる小道／石重なる小道》	名詞
＠えだかさ	《枝重なる小道／石重なる小道》	名詞
＠えだかさな	《枝重なる小道／石重なる小道》	名詞
＠えだかさなる	《枝重なる小道／石重なる小道》	名詞
＠えだかさなるこ	《枝重なる小道／石重なる小道》	名詞
＠えだかさなるこみ	《枝重なる小道／石重なる小道》	名詞
＠えだかさなるこみち	《枝重なる小道／石重なる小道》	名詞
＠い	《枝重なる小道／石重なる小道》	名詞
＠いし	《枝重なる小道／石重なる小道》	名詞
＠いしか	《枝重なる小道／石重なる小道》	名詞
＠いしかさ	《枝重なる小道／石重なる小道》	名詞
＠いしかさな	《枝重なる小道／石重なる小道》	名詞
＠いしかさなる	《枝重なる小道／石重なる小道》	名詞
＠いしかさなるこ	《枝重なる小道／石重なる小道》	名詞
＠いしかさなるこみ	《枝重なる小道／石重なる小道》	名詞
＠いしかさなるこみち	《枝重なる小道／石重なる小道》	名詞
＠か	《河川滑りの小道／溶岩滑りの小道》	名詞
＠かせ	《河川滑りの小道／溶岩滑りの小道》	名詞
＠かせん	《河川滑りの小道／溶岩滑りの小道》	名詞
＠かせんす	《河川滑りの小道／溶岩滑りの小道》	名詞
＠かせんすべ	《河川滑りの小道／溶岩滑りの小道》	名詞
＠かせんすべり	《河川滑りの小道／溶岩滑りの小道》	名詞
＠かせんすべりの	《河川滑りの小道／溶岩滑りの小道》	名詞
＠かせんすべりのこ	《河川滑りの小道／溶岩滑りの小道》	名詞
＠かせんすべりのこみ	《河川滑りの小道／溶岩滑りの小道》	名詞
＠かせんすべりのこみち	《河川滑りの小道／溶岩滑りの小道》	名詞
＠よ	《河川滑りの小道／溶岩滑りの小道》	名詞
＠よう	《河川滑りの小道／溶岩滑りの小道》	名詞
＠ようが	《河川滑りの小道／溶岩滑りの小道》	名詞
＠ようがん	《河川滑りの小道／溶岩滑りの小道》	名詞
＠ようがんす	《河川滑りの小道／溶岩滑りの小道》	名詞
＠ようがんすべ	《河川滑りの小道／溶岩滑りの小道》	名詞
＠ようがんすべり	《河川滑りの小道／溶岩滑りの小道》	名詞
＠ようがんすべりの	《河川滑りの小道／溶岩滑りの小道》	名詞
＠ようがんすべりのこ	《河川滑りの小道／溶岩滑りの小道》	名詞
＠ようがんすべりのこみ	《河川滑りの小道／溶岩滑りの小道》	名詞
＠ようがんすべりのこみち	《河川滑りの小道／溶岩滑りの小道》	名詞
＠し	《清水の小道／泥水の小道》	名詞
＠しみ	《清水の小道／泥水の小道》	名詞
＠しみず	《清水の小道／泥水の小道》	名詞
＠しみずの	《清水の小道／泥水の小道》	名詞
＠しみずのこ	《清水の小道／泥水の小道》	名詞
＠しみずのこみ	《清水の小道／泥水の小道》	名詞
＠しみずのこみち	《清水の小道／泥水の小道》	名詞
＠ど	《清水の小道／泥水の小道》	名詞
＠どろ	《清水の小道／泥水の小道》	名詞
＠どろみ	《清水の小道／泥水の小道》	名詞
＠どろみず	《清水の小道／泥水の小道》	名詞
＠どろみずの	《清水の小道／泥水の小道》	名詞
＠どろみずのこ	《清水の小道／泥水の小道》	名詞
＠どろみずのこみ	《清水の小道／泥水の小道》	名詞
＠どろみずのこみち	《清水の小道／泥水の小道》	名詞
＠し	《針縁の小道／柱縁の小道》	名詞
＠しん	《針縁の小道／柱縁の小道》	名詞
＠しんえ	《針縁の小道／柱縁の小道》	名詞
＠しんえん	《針縁の小道／柱縁の小道》	名詞
＠しんえんの	《針縁の小道／柱縁の小道》	名詞
＠しんえんのこ	《針縁の小道／柱縁の小道》	名詞
＠しんえんのこみ	《針縁の小道／柱縁の小道》	名詞
＠しんえんのこみち	《針縁の小道／柱縁の小道》	名詞
＠ち	《針縁の小道／柱縁の小道》	名詞
＠ちゅ	《針縁の小道／柱縁の小道》	名詞
＠ちゅう	《針縁の小道／柱縁の小道》	名詞
＠ちゅうえ	《針縁の小道／柱縁の小道》	名詞
＠ちゅうえん	《針縁の小道／柱縁の小道》	名詞
＠ちゅうえんの	《針縁の小道／柱縁の小道》	名詞
＠ちゅうえんのこ	《針縁の小道／柱縁の小道》	名詞
＠ちゅうえんのこみ	《針縁の小道／柱縁の小道》	名詞
＠ちゅうえんのこみち	《針縁の小道／柱縁の小道》	名詞
＠は	《這い回るやせ地》	名詞
＠はい	《這い回るやせ地》	名詞
＠はいま	《這い回るやせ地》	名詞
＠はいまわ	《這い回るやせ地》	名詞
＠はいまわる	《這い回るやせ地》	名詞
＠はいまわるや	《這い回るやせ地》	名詞
＠はいまわるやせ	《這い回るやせ地》	名詞
＠はいまわるやせち	《這い回るやせ地》	名詞
＠ま	《マキンディの玉座》	名詞
＠まき	《マキンディの玉座》	名詞
＠まきん	《マキンディの玉座》	名詞
＠まきんで	《マキンディの玉座》	名詞
＠まきんでぃ	《マキンディの玉座》	名詞
＠まきんでぃの	《マキンディの玉座》	名詞
＠まきんでぃのぎ	《マキンディの玉座》	名詞
＠まきんでぃのぎょ	《マキンディの玉座》	名詞
＠まきんでぃのぎょく	《マキンディの玉座》	名詞
＠まきんでぃのぎょくざ	《マキンディの玉座》	名詞
＠よ	《陽光昇りの小道／恐怖昇りの小道》	名詞
＠よう	《陽光昇りの小道／恐怖昇りの小道》	名詞
＠ようこ	《陽光昇りの小道／恐怖昇りの小道》	名詞
＠ようこう	《陽光昇りの小道／恐怖昇りの小道》	名詞
＠ようこうの	《陽光昇りの小道／恐怖昇りの小道》	名詞
＠ようこうのぼ	《陽光昇りの小道／恐怖昇りの小道》	名詞
＠ようこうのぼり	《陽光昇りの小道／恐怖昇りの小道》	名詞
＠ようこうのぼりの	《陽光昇りの小道／恐怖昇りの小道》	名詞
＠ようこうのぼりのこ	《陽光昇りの小道／恐怖昇りの小道》	名詞
＠ようこうのぼりのこみ	《陽光昇りの小道／恐怖昇りの小道》	名詞
＠ようこうのぼりのこみち	《陽光昇りの小道／恐怖昇りの小道》	名詞
＠き	《陽光昇りの小道／恐怖昇りの小道》	名詞
＠きょ	《陽光昇りの小道／恐怖昇りの小道》	名詞
＠きょう	《陽光昇りの小道／恐怖昇りの小道》	名詞
＠きょうふ	《陽光昇りの小道／恐怖昇りの小道》	名詞
＠きょうふの	《陽光昇りの小道／恐怖昇りの小道》	名詞
＠きょうふのぼ	《陽光昇りの小道／恐怖昇りの小道》	名詞
＠きょうふのぼり	《陽光昇りの小道／恐怖昇りの小道》	名詞
＠きょうふのぼりの	《陽光昇りの小道／恐怖昇りの小道》	名詞
＠きょうふのぼりのこ	《陽光昇りの小道／恐怖昇りの小道》	名詞
＠きょうふのぼりのこみ	《陽光昇りの小道／恐怖昇りの小道》	名詞
＠きょうふのぼりのこみち	《陽光昇りの小道／恐怖昇りの小道》	名詞
