＠か	《彼方見》	名詞
＠かな	《彼方見》	名詞
＠かなた	《彼方見》	名詞
＠かなたみ	《彼方見》	名詞
＠じ	《順応する煌くもの》	名詞
＠じゅ	《順応する煌くもの》	名詞
＠じゅん	《順応する煌くもの》	名詞
＠じゅんの	《順応する煌くもの》	名詞
＠じゅんのう	《順応する煌くもの》	名詞
＠じゅんのうす	《順応する煌くもの》	名詞
＠じゅんのうする	《順応する煌くもの》	名詞
＠じゅんのうするき	《順応する煌くもの》	名詞
＠じゅんのうするきら	《順応する煌くもの》	名詞
＠じゅんのうするきらめ	《順応する煌くもの》	名詞
＠じゅんのうするきらめく	《順応する煌くもの》	名詞
＠じゅんのうするきらめくも	《順応する煌くもの》	名詞
＠じゅんのうするきらめくもの	《順応する煌くもの》	名詞
＠ふ	《不思議な卵》	名詞
＠ふし	《不思議な卵》	名詞
＠ふしぎ	《不思議な卵》	名詞
＠ふしぎな	《不思議な卵》	名詞
＠ふしぎなた	《不思議な卵》	名詞
＠ふしぎなたま	《不思議な卵》	名詞
＠ふしぎなたまご	《不思議な卵》	名詞
＠い	《威圧するヴァンタサウルス》	名詞
＠いあ	《威圧するヴァンタサウルス》	名詞
＠いあつ	《威圧するヴァンタサウルス》	名詞
＠いあつす	《威圧するヴァンタサウルス》	名詞
＠いあつする	《威圧するヴァンタサウルス》	名詞
＠いあつするヴ	《威圧するヴァンタサウルス》	名詞
＠いあつするヴぁ	《威圧するヴァンタサウルス》	名詞
＠いあつするヴぁん	《威圧するヴァンタサウルス》	名詞
＠いあつするヴぁんた	《威圧するヴァンタサウルス》	名詞
＠いあつするヴぁんたさ	《威圧するヴァンタサウルス》	名詞
＠いあつするヴぁんたさう	《威圧するヴァンタサウルス》	名詞
＠いあつするヴぁんたさうる	《威圧するヴァンタサウルス》	名詞
＠いあつするヴぁんたさうるす	《威圧するヴァンタサウルス》	名詞
＠き	《狐インコ》	名詞
＠きつ	《狐インコ》	名詞
＠きつね	《狐インコ》	名詞
＠きつねい	《狐インコ》	名詞
＠きつねいん	《狐インコ》	名詞
＠きつねいんこ	《狐インコ》	名詞
＠き	《希望の光》	名詞
＠きぼ	《希望の光》	名詞
＠きぼう	《希望の光》	名詞
＠きぼうの	《希望の光》	名詞
＠きぼうのひ	《希望の光》	名詞
＠きぼうのひか	《希望の光》	名詞
＠きぼうのひかり	《希望の光》	名詞
＠け	《堅実な立ち位置》	名詞
＠けん	《堅実な立ち位置》	名詞
＠けんじ	《堅実な立ち位置》	名詞
＠けんじつ	《堅実な立ち位置》	名詞
＠けんじつな	《堅実な立ち位置》	名詞
＠けんじつなた	《堅実な立ち位置》	名詞
＠けんじつなたち	《堅実な立ち位置》	名詞
＠けんじつなたちい	《堅実な立ち位置》	名詞
＠けんじつなたちいち	《堅実な立ち位置》	名詞
＠け	《検問官》	名詞
＠けん	《検問官》	名詞
＠けんも	《検問官》	名詞
＠けんもん	《検問官》	名詞
＠けんもんか	《検問官》	名詞
＠けんもんかん	《検問官》	名詞
＠さ	《サヴァイの剣歯虎》	名詞
＠さヴ	《サヴァイの剣歯虎》	名詞
＠さヴぁ	《サヴァイの剣歯虎》	名詞
＠さヴぁい	《サヴァイの剣歯虎》	名詞
＠さヴぁいの	《サヴァイの剣歯虎》	名詞
＠さヴぁいのけ	《サヴァイの剣歯虎》	名詞
＠さヴぁいのけん	《サヴァイの剣歯虎》	名詞
＠さヴぁいのけんぱ	《サヴァイの剣歯虎》	名詞
＠さヴぁいのけんぱと	《サヴァイの剣歯虎》	名詞
＠さヴぁいのけんぱとら	《サヴァイの剣歯虎》	名詞
＠し	《神聖なる矢》	名詞
＠しん	《神聖なる矢》	名詞
＠しんせ	《神聖なる矢》	名詞
＠しんせい	《神聖なる矢》	名詞
＠しんせいな	《神聖なる矢》	名詞
＠しんせいなる	《神聖なる矢》	名詞
＠しんせいなるや	《神聖なる矢》	名詞
＠そ	《揃った突撃》	名詞
＠そろ	《揃った突撃》	名詞
＠そろっ	《揃った突撃》	名詞
＠そろった	《揃った突撃》	名詞
＠そろったと	《揃った突撃》	名詞
＠そろったとつ	《揃った突撃》	名詞
＠そろったとつげ	《揃った突撃》	名詞
＠そろったとつげき	《揃った突撃》	名詞
＠た	《たてがみサーバル》	名詞
＠たて	《たてがみサーバル》	名詞
＠たてが	《たてがみサーバル》	名詞
＠たてがみ	《たてがみサーバル》	名詞
＠たてがみさ	《たてがみサーバル》	名詞
＠たてがみさー	《たてがみサーバル》	名詞
＠たてがみさーば	《たてがみサーバル》	名詞
＠たてがみさーばる	《たてがみサーバル》	名詞
＠ち	《駐屯地の猫》	名詞
＠ちゅ	《駐屯地の猫》	名詞
＠ちゅう	《駐屯地の猫》	名詞
＠ちゅうと	《駐屯地の猫》	名詞
＠ちゅうとん	《駐屯地の猫》	名詞
＠ちゅうとんち	《駐屯地の猫》	名詞
＠ちゅうとんちの	《駐屯地の猫》	名詞
＠ちゅうとんちのね	《駐屯地の猫》	名詞
＠ちゅうとんちのねこ	《駐屯地の猫》	名詞
＠と	《突発的飛行》	名詞
＠とっ	《突発的飛行》	名詞
＠とっぱ	《突発的飛行》	名詞
＠とっぱつ	《突発的飛行》	名詞
＠とっぱつて	《突発的飛行》	名詞
＠とっぱつてき	《突発的飛行》	名詞
＠とっぱつてきひ	《突発的飛行》	名詞
＠とっぱつてきひこ	《突発的飛行》	名詞
＠とっぱつてきひこう	《突発的飛行》	名詞
＠ど	《ドラニスの癒し手》	名詞
＠どら	《ドラニスの癒し手》	名詞
＠どらに	《ドラニスの癒し手》	名詞
＠どらにす	《ドラニスの癒し手》	名詞
＠どらにすの	《ドラニスの癒し手》	名詞
＠どらにすのい	《ドラニスの癒し手》	名詞
＠どらにすのいや	《ドラニスの癒し手》	名詞
＠どらにすのいやし	《ドラニスの癒し手》	名詞
＠どらにすのいやして	《ドラニスの癒し手》	名詞
＠に	《日勤隊の指揮官》	名詞
＠にっ	《日勤隊の指揮官》	名詞
＠にっき	《日勤隊の指揮官》	名詞
＠にっきん	《日勤隊の指揮官》	名詞
＠にっきんた	《日勤隊の指揮官》	名詞
＠にっきんたい	《日勤隊の指揮官》	名詞
＠にっきんたいの	《日勤隊の指揮官》	名詞
＠にっきんたいのし	《日勤隊の指揮官》	名詞
＠にっきんたいのしき	《日勤隊の指揮官》	名詞
＠にっきんたいのしきか	《日勤隊の指揮官》	名詞
＠にっきんたいのしきかん	《日勤隊の指揮官》	名詞
＠へ	《平和な心》	名詞
＠へい	《平和な心》	名詞
＠へいわ	《平和な心》	名詞
＠へいわな	《平和な心》	名詞
＠へいわなこ	《平和な心》	名詞
＠へいわなここ	《平和な心》	名詞
＠へいわなこころ	《平和な心》	名詞
＠ぼ	《防衛線の兵長》	名詞
＠ぼう	《防衛線の兵長》	名詞
＠ぼうえ	《防衛線の兵長》	名詞
＠ぼうえい	《防衛線の兵長》	名詞
＠ぼうえいせ	《防衛線の兵長》	名詞
＠ぼうえいせん	《防衛線の兵長》	名詞
＠ぼうえいせんの	《防衛線の兵長》	名詞
＠ぼうえいせんのへ	《防衛線の兵長》	名詞
＠ぼうえいせんのへい	《防衛線の兵長》	名詞
＠ぼうえいせんのへいち	《防衛線の兵長》	名詞
＠ぼうえいせんのへいちょ	《防衛線の兵長》	名詞
＠ぼうえいせんのへいちょう	《防衛線の兵長》	名詞
＠ば	《刃による払拭》	名詞
＠ばに	《刃による払拭》	名詞
＠ばによ	《刃による払拭》	名詞
＠ばによる	《刃による払拭》	名詞
＠ばによるふ	《刃による払拭》	名詞
＠ばによるふっ	《刃による払拭》	名詞
＠ばによるふっし	《刃による払拭》	名詞
＠ばによるふっしょ	《刃による払拭》	名詞
＠ばによるふっしょく	《刃による払拭》	名詞
＠つ	《翼膜の虎》	名詞
＠つば	《翼膜の虎》	名詞
＠つばさ	《翼膜の虎》	名詞
＠つばさま	《翼膜の虎》	名詞
＠つばさまく	《翼膜の虎》	名詞
＠つばさまくの	《翼膜の虎》	名詞
＠つばさまくのと	《翼膜の虎》	名詞
＠つばさまくのとら	《翼膜の虎》	名詞
＠ら	《らせん樹の滑空獣》	名詞
＠らせ	《らせん樹の滑空獣》	名詞
＠らせん	《らせん樹の滑空獣》	名詞
＠らせんじ	《らせん樹の滑空獣》	名詞
＠らせんじゅ	《らせん樹の滑空獣》	名詞
＠らせんじゅの	《らせん樹の滑空獣》	名詞
＠らせんじゅのか	《らせん樹の滑空獣》	名詞
＠らせんじゅのかっ	《らせん樹の滑空獣》	名詞
＠らせんじゅのかっく	《らせん樹の滑空獣》	名詞
＠らせんじゅのかっくう	《らせん樹の滑空獣》	名詞
＠らせんじゅのかっくうじ	《らせん樹の滑空獣》	名詞
＠らせんじゅのかっくうじゅ	《らせん樹の滑空獣》	名詞
＠らせんじゅのかっくうじゅう	《らせん樹の滑空獣》	名詞
＠わ	《罠の戦術家》	名詞
＠わな	《罠の戦術家》	名詞
＠わなの	《罠の戦術家》	名詞
＠わなのせ	《罠の戦術家》	名詞
＠わなのせん	《罠の戦術家》	名詞
＠わなのせんじ	《罠の戦術家》	名詞
＠わなのせんじゅ	《罠の戦術家》	名詞
＠わなのせんじゅつ	《罠の戦術家》	名詞
＠わなのせんじゅつか	《罠の戦術家》	名詞
＠い	《一心同体》	名詞
＠いっ	《一心同体》	名詞
＠いっし	《一心同体》	名詞
＠いっしん	《一心同体》	名詞
＠いっしんど	《一心同体》	名詞
＠いっしんどう	《一心同体》	名詞
＠いっしんどうた	《一心同体》	名詞
＠いっしんどうたい	《一心同体》	名詞
＠お	《雄々しい救出者》	名詞
＠おお	《雄々しい救出者》	名詞
＠おおし	《雄々しい救出者》	名詞
＠おおしい	《雄々しい救出者》	名詞
＠おおしいき	《雄々しい救出者》	名詞
＠おおしいきゅ	《雄々しい救出者》	名詞
＠おおしいきゅう	《雄々しい救出者》	名詞
＠おおしいきゅうし	《雄々しい救出者》	名詞
＠おおしいきゅうしゅ	《雄々しい救出者》	名詞
＠おおしいきゅうしゅつ	《雄々しい救出者》	名詞
＠おおしいきゅうしゅつし	《雄々しい救出者》	名詞
＠おおしいきゅうしゅつしゃ	《雄々しい救出者》	名詞
＠け	《慧眼の導師》	名詞
＠けい	《慧眼の導師》	名詞
＠けいが	《慧眼の導師》	名詞
＠けいがん	《慧眼の導師》	名詞
＠けいがんの	《慧眼の導師》	名詞
＠けいがんのど	《慧眼の導師》	名詞
＠けいがんのどう	《慧眼の導師》	名詞
＠けいがんのどうし	《慧眼の導師》	名詞
＠す	《全てを狩るものの意志》	名詞
＠すべ	《全てを狩るものの意志》	名詞
＠すべて	《全てを狩るものの意志》	名詞
＠すべてを	《全てを狩るものの意志》	名詞
＠すべてをか	《全てを狩るものの意志》	名詞
＠すべてをかる	《全てを狩るものの意志》	名詞
＠すべてをかるも	《全てを狩るものの意志》	名詞
＠すべてをかるもの	《全てを狩るものの意志》	名詞
＠すべてをかるものの	《全てを狩るものの意志》	名詞
＠すべてをかるもののい	《全てを狩るものの意志》	名詞
＠すべてをかるもののいし	《全てを狩るものの意志》	名詞
＠せ	《聖域封鎖》	名詞
＠せい	《聖域封鎖》	名詞
＠せいい	《聖域封鎖》	名詞
＠せいいき	《聖域封鎖》	名詞
＠せいいきふ	《聖域封鎖》	名詞
＠せいいきふう	《聖域封鎖》	名詞
＠せいいきふうさ	《聖域封鎖》	名詞
＠そ	《壮麗な金角獣》	名詞
＠そう	《壮麗な金角獣》	名詞
＠そうれ	《壮麗な金角獣》	名詞
＠そうれい	《壮麗な金角獣》	名詞
＠そうれいな	《壮麗な金角獣》	名詞
＠そうれいなき	《壮麗な金角獣》	名詞
＠そうれいなきん	《壮麗な金角獣》	名詞
＠そうれいなきんか	《壮麗な金角獣》	名詞
＠そうれいなきんかく	《壮麗な金角獣》	名詞
＠そうれいなきんかくじ	《壮麗な金角獣》	名詞
＠そうれいなきんかくじゅ	《壮麗な金角獣》	名詞
＠そうれいなきんかくじゅう	《壮麗な金角獣》	名詞
＠そ	《壮麗牝馬》	名詞
＠そう	《壮麗牝馬》	名詞
＠そうれ	《壮麗牝馬》	名詞
＠そうれい	《壮麗牝馬》	名詞
＠そうれいひ	《壮麗牝馬》	名詞
＠そうれいひん	《壮麗牝馬》	名詞
＠そうれいひんば	《壮麗牝馬》	名詞
＠は	《繁栄の狐》	名詞
＠はん	《繁栄の狐》	名詞
＠はんえ	《繁栄の狐》	名詞
＠はんえい	《繁栄の狐》	名詞
＠はんえいの	《繁栄の狐》	名詞
＠はんえいのき	《繁栄の狐》	名詞
＠はんえいのきつ	《繁栄の狐》	名詞
＠はんえいのきつね	《繁栄の狐》	名詞
＠ま	《丸呑み》	名詞
＠まる	《丸呑み》	名詞
＠まるの	《丸呑み》	名詞
＠まるのみ	《丸呑み》	名詞
＠あ	《嵐生の飛び山羊》	名詞
＠あら	《嵐生の飛び山羊》	名詞
＠あらし	《嵐生の飛び山羊》	名詞
＠あらしせ	《嵐生の飛び山羊》	名詞
＠あらしせい	《嵐生の飛び山羊》	名詞
＠あらしせいの	《嵐生の飛び山羊》	名詞
＠あらしせいのと	《嵐生の飛び山羊》	名詞
＠あらしせいのとび	《嵐生の飛び山羊》	名詞
＠あらしせいのとびや	《嵐生の飛び山羊》	名詞
＠あらしせいのとびやぎ	《嵐生の飛び山羊》	名詞
＠か	《猟匠ライガー》	名詞
＠かり	《猟匠ライガー》	名詞
＠かりた	《猟匠ライガー》	名詞
＠かりたく	《猟匠ライガー》	名詞
＠かりたくみ	《猟匠ライガー》	名詞
＠かりたくみら	《猟匠ライガー》	名詞
＠かりたくみらい	《猟匠ライガー》	名詞
＠かりたくみらいが	《猟匠ライガー》	名詞
＠かりたくみらいがー	《猟匠ライガー》	名詞
＠す	《スナップダックスの神話》	名詞
＠すな	《スナップダックスの神話》	名詞
＠すなっ	《スナップダックスの神話》	名詞
＠すなっぷ	《スナップダックスの神話》	名詞
＠すなっぷだ	《スナップダックスの神話》	名詞
＠すなっぷだっ	《スナップダックスの神話》	名詞
＠すなっぷだっく	《スナップダックスの神話》	名詞
＠すなっぷだっくす	《スナップダックスの神話》	名詞
＠すなっぷだっくすの	《スナップダックスの神話》	名詞
＠すなっぷだっくすのし	《スナップダックスの神話》	名詞
＠すなっぷだっくすのしん	《スナップダックスの神話》	名詞
＠すなっぷだっくすのしんわ	《スナップダックスの神話》	名詞
＠ど	《ドラニスの判事》	名詞
＠どら	《ドラニスの判事》	名詞
＠どらに	《ドラニスの判事》	名詞
＠どらにす	《ドラニスの判事》	名詞
＠どらにすの	《ドラニスの判事》	名詞
＠どらにすのは	《ドラニスの判事》	名詞
＠どらにすのはん	《ドラニスの判事》	名詞
＠どらにすのはんじ	《ドラニスの判事》	名詞
＠よ	《幼獣守り》	名詞
＠よう	《幼獣守り》	名詞
＠ようじ	《幼獣守り》	名詞
＠ようじゅ	《幼獣守り》	名詞
＠ようじゅう	《幼獣守り》	名詞
＠ようじゅうま	《幼獣守り》	名詞
＠ようじゅうまも	《幼獣守り》	名詞
＠ようじゅうまもり	《幼獣守り》	名詞
＠ら	《ラバブリンクの冒険者》	名詞
＠らば	《ラバブリンクの冒険者》	名詞
＠らばぶ	《ラバブリンクの冒険者》	名詞
＠らばぶり	《ラバブリンクの冒険者》	名詞
＠らばぶりん	《ラバブリンクの冒険者》	名詞
＠らばぶりんく	《ラバブリンクの冒険者》	名詞
＠らばぶりんくの	《ラバブリンクの冒険者》	名詞
＠らばぶりんくのぼ	《ラバブリンクの冒険者》	名詞
＠らばぶりんくのぼう	《ラバブリンクの冒険者》	名詞
＠らばぶりんくのぼうけ	《ラバブリンクの冒険者》	名詞
＠らばぶりんくのぼうけん	《ラバブリンクの冒険者》	名詞
＠らばぶりんくのぼうけんし	《ラバブリンクの冒険者》	名詞
＠らばぶりんくのぼうけんしゃ	《ラバブリンクの冒険者》	名詞
＠こ	《光明の繁殖蛾》	名詞
＠こう	《光明の繁殖蛾》	名詞
＠こうみ	《光明の繁殖蛾》	名詞
＠こうみょ	《光明の繁殖蛾》	名詞
＠こうみょう	《光明の繁殖蛾》	名詞
＠こうみょうの	《光明の繁殖蛾》	名詞
＠こうみょうのは	《光明の繁殖蛾》	名詞
＠こうみょうのはん	《光明の繁殖蛾》	名詞
＠こうみょうのはんし	《光明の繁殖蛾》	名詞
＠こうみょうのはんしょ	《光明の繁殖蛾》	名詞
＠こうみょうのはんしょく	《光明の繁殖蛾》	名詞
＠こうみょうのはんしょくが	《光明の繁殖蛾》	名詞
＠あ	《安全維持》	名詞
＠あん	《安全維持》	名詞
＠あんぜ	《安全維持》	名詞
＠あんぜん	《安全維持》	名詞
＠あんぜんい	《安全維持》	名詞
＠あんぜんいじ	《安全維持》	名詞
＠お	《驚くべき発育》	名詞
＠おど	《驚くべき発育》	名詞
＠おどろ	《驚くべき発育》	名詞
＠おどろく	《驚くべき発育》	名詞
＠おどろくべ	《驚くべき発育》	名詞
＠おどろくべき	《驚くべき発育》	名詞
＠おどろくべきは	《驚くべき発育》	名詞
＠おどろくべきはつ	《驚くべき発育》	名詞
＠おどろくべきはつい	《驚くべき発育》	名詞
＠おどろくべきはついく	《驚くべき発育》	名詞
＠お	《折り畳み翼竜》	名詞
＠おり	《折り畳み翼竜》	名詞
＠おりた	《折り畳み翼竜》	名詞
＠おりたた	《折り畳み翼竜》	名詞
＠おりたたみ	《折り畳み翼竜》	名詞
＠おりたたみつ	《折り畳み翼竜》	名詞
＠おりたたみつば	《折り畳み翼竜》	名詞
＠おりたたみつばさ	《折り畳み翼竜》	名詞
＠おりたたみつばさり	《折り畳み翼竜》	名詞
＠おりたたみつばさりゅ	《折り畳み翼竜》	名詞
＠おりたたみつばさりゅう	《折り畳み翼竜》	名詞
＠き	《切子読み》	名詞
＠きり	《切子読み》	名詞
＠きりこ	《切子読み》	名詞
＠きりこよ	《切子読み》	名詞
＠きりこよみ	《切子読み》	名詞
＠し	《心を一つに》	名詞
＠しん	《心を一つに》	名詞
＠しんを	《心を一つに》	名詞
＠しんをひ	《心を一つに》	名詞
＠しんをひと	《心を一つに》	名詞
＠しんをひとつ	《心を一つに》	名詞
＠しんをひとつに	《心を一つに》	名詞
＠し	《疾風》	名詞
＠しっ	《疾風》	名詞
＠しっぷ	《疾風》	名詞
＠しっぷう	《疾風》	名詞
＠じ	《霜帳の奇襲》	名詞
＠じも	《霜帳の奇襲》	名詞
＠じもち	《霜帳の奇襲》	名詞
＠じもちょ	《霜帳の奇襲》	名詞
＠じもちょう	《霜帳の奇襲》	名詞
＠じもちょうの	《霜帳の奇襲》	名詞
＠じもちょうのき	《霜帳の奇襲》	名詞
＠じもちょうのきし	《霜帳の奇襲》	名詞
＠じもちょうのきしゅ	《霜帳の奇襲》	名詞
＠じもちょうのきしゅう	《霜帳の奇襲》	名詞
＠じ	《霜のオオヤマネコ》	名詞
＠じも	《霜のオオヤマネコ》	名詞
＠じもの	《霜のオオヤマネコ》	名詞
＠じものお	《霜のオオヤマネコ》	名詞
＠じものおお	《霜のオオヤマネコ》	名詞
＠じものおおや	《霜のオオヤマネコ》	名詞
＠じものおおやま	《霜のオオヤマネコ》	名詞
＠じものおおやまね	《霜のオオヤマネコ》	名詞
＠じものおおやまねこ	《霜のオオヤマネコ》	名詞
＠あ	《晶殻ガニ》	名詞
＠あき	《晶殻ガニ》	名詞
＠あきら	《晶殻ガニ》	名詞
＠あきらが	《晶殻ガニ》	名詞
＠あきらがら	《晶殻ガニ》	名詞
＠あきらがらが	《晶殻ガニ》	名詞
＠あきらがらがに	《晶殻ガニ》	名詞
＠し	《神盾の海亀》	名詞
＠しん	《神盾の海亀》	名詞
＠しんた	《神盾の海亀》	名詞
＠しんたて	《神盾の海亀》	名詞
＠しんたての	《神盾の海亀》	名詞
＠しんたてのう	《神盾の海亀》	名詞
＠しんたてのうみ	《神盾の海亀》	名詞
＠しんたてのうみが	《神盾の海亀》	名詞
＠しんたてのうみがめ	《神盾の海亀》	名詞
＠せ	《潜界イルカ》	名詞
＠せん	《潜界イルカ》	名詞
＠せんか	《潜界イルカ》	名詞
＠せんかい	《潜界イルカ》	名詞
＠せんかいい	《潜界イルカ》	名詞
＠せんかいいる	《潜界イルカ》	名詞
＠せんかいいるか	《潜界イルカ》	名詞
＠ど	《泥棒カワウソ》	名詞
＠どろ	《泥棒カワウソ》	名詞
＠どろぼ	《泥棒カワウソ》	名詞
＠どろぼう	《泥棒カワウソ》	名詞
＠どろぼうか	《泥棒カワウソ》	名詞
＠どろぼうかわ	《泥棒カワウソ》	名詞
＠どろぼうかわう	《泥棒カワウソ》	名詞
＠どろぼうかわうそ	《泥棒カワウソ》	名詞
＠び	《微光クラゲ》	名詞
＠びこ	《微光クラゲ》	名詞
＠びこう	《微光クラゲ》	名詞
＠びこうく	《微光クラゲ》	名詞
＠びこうくら	《微光クラゲ》	名詞
＠びこうくらげ	《微光クラゲ》	名詞
＠ぼ	《妨害する罠》	名詞
＠ぼう	《妨害する罠》	名詞
＠ぼうが	《妨害する罠》	名詞
＠ぼうがい	《妨害する罠》	名詞
＠ぼうがいす	《妨害する罠》	名詞
＠ぼうがいする	《妨害する罠》	名詞
＠ぼうがいするわ	《妨害する罠》	名詞
＠ぼうがいするわな	《妨害する罠》	名詞
＠ほ	《捕獲球》	名詞
＠ほか	《捕獲球》	名詞
＠ほかく	《捕獲球》	名詞
＠ほかくだ	《捕獲球》	名詞
＠ほかくだま	《捕獲球》	名詞
＠ほ	《本質の散乱》	名詞
＠ほん	《本質の散乱》	名詞
＠ほんし	《本質の散乱》	名詞
＠ほんしつ	《本質の散乱》	名詞
＠ほんしつの	《本質の散乱》	名詞
＠ほんしつのさ	《本質の散乱》	名詞
＠ほんしつのさん	《本質の散乱》	名詞
＠ほんしつのさんら	《本質の散乱》	名詞
＠ほんしつのさんらん	《本質の散乱》	名詞
＠ま	《巻き込み》	名詞
＠まき	《巻き込み》	名詞
＠まきこ	《巻き込み》	名詞
＠まきこみ	《巻き込み》	名詞
＠ゆ	《夢尾の鷺》	名詞
＠ゆめ	《夢尾の鷺》	名詞
＠ゆめお	《夢尾の鷺》	名詞
＠ゆめおの	《夢尾の鷺》	名詞
＠ゆめおのさ	《夢尾の鷺》	名詞
＠ゆめおのさぎ	《夢尾の鷺》	名詞
＠よ	《予期》	名詞
＠よき	《予期》	名詞
＠き	《奇異鳥》	名詞
＠きい	《奇異鳥》	名詞
＠きいど	《奇異鳥》	名詞
＠きいどり	《奇異鳥》	名詞
＠し	《神秘の制圧》	名詞
＠しん	《神秘の制圧》	名詞
＠しんぴ	《神秘の制圧》	名詞
＠しんぴの	《神秘の制圧》	名詞
＠しんぴのせ	《神秘の制圧》	名詞
＠しんぴのせい	《神秘の制圧》	名詞
＠しんぴのせいあ	《神秘の制圧》	名詞
＠しんぴのせいあつ	《神秘の制圧》	名詞
＠だ	《脱出の儀礼》	名詞
＠だっ	《脱出の儀礼》	名詞
＠だっし	《脱出の儀礼》	名詞
＠だっしゅ	《脱出の儀礼》	名詞
＠だっしゅつ	《脱出の儀礼》	名詞
＠だっしゅつの	《脱出の儀礼》	名詞
＠だっしゅつのぎ	《脱出の儀礼》	名詞
＠だっしゅつのぎれ	《脱出の儀礼》	名詞
＠だっしゅつのぎれい	《脱出の儀礼》	名詞
＠ち	《中和》	名詞
＠ちゅ	《中和》	名詞
＠ちゅう	《中和》	名詞
＠ちゅうわ	《中和》	名詞
＠て	《偵察任務》	名詞
＠てい	《偵察任務》	名詞
＠ていさ	《偵察任務》	名詞
＠ていさつ	《偵察任務》	名詞
＠ていさつに	《偵察任務》	名詞
＠ていさつにん	《偵察任務》	名詞
＠ていさつにんむ	《偵察任務》	名詞
＠と	《飛びかかる岸鮫》	名詞
＠とび	《飛びかかる岸鮫》	名詞
＠とびか	《飛びかかる岸鮫》	名詞
＠とびかか	《飛びかかる岸鮫》	名詞
＠とびかかる	《飛びかかる岸鮫》	名詞
＠とびかかるき	《飛びかかる岸鮫》	名詞
＠とびかかるきし	《飛びかかる岸鮫》	名詞
＠とびかかるきしさ	《飛びかかる岸鮫》	名詞
＠とびかかるきしさめ	《飛びかかる岸鮫》	名詞
＠に	《肉食島》	名詞
＠にく	《肉食島》	名詞
＠にくし	《肉食島》	名詞
＠にくしょ	《肉食島》	名詞
＠にくしょく	《肉食島》	名詞
＠にくしょくと	《肉食島》	名詞
＠にくしょくとう	《肉食島》	名詞
＠ね	《願い与えの加護》	名詞
＠ねが	《願い与えの加護》	名詞
＠ねがい	《願い与えの加護》	名詞
＠ねがいあ	《願い与えの加護》	名詞
＠ねがいあた	《願い与えの加護》	名詞
＠ねがいあたえ	《願い与えの加護》	名詞
＠ねがいあたえの	《願い与えの加護》	名詞
＠ねがいあたえのか	《願い与えの加護》	名詞
＠ねがいあたえのかご	《願い与えの加護》	名詞
＠ふ	《不吉な海》	名詞
＠ふき	《不吉な海》	名詞
＠ふきつ	《不吉な海》	名詞
＠ふきつな	《不吉な海》	名詞
＠ふきつなう	《不吉な海》	名詞
＠ふきつなうみ	《不吉な海》	名詞
＠り	《両生共生体》	名詞
＠りょ	《両生共生体》	名詞
＠りょう	《両生共生体》	名詞
＠りょうせ	《両生共生体》	名詞
＠りょうせい	《両生共生体》	名詞
＠りょうせいき	《両生共生体》	名詞
＠りょうせいきょ	《両生共生体》	名詞
＠りょうせいきょう	《両生共生体》	名詞
＠りょうせいきょうせ	《両生共生体》	名詞
＠りょうせいきょうせい	《両生共生体》	名詞
＠りょうせいきょうせいた	《両生共生体》	名詞
＠りょうせいきょうせいたい	《両生共生体》	名詞
＠つ	《翼長の導師》	名詞
＠つば	《翼長の導師》	名詞
＠つばさ	《翼長の導師》	名詞
＠つばさち	《翼長の導師》	名詞
＠つばさちょ	《翼長の導師》	名詞
＠つばさちょう	《翼長の導師》	名詞
＠つばさちょうの	《翼長の導師》	名詞
＠つばさちょうのど	《翼長の導師》	名詞
＠つばさちょうのどう	《翼長の導師》	名詞
＠つばさちょうのどうし	《翼長の導師》	名詞
＠い	《イルーナの神話》	名詞
＠いる	《イルーナの神話》	名詞
＠いるー	《イルーナの神話》	名詞
＠いるーな	《イルーナの神話》	名詞
＠いるーなの	《イルーナの神話》	名詞
＠いるーなのし	《イルーナの神話》	名詞
＠いるーなのしん	《イルーナの神話》	名詞
＠いるーなのしんわ	《イルーナの神話》	名詞
＠う	《海駆けダコ》	名詞
＠うみ	《海駆けダコ》	名詞
＠うみか	《海駆けダコ》	名詞
＠うみかけ	《海駆けダコ》	名詞
＠うみかけだ	《海駆けダコ》	名詞
＠うみかけだこ	《海駆けダコ》	名詞
＠さ	《サメ台風》	名詞
＠さめ	《サメ台風》	名詞
＠さめた	《サメ台風》	名詞
＠さめたい	《サメ台風》	名詞
＠さめたいふ	《サメ台風》	名詞
＠さめたいふう	《サメ台風》	名詞
＠た	《大食の巨大鮫》	名詞
＠たい	《大食の巨大鮫》	名詞
＠たいし	《大食の巨大鮫》	名詞
＠たいしょ	《大食の巨大鮫》	名詞
＠たいしょく	《大食の巨大鮫》	名詞
＠たいしょくの	《大食の巨大鮫》	名詞
＠たいしょくのき	《大食の巨大鮫》	名詞
＠たいしょくのきょ	《大食の巨大鮫》	名詞
＠たいしょくのきょだ	《大食の巨大鮫》	名詞
＠たいしょくのきょだい	《大食の巨大鮫》	名詞
＠たいしょくのきょだいさ	《大食の巨大鮫》	名詞
＠たいしょくのきょだいさめ	《大食の巨大鮫》	名詞
＠い	《息詰まる噴煙》	名詞
＠いき	《息詰まる噴煙》	名詞
＠いきづ	《息詰まる噴煙》	名詞
＠いきづま	《息詰まる噴煙》	名詞
＠いきづまる	《息詰まる噴煙》	名詞
＠いきづまるふ	《息詰まる噴煙》	名詞
＠いきづまるふん	《息詰まる噴煙》	名詞
＠いきづまるふんえ	《息詰まる噴煙》	名詞
＠いきづまるふんえん	《息詰まる噴煙》	名詞
＠う	《薄暗がりのセンザンコウ》	名詞
＠うす	《薄暗がりのセンザンコウ》	名詞
＠うすく	《薄暗がりのセンザンコウ》	名詞
＠うすくら	《薄暗がりのセンザンコウ》	名詞
＠うすくらが	《薄暗がりのセンザンコウ》	名詞
＠うすくらがり	《薄暗がりのセンザンコウ》	名詞
＠うすくらがりの	《薄暗がりのセンザンコウ》	名詞
＠うすくらがりのせ	《薄暗がりのセンザンコウ》	名詞
＠うすくらがりのせん	《薄暗がりのセンザンコウ》	名詞
＠うすくらがりのせんざ	《薄暗がりのセンザンコウ》	名詞
＠うすくらがりのせんざん	《薄暗がりのセンザンコウ》	名詞
＠うすくらがりのせんざんこ	《薄暗がりのセンザンコウ》	名詞
＠うすくらがりのせんざんこう	《薄暗がりのセンザンコウ》	名詞
＠が	《隠れ潜む名射手》	名詞
＠がく	《隠れ潜む名射手》	名詞
＠がくれ	《隠れ潜む名射手》	名詞
＠がくれひ	《隠れ潜む名射手》	名詞
＠がくれひそ	《隠れ潜む名射手》	名詞
＠がくれひそむ	《隠れ潜む名射手》	名詞
＠がくれひそむめ	《隠れ潜む名射手》	名詞
＠がくれひそむめい	《隠れ潜む名射手》	名詞
＠がくれひそむめいし	《隠れ潜む名射手》	名詞
＠がくれひそむめいしゃ	《隠れ潜む名射手》	名詞
＠がくれひそむめいしゃし	《隠れ潜む名射手》	名詞
＠がくれひそむめいしゃしゅ	《隠れ潜む名射手》	名詞
＠が	《頑丈なダンゴムシ》	名詞
＠がん	《頑丈なダンゴムシ》	名詞
＠がんじ	《頑丈なダンゴムシ》	名詞
＠がんじょ	《頑丈なダンゴムシ》	名詞
＠がんじょう	《頑丈なダンゴムシ》	名詞
＠がんじょうな	《頑丈なダンゴムシ》	名詞
＠がんじょうなだ	《頑丈なダンゴムシ》	名詞
＠がんじょうなだん	《頑丈なダンゴムシ》	名詞
＠がんじょうなだんご	《頑丈なダンゴムシ》	名詞
＠がんじょうなだんごむ	《頑丈なダンゴムシ》	名詞
＠がんじょうなだんごむし	《頑丈なダンゴムシ》	名詞
＠き	《記憶漏出》	名詞
＠きお	《記憶漏出》	名詞
＠きおく	《記憶漏出》	名詞
＠きおくろ	《記憶漏出》	名詞
＠きおくろう	《記憶漏出》	名詞
＠きおくろうし	《記憶漏出》	名詞
＠きおくろうしゅ	《記憶漏出》	名詞
＠きおくろうしゅつ	《記憶漏出》	名詞
＠き	《急襲ヒル》	名詞
＠きゅ	《急襲ヒル》	名詞
＠きゅう	《急襲ヒル》	名詞
＠きゅうし	《急襲ヒル》	名詞
＠きゅうしゅ	《急襲ヒル》	名詞
＠きゅうしゅう	《急襲ヒル》	名詞
＠きゅうしゅうひ	《急襲ヒル》	名詞
＠きゅうしゅうひる	《急襲ヒル》	名詞
＠く	《靴かじり》	名詞
＠くつ	《靴かじり》	名詞
＠くつか	《靴かじり》	名詞
＠くつかじ	《靴かじり》	名詞
＠くつかじり	《靴かじり》	名詞
＠さ	《囁く兵団》	名詞
＠ささ	《囁く兵団》	名詞
＠ささや	《囁く兵団》	名詞
＠ささやく	《囁く兵団》	名詞
＠ささやくへ	《囁く兵団》	名詞
＠ささやくへい	《囁く兵団》	名詞
＠ささやくへいだ	《囁く兵団》	名詞
＠ささやくへいだん	《囁く兵団》	名詞
＠し	《屍体の攪拌》	名詞
＠した	《屍体の攪拌》	名詞
＠したい	《屍体の攪拌》	名詞
＠したいの	《屍体の攪拌》	名詞
＠したいのか	《屍体の攪拌》	名詞
＠したいのかく	《屍体の攪拌》	名詞
＠したいのかくは	《屍体の攪拌》	名詞
＠したいのかくはん	《屍体の攪拌》	名詞
＠し	《死の重み》	名詞
＠しの	《死の重み》	名詞
＠しのお	《死の重み》	名詞
＠しのおも	《死の重み》	名詞
＠しのおもみ	《死の重み》	名詞
＠そ	《相互破壊》	名詞
＠そう	《相互破壊》	名詞
＠そうご	《相互破壊》	名詞
＠そうごは	《相互破壊》	名詞
＠そうごはか	《相互破壊》	名詞
＠そうごはかい	《相互破壊》	名詞
＠け	《血液凝固》	名詞
＠けつ	《血液凝固》	名詞
＠けつえ	《血液凝固》	名詞
＠けつえき	《血液凝固》	名詞
＠けつえきぎ	《血液凝固》	名詞
＠けつえきぎょ	《血液凝固》	名詞
＠けつえきぎょう	《血液凝固》	名詞
＠けつえきぎょうこ	《血液凝固》	名詞
＠ど	《洞窟で囁くもの》	名詞
＠どう	《洞窟で囁くもの》	名詞
＠どうく	《洞窟で囁くもの》	名詞
＠どうくつ	《洞窟で囁くもの》	名詞
＠どうくつで	《洞窟で囁くもの》	名詞
＠どうくつでさ	《洞窟で囁くもの》	名詞
＠どうくつでささ	《洞窟で囁くもの》	名詞
＠どうくつでささや	《洞窟で囁くもの》	名詞
＠どうくつでささやく	《洞窟で囁くもの》	名詞
＠どうくつでささやくも	《洞窟で囁くもの》	名詞
＠どうくつでささやくもの	《洞窟で囁くもの》	名詞
＠の	《鋸刃蠍》	名詞
＠のこ	《鋸刃蠍》	名詞
＠のこば	《鋸刃蠍》	名詞
＠のこばさ	《鋸刃蠍》	名詞
＠のこばさそ	《鋸刃蠍》	名詞
＠のこばさそり	《鋸刃蠍》	名詞
＠や	《夜勤隊の猛士》	名詞
＠やき	《夜勤隊の猛士》	名詞
＠やきん	《夜勤隊の猛士》	名詞
＠やきんた	《夜勤隊の猛士》	名詞
＠やきんたい	《夜勤隊の猛士》	名詞
＠やきんたいの	《夜勤隊の猛士》	名詞
＠やきんたいのも	《夜勤隊の猛士》	名詞
＠やきんたいのもう	《夜勤隊の猛士》	名詞
＠やきんたいのもうし	《夜勤隊の猛士》	名詞
＠や	《野生肉の密猟者》	名詞
＠やせ	《野生肉の密猟者》	名詞
＠やせい	《野生肉の密猟者》	名詞
＠やせいに	《野生肉の密猟者》	名詞
＠やせいにく	《野生肉の密猟者》	名詞
＠やせいにくの	《野生肉の密猟者》	名詞
＠やせいにくのみ	《野生肉の密猟者》	名詞
＠やせいにくのみつ	《野生肉の密猟者》	名詞
＠やせいにくのみつり	《野生肉の密猟者》	名詞
＠やせいにくのみつりょ	《野生肉の密猟者》	名詞
＠やせいにくのみつりょう	《野生肉の密猟者》	名詞
＠やせいにくのみつりょうし	《野生肉の密猟者》	名詞
＠やせいにくのみつりょうしゃ	《野生肉の密猟者》	名詞
＠や	《闇の取り引き》	名詞
＠やみ	《闇の取り引き》	名詞
＠やみの	《闇の取り引き》	名詞
＠やみのと	《闇の取り引き》	名詞
＠やみのとり	《闇の取り引き》	名詞
＠やみのとりひ	《闇の取り引き》	名詞
＠やみのとりひき	《闇の取り引き》	名詞
＠よ	《予期せぬ助力》	名詞
＠よき	《予期せぬ助力》	名詞
＠よきせ	《予期せぬ助力》	名詞
＠よきせぬ	《予期せぬ助力》	名詞
＠よきせぬじ	《予期せぬ助力》	名詞
＠よきせぬじょ	《予期せぬ助力》	名詞
＠よきせぬじょり	《予期せぬ助力》	名詞
＠よきせぬじょりょ	《予期せぬ助力》	名詞
＠よきせぬじょりょく	《予期せぬ助力》	名詞
＠よ	《予想外の牙》	名詞
＠よそ	《予想外の牙》	名詞
＠よそう	《予想外の牙》	名詞
＠よそうが	《予想外の牙》	名詞
＠よそうがい	《予想外の牙》	名詞
＠よそうがいの	《予想外の牙》	名詞
＠よそうがいのき	《予想外の牙》	名詞
＠よそうがいのきば	《予想外の牙》	名詞
＠か	《恰好の餌食》	名詞
＠かっ	《恰好の餌食》	名詞
＠かっこ	《恰好の餌食》	名詞
＠かっこう	《恰好の餌食》	名詞
＠かっこうの	《恰好の餌食》	名詞
＠かっこうのえ	《恰好の餌食》	名詞
＠かっこうのえじ	《恰好の餌食》	名詞
＠かっこうのえじき	《恰好の餌食》	名詞
＠く	《暮れ牙の導師》	名詞
＠くれ	《暮れ牙の導師》	名詞
＠くれき	《暮れ牙の導師》	名詞
＠くれきば	《暮れ牙の導師》	名詞
＠くれきばの	《暮れ牙の導師》	名詞
＠くれきばのど	《暮れ牙の導師》	名詞
＠くれきばのどう	《暮れ牙の導師》	名詞
＠くれきばのどうし	《暮れ牙の導師》	名詞
＠ご	《強欲な血喰い》	名詞
＠ごう	《強欲な血喰い》	名詞
＠ごうよ	《強欲な血喰い》	名詞
＠ごうよく	《強欲な血喰い》	名詞
＠ごうよくな	《強欲な血喰い》	名詞
＠ごうよくなち	《強欲な血喰い》	名詞
＠ごうよくなちく	《強欲な血喰い》	名詞
＠ごうよくなちくい	《強欲な血喰い》	名詞
＠こ	《虚空を招くもの》	名詞
＠こく	《虚空を招くもの》	名詞
＠こくう	《虚空を招くもの》	名詞
＠こくうを	《虚空を招くもの》	名詞
＠こくうをま	《虚空を招くもの》	名詞
＠こくうをまね	《虚空を招くもの》	名詞
＠こくうをまねく	《虚空を招くもの》	名詞
＠こくうをまねくも	《虚空を招くもの》	名詞
＠こくうをまねくもの	《虚空を招くもの》	名詞
＠さ	《騒がしい収穫者》	名詞
＠さわ	《騒がしい収穫者》	名詞
＠さわが	《騒がしい収穫者》	名詞
＠さわがし	《騒がしい収穫者》	名詞
＠さわがしい	《騒がしい収穫者》	名詞
＠さわがしいし	《騒がしい収穫者》	名詞
＠さわがしいしゅ	《騒がしい収穫者》	名詞
＠さわがしいしゅう	《騒がしい収穫者》	名詞
＠さわがしいしゅうか	《騒がしい収穫者》	名詞
＠さわがしいしゅうかく	《騒がしい収穫者》	名詞
＠さわがしいしゅうかくし	《騒がしい収穫者》	名詞
＠さわがしいしゅうかくしゃ	《騒がしい収穫者》	名詞
＠し	《死住まいの呼び声》	名詞
＠しず	《死住まいの呼び声》	名詞
＠しずま	《死住まいの呼び声》	名詞
＠しずまい	《死住まいの呼び声》	名詞
＠しずまいの	《死住まいの呼び声》	名詞
＠しずまいのよ	《死住まいの呼び声》	名詞
＠しずまいのよび	《死住まいの呼び声》	名詞
＠しずまいのよびご	《死住まいの呼び声》	名詞
＠しずまいのよびごえ	《死住まいの呼び声》	名詞
＠ぜ	《ゼイゴスのマンバ》	名詞
＠ぜい	《ゼイゴスのマンバ》	名詞
＠ぜいご	《ゼイゴスのマンバ》	名詞
＠ぜいごす	《ゼイゴスのマンバ》	名詞
＠ぜいごすの	《ゼイゴスのマンバ》	名詞
＠ぜいごすのま	《ゼイゴスのマンバ》	名詞
＠ぜいごすのまん	《ゼイゴスのマンバ》	名詞
＠ぜいごすのまんば	《ゼイゴスのマンバ》	名詞
＠そ	《想起の拠点》	名詞
＠そう	《想起の拠点》	名詞
＠そうき	《想起の拠点》	名詞
＠そうきの	《想起の拠点》	名詞
＠そうきのき	《想起の拠点》	名詞
＠そうきのきょ	《想起の拠点》	名詞
＠そうきのきょて	《想起の拠点》	名詞
＠そうきのきょてん	《想起の拠点》	名詞
＠ぶ	《不気味舞い》	名詞
＠ぶき	《不気味舞い》	名詞
＠ぶきみ	《不気味舞い》	名詞
＠ぶきみま	《不気味舞い》	名詞
＠ぶきみまい	《不気味舞い》	名詞
＠ふ	《不断の絆》	名詞
＠ふだ	《不断の絆》	名詞
＠ふだん	《不断の絆》	名詞
＠ふだんの	《不断の絆》	名詞
＠ふだんのき	《不断の絆》	名詞
＠ふだんのきず	《不断の絆》	名詞
＠ふだんのきずな	《不断の絆》	名詞
＠む	《無情な行動》	名詞
＠むじ	《無情な行動》	名詞
＠むじょ	《無情な行動》	名詞
＠むじょう	《無情な行動》	名詞
＠むじょうな	《無情な行動》	名詞
＠むじょうなこ	《無情な行動》	名詞
＠むじょうなこう	《無情な行動》	名詞
＠むじょうなこうど	《無情な行動》	名詞
＠むじょうなこうどう	《無情な行動》	名詞
＠あ	《哀歌コウモリ》	名詞
＠あい	《哀歌コウモリ》	名詞
＠あいか	《哀歌コウモリ》	名詞
＠あいかこ	《哀歌コウモリ》	名詞
＠あいかこう	《哀歌コウモリ》	名詞
＠あいかこうも	《哀歌コウモリ》	名詞
＠あいかこうもり	《哀歌コウモリ》	名詞
＠が	《狩り立てられた悪夢》	名詞
＠がり	《狩り立てられた悪夢》	名詞
＠がりた	《狩り立てられた悪夢》	名詞
＠がりたて	《狩り立てられた悪夢》	名詞
＠がりたてら	《狩り立てられた悪夢》	名詞
＠がりたてられ	《狩り立てられた悪夢》	名詞
＠がりたてられた	《狩り立てられた悪夢》	名詞
＠がりたてられたあ	《狩り立てられた悪夢》	名詞
＠がりたてられたあく	《狩り立てられた悪夢》	名詞
＠がりたてられたあくむ	《狩り立てられた悪夢》	名詞
＠ぜ	《絶滅の契機》	名詞
＠ぜつ	《絶滅の契機》	名詞
＠ぜつめ	《絶滅の契機》	名詞
＠ぜつめつ	《絶滅の契機》	名詞
＠ぜつめつの	《絶滅の契機》	名詞
＠ぜつめつのけ	《絶滅の契機》	名詞
＠ぜつめつのけい	《絶滅の契機》	名詞
＠ぜつめつのけいき	《絶滅の契機》	名詞
＠ね	《ネスロイの神話》	名詞
＠ねす	《ネスロイの神話》	名詞
＠ねすろ	《ネスロイの神話》	名詞
＠ねすろい	《ネスロイの神話》	名詞
＠ねすろいの	《ネスロイの神話》	名詞
＠ねすろいのし	《ネスロイの神話》	名詞
＠ねすろいのしん	《ネスロイの神話》	名詞
＠ねすろいのしんわ	《ネスロイの神話》	名詞
＠あ	《安堵の再会》	名詞
＠あん	《安堵の再会》	名詞
＠あんど	《安堵の再会》	名詞
＠あんどの	《安堵の再会》	名詞
＠あんどのさ	《安堵の再会》	名詞
＠あんどのさい	《安堵の再会》	名詞
＠あんどのさいか	《安堵の再会》	名詞
＠あんどのさいかい	《安堵の再会》	名詞
＠い	《一時的な連帯》	名詞
＠いち	《一時的な連帯》	名詞
＠いちじ	《一時的な連帯》	名詞
＠いちじて	《一時的な連帯》	名詞
＠いちじてき	《一時的な連帯》	名詞
＠いちじてきな	《一時的な連帯》	名詞
＠いちじてきなれ	《一時的な連帯》	名詞
＠いちじてきなれん	《一時的な連帯》	名詞
＠いちじてきなれんた	《一時的な連帯》	名詞
＠いちじてきなれんたい	《一時的な連帯》	名詞
＠き	《切り裂かれた帆》	名詞
＠きり	《切り裂かれた帆》	名詞
＠きりさ	《切り裂かれた帆》	名詞
＠きりさか	《切り裂かれた帆》	名詞
＠きりさかれ	《切り裂かれた帆》	名詞
＠きりさかれた	《切り裂かれた帆》	名詞
＠きりさかれたほ	《切り裂かれた帆》	名詞
＠き	《禁じられた友情》	名詞
＠きん	《禁じられた友情》	名詞
＠きんじ	《禁じられた友情》	名詞
＠きんじら	《禁じられた友情》	名詞
＠きんじられ	《禁じられた友情》	名詞
＠きんじられた	《禁じられた友情》	名詞
＠きんじられたゆ	《禁じられた友情》	名詞
＠きんじられたゆう	《禁じられた友情》	名詞
＠きんじられたゆうじ	《禁じられた友情》	名詞
＠きんじられたゆうじょ	《禁じられた友情》	名詞
＠きんじられたゆうじょう	《禁じられた友情》	名詞
＠く	《雲貫き》	名詞
＠くも	《雲貫き》	名詞
＠くもつ	《雲貫き》	名詞
＠くもつら	《雲貫き》	名詞
＠くもつらぬ	《雲貫き》	名詞
＠くもつらぬき	《雲貫き》	名詞
＠げ	《激情の猛竜》	名詞
＠げき	《激情の猛竜》	名詞
＠げきじ	《激情の猛竜》	名詞
＠げきじょ	《激情の猛竜》	名詞
＠げきじょう	《激情の猛竜》	名詞
＠げきじょうの	《激情の猛竜》	名詞
＠げきじょうのも	《激情の猛竜》	名詞
＠げきじょうのもう	《激情の猛竜》	名詞
＠げきじょうのもうり	《激情の猛竜》	名詞
＠げきじょうのもうりゅ	《激情の猛竜》	名詞
＠げきじょうのもうりゅう	《激情の猛竜》	名詞
＠じ	《呪文喰いクズリ》	名詞
＠じゅ	《呪文喰いクズリ》	名詞
＠じゅも	《呪文喰いクズリ》	名詞
＠じゅもん	《呪文喰いクズリ》	名詞
＠じゅもんく	《呪文喰いクズリ》	名詞
＠じゅもんくい	《呪文喰いクズリ》	名詞
＠じゅもんくいく	《呪文喰いクズリ》	名詞
＠じゅもんくいくず	《呪文喰いクズリ》	名詞
＠じゅもんくいくずり	《呪文喰いクズリ》	名詞
＠ち	《血の希求》	名詞
＠ちの	《血の希求》	名詞
＠ちのき	《血の希求》	名詞
＠ちのきき	《血の希求》	名詞
＠ちのききゅ	《血の希求》	名詞
＠ちのききゅう	《血の希求》	名詞
＠ど	《獰猛なゴリトラ》	名詞
＠どう	《獰猛なゴリトラ》	名詞
＠どうも	《獰猛なゴリトラ》	名詞
＠どうもう	《獰猛なゴリトラ》	名詞
＠どうもうな	《獰猛なゴリトラ》	名詞
＠どうもうなご	《獰猛なゴリトラ》	名詞
＠どうもうなごり	《獰猛なゴリトラ》	名詞
＠どうもうなごりと	《獰猛なゴリトラ》	名詞
＠どうもうなごりとら	《獰猛なゴリトラ》	名詞
＠と	《トゲマーモセット》	名詞
＠とげ	《トゲマーモセット》	名詞
＠とげま	《トゲマーモセット》	名詞
＠とげまー	《トゲマーモセット》	名詞
＠とげまーも	《トゲマーモセット》	名詞
＠とげまーもせ	《トゲマーモセット》	名詞
＠とげまーもせっ	《トゲマーモセット》	名詞
＠とげまーもせっと	《トゲマーモセット》	名詞
＠と	《轟く岩滑り》	名詞
＠とど	《轟く岩滑り》	名詞
＠とどろ	《轟く岩滑り》	名詞
＠とどろく	《轟く岩滑り》	名詞
＠とどろくい	《轟く岩滑り》	名詞
＠とどろくいわ	《轟く岩滑り》	名詞
＠とどろくいわす	《轟く岩滑り》	名詞
＠とどろくいわすべ	《轟く岩滑り》	名詞
＠とどろくいわすべり	《轟く岩滑り》	名詞
＠ど	《ドラニスの刺突者》	名詞
＠どら	《ドラニスの刺突者》	名詞
＠どらに	《ドラニスの刺突者》	名詞
＠どらにす	《ドラニスの刺突者》	名詞
＠どらにすの	《ドラニスの刺突者》	名詞
＠どらにすのし	《ドラニスの刺突者》	名詞
＠どらにすのしと	《ドラニスの刺突者》	名詞
＠どらにすのしとつ	《ドラニスの刺突者》	名詞
＠どらにすのしとつし	《ドラニスの刺突者》	名詞
＠どらにすのしとつしゃ	《ドラニスの刺突者》	名詞
＠ぱ	《パイロケラトプス》	名詞
＠ぱい	《パイロケラトプス》	名詞
＠ぱいろ	《パイロケラトプス》	名詞
＠ぱいろけ	《パイロケラトプス》	名詞
＠ぱいろけら	《パイロケラトプス》	名詞
＠ぱいろけらと	《パイロケラトプス》	名詞
＠ぱいろけらとぷ	《パイロケラトプス》	名詞
＠ぱいろけらとぷす	《パイロケラトプス》	名詞
＠は	《反射神経の亢進》	名詞
＠はん	《反射神経の亢進》	名詞
＠はんし	《反射神経の亢進》	名詞
＠はんしゃ	《反射神経の亢進》	名詞
＠はんしゃし	《反射神経の亢進》	名詞
＠はんしゃしん	《反射神経の亢進》	名詞
＠はんしゃしんけ	《反射神経の亢進》	名詞
＠はんしゃしんけい	《反射神経の亢進》	名詞
＠はんしゃしんけいの	《反射神経の亢進》	名詞
＠はんしゃしんけいのこ	《反射神経の亢進》	名詞
＠はんしゃしんけいのこう	《反射神経の亢進》	名詞
＠はんしゃしんけいのこうし	《反射神経の亢進》	名詞
＠はんしゃしんけいのこうしん	《反射神経の亢進》	名詞
＠ひ	《ひっかく鉤爪》	名詞
＠ひっ	《ひっかく鉤爪》	名詞
＠ひっか	《ひっかく鉤爪》	名詞
＠ひっかく	《ひっかく鉤爪》	名詞
＠ひっかくか	《ひっかく鉤爪》	名詞
＠ひっかくかぎ	《ひっかく鉤爪》	名詞
＠ひっかくかぎつ	《ひっかく鉤爪》	名詞
＠ひっかくかぎつめ	《ひっかく鉤爪》	名詞
＠ひ	《火の予言》	名詞
＠ひの	《火の予言》	名詞
＠ひのよ	《火の予言》	名詞
＠ひのよげ	《火の予言》	名詞
＠ひのよげん	《火の予言》	名詞
＠も	《猛火の斉射》	名詞
＠もう	《猛火の斉射》	名詞
＠もうか	《猛火の斉射》	名詞
＠もうかの	《猛火の斉射》	名詞
＠もうかのせ	《猛火の斉射》	名詞
＠もうかのせい	《猛火の斉射》	名詞
＠もうかのせいし	《猛火の斉射》	名詞
＠もうかのせいしゃ	《猛火の斉射》	名詞
＠か	《火傷吐きグレムリン》	名詞
＠かし	《火傷吐きグレムリン》	名詞
＠かしょ	《火傷吐きグレムリン》	名詞
＠かしょう	《火傷吐きグレムリン》	名詞
＠かしょうは	《火傷吐きグレムリン》	名詞
＠かしょうはき	《火傷吐きグレムリン》	名詞
＠かしょうはきぐ	《火傷吐きグレムリン》	名詞
＠かしょうはきぐれ	《火傷吐きグレムリン》	名詞
＠かしょうはきぐれむ	《火傷吐きグレムリン》	名詞
＠かしょうはきぐれむり	《火傷吐きグレムリン》	名詞
＠かしょうはきぐれむりん	《火傷吐きグレムリン》	名詞
＠よ	《溶岩の海蛇》	名詞
＠よう	《溶岩の海蛇》	名詞
＠ようが	《溶岩の海蛇》	名詞
＠ようがん	《溶岩の海蛇》	名詞
＠ようがんの	《溶岩の海蛇》	名詞
＠ようがんのう	《溶岩の海蛇》	名詞
＠ようがんのうみ	《溶岩の海蛇》	名詞
＠ようがんのうみへ	《溶岩の海蛇》	名詞
＠ようがんのうみへび	《溶岩の海蛇》	名詞
＠い	《勢い付く地鳴らし》	名詞
＠いき	《勢い付く地鳴らし》	名詞
＠いきお	《勢い付く地鳴らし》	名詞
＠いきおい	《勢い付く地鳴らし》	名詞
＠いきおいづ	《勢い付く地鳴らし》	名詞
＠いきおいづく	《勢い付く地鳴らし》	名詞
＠いきおいづくち	《勢い付く地鳴らし》	名詞
＠いきおいづくちな	《勢い付く地鳴らし》	名詞
＠いきおいづくちなら	《勢い付く地鳴らし》	名詞
＠いきおいづくちならし	《勢い付く地鳴らし》	名詞
＠え	《襟脅しの導師》	名詞
＠えり	《襟脅しの導師》	名詞
＠えりお	《襟脅しの導師》	名詞
＠えりおど	《襟脅しの導師》	名詞
＠えりおどし	《襟脅しの導師》	名詞
＠えりおどしの	《襟脅しの導師》	名詞
＠えりおどしのど	《襟脅しの導師》	名詞
＠えりおどしのどう	《襟脅しの導師》	名詞
＠えりおどしのどうし	《襟脅しの導師》	名詞
＠か	《怪物の兵器化》	名詞
＠かい	《怪物の兵器化》	名詞
＠かいぶ	《怪物の兵器化》	名詞
＠かいぶつ	《怪物の兵器化》	名詞
＠かいぶつの	《怪物の兵器化》	名詞
＠かいぶつのへ	《怪物の兵器化》	名詞
＠かいぶつのへい	《怪物の兵器化》	名詞
＠かいぶつのへいき	《怪物の兵器化》	名詞
＠かいぶつのへいきか	《怪物の兵器化》	名詞
＠き	《巨獣の激突》	名詞
＠きょ	《巨獣の激突》	名詞
＠きょじ	《巨獣の激突》	名詞
＠きょじゅ	《巨獣の激突》	名詞
＠きょじゅう	《巨獣の激突》	名詞
＠きょじゅうの	《巨獣の激突》	名詞
＠きょじゅうのげ	《巨獣の激突》	名詞
＠きょじゅうのげき	《巨獣の激突》	名詞
＠きょじゅうのげきと	《巨獣の激突》	名詞
＠きょじゅうのげきとつ	《巨獣の激突》	名詞
＠せ	《聖域潰し》	名詞
＠せい	《聖域潰し》	名詞
＠せいい	《聖域潰し》	名詞
＠せいいき	《聖域潰し》	名詞
＠せいいきつ	《聖域潰し》	名詞
＠せいいきつぶ	《聖域潰し》	名詞
＠せいいきつぶし	《聖域潰し》	名詞
＠は	《発根のモロク》	名詞
＠はっ	《発根のモロク》	名詞
＠はっこ	《発根のモロク》	名詞
＠はっこん	《発根のモロク》	名詞
＠はっこんの	《発根のモロク》	名詞
＠はっこんのも	《発根のモロク》	名詞
＠はっこんのもろ	《発根のモロク》	名詞
＠はっこんのもろく	《発根のモロク》	名詞
＠は	《爬虫類の反射》	名詞
＠はち	《爬虫類の反射》	名詞
＠はちゅ	《爬虫類の反射》	名詞
＠はちゅう	《爬虫類の反射》	名詞
＠はちゅうる	《爬虫類の反射》	名詞
＠はちゅうるい	《爬虫類の反射》	名詞
＠はちゅうるいの	《爬虫類の反射》	名詞
＠はちゅうるいのは	《爬虫類の反射》	名詞
＠はちゅうるいのはん	《爬虫類の反射》	名詞
＠はちゅうるいのはんし	《爬虫類の反射》	名詞
＠はちゅうるいのはんしゃ	《爬虫類の反射》	名詞
＠ふ	《踏み穴のクレーター》	名詞
＠ふみ	《踏み穴のクレーター》	名詞
＠ふみあ	《踏み穴のクレーター》	名詞
＠ふみあな	《踏み穴のクレーター》	名詞
＠ふみあなの	《踏み穴のクレーター》	名詞
＠ふみあなのく	《踏み穴のクレーター》	名詞
＠ふみあなのくれ	《踏み穴のクレーター》	名詞
＠ふみあなのくれー	《踏み穴のクレーター》	名詞
＠ふみあなのくれーた	《踏み穴のクレーター》	名詞
＠ふみあなのくれーたー	《踏み穴のクレーター》	名詞
＠え	《炎の氾濫》	名詞
＠えん	《炎の氾濫》	名詞
＠えんの	《炎の氾濫》	名詞
＠えんのは	《炎の氾濫》	名詞
＠えんのはん	《炎の氾濫》	名詞
＠えんのはんら	《炎の氾濫》	名詞
＠えんのはんらん	《炎の氾濫》	名詞
＠や	《ヤマオウム》	名詞
＠やま	《ヤマオウム》	名詞
＠やまお	《ヤマオウム》	名詞
＠やまおう	《ヤマオウム》	名詞
＠やまおうむ	《ヤマオウム》	名詞
＠か	《雷猛竜の襲撃》	名詞
＠かみ	《雷猛竜の襲撃》	名詞
＠かみな	《雷猛竜の襲撃》	名詞
＠かみなり	《雷猛竜の襲撃》	名詞
＠かみなりも	《雷猛竜の襲撃》	名詞
＠かみなりもう	《雷猛竜の襲撃》	名詞
＠かみなりもうり	《雷猛竜の襲撃》	名詞
＠かみなりもうりゅ	《雷猛竜の襲撃》	名詞
＠かみなりもうりゅう	《雷猛竜の襲撃》	名詞
＠かみなりもうりゅうの	《雷猛竜の襲撃》	名詞
＠かみなりもうりゅうのし	《雷猛竜の襲撃》	名詞
＠かみなりもうりゅうのしゅ	《雷猛竜の襲撃》	名詞
＠かみなりもうりゅうのしゅう	《雷猛竜の襲撃》	名詞
＠かみなりもうりゅうのしゅうげ	《雷猛竜の襲撃》	名詞
＠かみなりもうりゅうのしゅうげき	《雷猛竜の襲撃》	名詞
＠ヴ	《ヴァドロックの神話》	名詞
＠ヴぁ	《ヴァドロックの神話》	名詞
＠ヴぁど	《ヴァドロックの神話》	名詞
＠ヴぁどろ	《ヴァドロックの神話》	名詞
＠ヴぁどろっ	《ヴァドロックの神話》	名詞
＠ヴぁどろっく	《ヴァドロックの神話》	名詞
＠ヴぁどろっくの	《ヴァドロックの神話》	名詞
＠ヴぁどろっくのし	《ヴァドロックの神話》	名詞
＠ヴぁどろっくのしん	《ヴァドロックの神話》	名詞
＠ヴぁどろっくのしんわ	《ヴァドロックの神話》	名詞
＠え	《永遠羽のフェニックス》	名詞
＠えい	《永遠羽のフェニックス》	名詞
＠えいえ	《永遠羽のフェニックス》	名詞
＠えいえん	《永遠羽のフェニックス》	名詞
＠えいえんわ	《永遠羽のフェニックス》	名詞
＠えいえんわの	《永遠羽のフェニックス》	名詞
＠えいえんわのふ	《永遠羽のフェニックス》	名詞
＠えいえんわのふぇ	《永遠羽のフェニックス》	名詞
＠えいえんわのふぇに	《永遠羽のフェニックス》	名詞
＠えいえんわのふぇにっ	《永遠羽のフェニックス》	名詞
＠えいえんわのふぇにっく	《永遠羽のフェニックス》	名詞
＠えいえんわのふぇにっくす	《永遠羽のフェニックス》	名詞
＠さ	《さまよう怪物、イダーロ》	名詞
＠さま	《さまよう怪物、イダーロ》	名詞
＠さまよ	《さまよう怪物、イダーロ》	名詞
＠さまよう	《さまよう怪物、イダーロ》	名詞
＠さまようか	《さまよう怪物、イダーロ》	名詞
＠さまようかい	《さまよう怪物、イダーロ》	名詞
＠さまようかいぶ	《さまよう怪物、イダーロ》	名詞
＠さまようかいぶつ	《さまよう怪物、イダーロ》	名詞
＠さまようかいぶつ、	《さまよう怪物、イダーロ》	名詞
＠さまようかいぶつ、い	《さまよう怪物、イダーロ》	名詞
＠さまようかいぶつ、いだ	《さまよう怪物、イダーロ》	名詞
＠さまようかいぶつ、いだー	《さまよう怪物、イダーロ》	名詞
＠さまようかいぶつ、いだーろ	《さまよう怪物、イダーロ》	名詞
＠い	《さまよう怪物、イダーロ》	名詞
＠いだ	《さまよう怪物、イダーロ》	名詞
＠いだー	《さまよう怪物、イダーロ》	名詞
＠いだーろ	《さまよう怪物、イダーロ》	名詞
＠よ	《予測不能な竜巻》	名詞
＠よそ	《予測不能な竜巻》	名詞
＠よそく	《予測不能な竜巻》	名詞
＠よそくふ	《予測不能な竜巻》	名詞
＠よそくふの	《予測不能な竜巻》	名詞
＠よそくふのう	《予測不能な竜巻》	名詞
＠よそくふのうな	《予測不能な竜巻》	名詞
＠よそくふのうなた	《予測不能な竜巻》	名詞
＠よそくふのうなたつ	《予測不能な竜巻》	名詞
＠よそくふのうなたつま	《予測不能な竜巻》	名詞
＠よそくふのうなたつまき	《予測不能な竜巻》	名詞
＠ど	《銅纏いののけ者、ルーカ》	名詞
＠どう	《銅纏いののけ者、ルーカ》	名詞
＠どうま	《銅纏いののけ者、ルーカ》	名詞
＠どうまと	《銅纏いののけ者、ルーカ》	名詞
＠どうまとい	《銅纏いののけ者、ルーカ》	名詞
＠どうまといの	《銅纏いののけ者、ルーカ》	名詞
＠どうまといのの	《銅纏いののけ者、ルーカ》	名詞
＠どうまといののけ	《銅纏いののけ者、ルーカ》	名詞
＠どうまといののけも	《銅纏いののけ者、ルーカ》	名詞
＠どうまといののけもの	《銅纏いののけ者、ルーカ》	名詞
＠どうまといののけもの、	《銅纏いののけ者、ルーカ》	名詞
＠どうまといののけもの、る	《銅纏いののけ者、ルーカ》	名詞
＠どうまといののけもの、るー	《銅纏いののけ者、ルーカ》	名詞
＠どうまといののけもの、るーか	《銅纏いののけ者、ルーカ》	名詞
＠る	《銅纏いののけ者、ルーカ》	名詞
＠るー	《銅纏いののけ者、ルーカ》	名詞
＠るーか	《銅纏いののけ者、ルーカ》	名詞
＠お	《大いなるサンドワーム》	名詞
＠おお	《大いなるサンドワーム》	名詞
＠おおい	《大いなるサンドワーム》	名詞
＠おおいな	《大いなるサンドワーム》	名詞
＠おおいなる	《大いなるサンドワーム》	名詞
＠おおいなるさ	《大いなるサンドワーム》	名詞
＠おおいなるさん	《大いなるサンドワーム》	名詞
＠おおいなるさんど	《大いなるサンドワーム》	名詞
＠おおいなるさんどわ	《大いなるサンドワーム》	名詞
＠おおいなるさんどわー	《大いなるサンドワーム》	名詞
＠おおいなるさんどわーむ	《大いなるサンドワーム》	名詞
＠き	《強行突破》	名詞
＠きょ	《強行突破》	名詞
＠きょう	《強行突破》	名詞
＠きょうこ	《強行突破》	名詞
＠きょうこう	《強行突破》	名詞
＠きょうこうと	《強行突破》	名詞
＠きょうこうとっ	《強行突破》	名詞
＠きょうこうとっぱ	《強行突破》	名詞
＠く	《掘削モグラ》	名詞
＠くっ	《掘削モグラ》	名詞
＠くっさ	《掘削モグラ》	名詞
＠くっさく	《掘削モグラ》	名詞
＠くっさくも	《掘削モグラ》	名詞
＠くっさくもぐ	《掘削モグラ》	名詞
＠くっさくもぐら	《掘削モグラ》	名詞
＠け	《謙虚な自然主義者》	名詞
＠けん	《謙虚な自然主義者》	名詞
＠けんき	《謙虚な自然主義者》	名詞
＠けんきょ	《謙虚な自然主義者》	名詞
＠けんきょな	《謙虚な自然主義者》	名詞
＠けんきょなし	《謙虚な自然主義者》	名詞
＠けんきょなしぜ	《謙虚な自然主義者》	名詞
＠けんきょなしぜん	《謙虚な自然主義者》	名詞
＠けんきょなしぜんし	《謙虚な自然主義者》	名詞
＠けんきょなしぜんしゅ	《謙虚な自然主義者》	名詞
＠けんきょなしぜんしゅぎ	《謙虚な自然主義者》	名詞
＠けんきょなしぜんしゅぎし	《謙虚な自然主義者》	名詞
＠けんきょなしぜんしゅぎしゃ	《謙虚な自然主義者》	名詞
＠こ	《苔毛のゴリアク》	名詞
＠こけ	《苔毛のゴリアク》	名詞
＠こけげ	《苔毛のゴリアク》	名詞
＠こけげの	《苔毛のゴリアク》	名詞
＠こけげのご	《苔毛のゴリアク》	名詞
＠こけげのごり	《苔毛のゴリアク》	名詞
＠こけげのごりあ	《苔毛のゴリアク》	名詞
＠こけげのごりあく	《苔毛のゴリアク》	名詞
＠ぎ	《逆毛の猪》	名詞
＠ぎゃ	《逆毛の猪》	名詞
＠ぎゃく	《逆毛の猪》	名詞
＠ぎゃくげ	《逆毛の猪》	名詞
＠ぎゃくげの	《逆毛の猪》	名詞
＠ぎゃくげのい	《逆毛の猪》	名詞
＠ぎゃくげのいの	《逆毛の猪》	名詞
＠ぎゃくげのいのし	《逆毛の猪》	名詞
＠ぎゃくげのいのしし	《逆毛の猪》	名詞
＠し	《萎れ》	名詞
＠しお	《萎れ》	名詞
＠しおれ	《萎れ》	名詞
＠じ	《充分な成長》	名詞
＠じゅ	《充分な成長》	名詞
＠じゅう	《充分な成長》	名詞
＠じゅうぶ	《充分な成長》	名詞
＠じゅうぶん	《充分な成長》	名詞
＠じゅうぶんな	《充分な成長》	名詞
＠じゅうぶんなせ	《充分な成長》	名詞
＠じゅうぶんなせい	《充分な成長》	名詞
＠じゅうぶんなせいち	《充分な成長》	名詞
＠じゅうぶんなせいちょ	《充分な成長》	名詞
＠じゅうぶんなせいちょう	《充分な成長》	名詞
＠す	《垂直落下》	名詞
＠すい	《垂直落下》	名詞
＠すいち	《垂直落下》	名詞
＠すいちょ	《垂直落下》	名詞
＠すいちょく	《垂直落下》	名詞
＠すいちょくら	《垂直落下》	名詞
＠すいちょくらっ	《垂直落下》	名詞
＠すいちょくらっか	《垂直落下》	名詞
＠せ	《生存者の絆》	名詞
＠せい	《生存者の絆》	名詞
＠せいぞ	《生存者の絆》	名詞
＠せいぞん	《生存者の絆》	名詞
＠せいぞんし	《生存者の絆》	名詞
＠せいぞんしゃ	《生存者の絆》	名詞
＠せいぞんしゃの	《生存者の絆》	名詞
＠せいぞんしゃのき	《生存者の絆》	名詞
＠せいぞんしゃのきず	《生存者の絆》	名詞
＠せいぞんしゃのきずな	《生存者の絆》	名詞
＠て	《敵軍妨害》	名詞
＠てき	《敵軍妨害》	名詞
＠てきぐ	《敵軍妨害》	名詞
＠てきぐん	《敵軍妨害》	名詞
＠てきぐんぼ	《敵軍妨害》	名詞
＠てきぐんぼう	《敵軍妨害》	名詞
＠てきぐんぼうが	《敵軍妨害》	名詞
＠てきぐんぼうがい	《敵軍妨害》	名詞
＠と	《突然の吐糸》	名詞
＠とつ	《突然の吐糸》	名詞
＠とつぜ	《突然の吐糸》	名詞
＠とつぜん	《突然の吐糸》	名詞
＠とつぜんの	《突然の吐糸》	名詞
＠とつぜんのと	《突然の吐糸》	名詞
＠とつぜんのとし	《突然の吐糸》	名詞
＠は	《ハエ捕り長首》	名詞
＠はえ	《ハエ捕り長首》	名詞
＠はえと	《ハエ捕り長首》	名詞
＠はえとり	《ハエ捕り長首》	名詞
＠はえとりち	《ハエ捕り長首》	名詞
＠はえとりちょ	《ハエ捕り長首》	名詞
＠はえとりちょう	《ハエ捕り長首》	名詞
＠はえとりちょうく	《ハエ捕り長首》	名詞
＠はえとりちょうくび	《ハエ捕り長首》	名詞
＠は	《蜂蜜マンモス》	名詞
＠はち	《蜂蜜マンモス》	名詞
＠はちみ	《蜂蜜マンモス》	名詞
＠はちみつ	《蜂蜜マンモス》	名詞
＠はちみつま	《蜂蜜マンモス》	名詞
＠はちみつまん	《蜂蜜マンモス》	名詞
＠はちみつまんも	《蜂蜜マンモス》	名詞
＠はちみつまんもす	《蜂蜜マンモス》	名詞
＠ば	《万能のブラッシュワグ》	名詞
＠ばん	《万能のブラッシュワグ》	名詞
＠ばんの	《万能のブラッシュワグ》	名詞
＠ばんのう	《万能のブラッシュワグ》	名詞
＠ばんのうの	《万能のブラッシュワグ》	名詞
＠ばんのうのぶ	《万能のブラッシュワグ》	名詞
＠ばんのうのぶら	《万能のブラッシュワグ》	名詞
＠ばんのうのぶらっ	《万能のブラッシュワグ》	名詞
＠ばんのうのぶらっし	《万能のブラッシュワグ》	名詞
＠ばんのうのぶらっしゅ	《万能のブラッシュワグ》	名詞
＠ばんのうのぶらっしゅわ	《万能のブラッシュワグ》	名詞
＠ばんのうのぶらっしゅわぐ	《万能のブラッシュワグ》	名詞
＠ふ	《ファーティリド》	名詞
＠ふぁ	《ファーティリド》	名詞
＠ふぁー	《ファーティリド》	名詞
＠ふぁーて	《ファーティリド》	名詞
＠ふぁーてぃ	《ファーティリド》	名詞
＠ふぁーてぃり	《ファーティリド》	名詞
＠ふぁーてぃりど	《ファーティリド》	名詞
＠ぼ	《冒険の衝動》	名詞
＠ぼう	《冒険の衝動》	名詞
＠ぼうけ	《冒険の衝動》	名詞
＠ぼうけん	《冒険の衝動》	名詞
＠ぼうけんの	《冒険の衝動》	名詞
＠ぼうけんのし	《冒険の衝動》	名詞
＠ぼうけんのしょ	《冒険の衝動》	名詞
＠ぼうけんのしょう	《冒険の衝動》	名詞
＠ぼうけんのしょうど	《冒険の衝動》	名詞
＠ぼうけんのしょうどう	《冒険の衝動》	名詞
＠ほ	《本質共生体》	名詞
＠ほん	《本質共生体》	名詞
＠ほんし	《本質共生体》	名詞
＠ほんしつ	《本質共生体》	名詞
＠ほんしつき	《本質共生体》	名詞
＠ほんしつきょ	《本質共生体》	名詞
＠ほんしつきょう	《本質共生体》	名詞
＠ほんしつきょうせ	《本質共生体》	名詞
＠ほんしつきょうせい	《本質共生体》	名詞
＠ほんしつきょうせいた	《本質共生体》	名詞
＠ほんしつきょうせいたい	《本質共生体》	名詞
＠わ	《渡る大角》	名詞
＠わた	《渡る大角》	名詞
＠わたる	《渡る大角》	名詞
＠わたるお	《渡る大角》	名詞
＠わたるおお	《渡る大角》	名詞
＠わたるおおす	《渡る大角》	名詞
＠わたるおおすみ	《渡る大角》	名詞
＠い	《移動経路》	名詞
＠いど	《移動経路》	名詞
＠いどう	《移動経路》	名詞
＠いどうけ	《移動経路》	名詞
＠いどうけい	《移動経路》	名詞
＠いどうけいろ	《移動経路》	名詞
＠え	《永遠獣の突撃》	名詞
＠えい	《永遠獣の突撃》	名詞
＠えいえ	《永遠獣の突撃》	名詞
＠えいえん	《永遠獣の突撃》	名詞
＠えいえんじ	《永遠獣の突撃》	名詞
＠えいえんじゅ	《永遠獣の突撃》	名詞
＠えいえんじゅう	《永遠獣の突撃》	名詞
＠えいえんじゅうの	《永遠獣の突撃》	名詞
＠えいえんじゅうのと	《永遠獣の突撃》	名詞
＠えいえんじゅうのとつ	《永遠獣の突撃》	名詞
＠えいえんじゅうのとつげ	《永遠獣の突撃》	名詞
＠えいえんじゅうのとつげき	《永遠獣の突撃》	名詞
＠か	《輝き石のイトグモ》	名詞
＠かが	《輝き石のイトグモ》	名詞
＠かがや	《輝き石のイトグモ》	名詞
＠かがやき	《輝き石のイトグモ》	名詞
＠かがやきせ	《輝き石のイトグモ》	名詞
＠かがやきせき	《輝き石のイトグモ》	名詞
＠かがやきせきの	《輝き石のイトグモ》	名詞
＠かがやきせきのい	《輝き石のイトグモ》	名詞
＠かがやきせきのいと	《輝き石のイトグモ》	名詞
＠かがやきせきのいとぐ	《輝き石のイトグモ》	名詞
＠かがやきせきのいとぐも	《輝き石のイトグモ》	名詞
＠き	《キヅタの精霊》	名詞
＠きづ	《キヅタの精霊》	名詞
＠きづた	《キヅタの精霊》	名詞
＠きづたの	《キヅタの精霊》	名詞
＠きづたのせ	《キヅタの精霊》	名詞
＠きづたのせい	《キヅタの精霊》	名詞
＠きづたのせいれ	《キヅタの精霊》	名詞
＠きづたのせいれい	《キヅタの精霊》	名詞
＠き	《巨怪な一歩》	名詞
＠きょ	《巨怪な一歩》	名詞
＠きょか	《巨怪な一歩》	名詞
＠きょかい	《巨怪な一歩》	名詞
＠きょかいな	《巨怪な一歩》	名詞
＠きょかいない	《巨怪な一歩》	名詞
＠きょかいないち	《巨怪な一歩》	名詞
＠きょかいないちほ	《巨怪な一歩》	名詞
＠し	《障壁突破》	名詞
＠しょ	《障壁突破》	名詞
＠しょう	《障壁突破》	名詞
＠しょうへ	《障壁突破》	名詞
＠しょうへき	《障壁突破》	名詞
＠しょうへきと	《障壁突破》	名詞
＠しょうへきとっ	《障壁突破》	名詞
＠しょうへきとっぱ	《障壁突破》	名詞
＠た	《タイタノス・レックス》	名詞
＠たい	《タイタノス・レックス》	名詞
＠たいた	《タイタノス・レックス》	名詞
＠たいたの	《タイタノス・レックス》	名詞
＠たいたのす	《タイタノス・レックス》	名詞
＠たいたのす・	《タイタノス・レックス》	名詞
＠たいたのす・れ	《タイタノス・レックス》	名詞
＠たいたのす・れっ	《タイタノス・レックス》	名詞
＠たいたのす・れっく	《タイタノス・レックス》	名詞
＠たいたのす・れっくす	《タイタノス・レックス》	名詞
＠か	《角突きの導師》	名詞
＠かく	《角突きの導師》	名詞
＠かくと	《角突きの導師》	名詞
＠かくとっ	《角突きの導師》	名詞
＠かくとっき	《角突きの導師》	名詞
＠かくとっきの	《角突きの導師》	名詞
＠かくとっきのど	《角突きの導師》	名詞
＠かくとっきのどう	《角突きの導師》	名詞
＠かくとっきのどうし	《角突きの導師》	名詞
＠は	《溌剌とした狼熊》	名詞
＠はつ	《溌剌とした狼熊》	名詞
＠はつら	《溌剌とした狼熊》	名詞
＠はつらつ	《溌剌とした狼熊》	名詞
＠はつらつと	《溌剌とした狼熊》	名詞
＠はつらつとし	《溌剌とした狼熊》	名詞
＠はつらつとした	《溌剌とした狼熊》	名詞
＠はつらつとしたお	《溌剌とした狼熊》	名詞
＠はつらつとしたおお	《溌剌とした狼熊》	名詞
＠はつらつとしたおおか	《溌剌とした狼熊》	名詞
＠はつらつとしたおおかみ	《溌剌とした狼熊》	名詞
＠はつらつとしたおおかみぐ	《溌剌とした狼熊》	名詞
＠はつらつとしたおおかみぐま	《溌剌とした狼熊》	名詞
＠ぼ	《暴走の先導》	名詞
＠ぼう	《暴走の先導》	名詞
＠ぼうそ	《暴走の先導》	名詞
＠ぼうそう	《暴走の先導》	名詞
＠ぼうそうの	《暴走の先導》	名詞
＠ぼうそうのせ	《暴走の先導》	名詞
＠ぼうそうのせん	《暴走の先導》	名詞
＠ぼうそうのせんど	《暴走の先導》	名詞
＠ぼうそうのせんどう	《暴走の先導》	名詞
＠め	《恵みのスターリックス》	名詞
＠めぐ	《恵みのスターリックス》	名詞
＠めぐみ	《恵みのスターリックス》	名詞
＠めぐみの	《恵みのスターリックス》	名詞
＠めぐみのす	《恵みのスターリックス》	名詞
＠めぐみのすた	《恵みのスターリックス》	名詞
＠めぐみのすたー	《恵みのスターリックス》	名詞
＠めぐみのすたーり	《恵みのスターリックス》	名詞
＠めぐみのすたーりっ	《恵みのスターリックス》	名詞
＠めぐみのすたーりっく	《恵みのスターリックス》	名詞
＠めぐみのすたーりっくす	《恵みのスターリックス》	名詞
＠き	《巨大猿、コグラ》	名詞
＠きょ	《巨大猿、コグラ》	名詞
＠きょだ	《巨大猿、コグラ》	名詞
＠きょだい	《巨大猿、コグラ》	名詞
＠きょだいざ	《巨大猿、コグラ》	名詞
＠きょだいざる	《巨大猿、コグラ》	名詞
＠きょだいざる、	《巨大猿、コグラ》	名詞
＠きょだいざる、こ	《巨大猿、コグラ》	名詞
＠きょだいざる、こぐ	《巨大猿、コグラ》	名詞
＠きょだいざる、こぐら	《巨大猿、コグラ》	名詞
＠こ	《巨大猿、コグラ》	名詞
＠こぐ	《巨大猿、コグラ》	名詞
＠こぐら	《巨大猿、コグラ》	名詞
＠す	《水晶壊し》	名詞
＠すい	《水晶壊し》	名詞
＠すいし	《水晶壊し》	名詞
＠すいしょ	《水晶壊し》	名詞
＠すいしょう	《水晶壊し》	名詞
＠すいしょうこ	《水晶壊し》	名詞
＠すいしょうこわ	《水晶壊し》	名詞
＠すいしょうこわし	《水晶壊し》	名詞
＠ち	《著大化》	名詞
＠ちょ	《著大化》	名詞
＠ちょだ	《著大化》	名詞
＠ちょだい	《著大化》	名詞
＠ちょだいか	《著大化》	名詞
＠ぶ	《ブロコスの神話》	名詞
＠ぶろ	《ブロコスの神話》	名詞
＠ぶろこ	《ブロコスの神話》	名詞
＠ぶろこす	《ブロコスの神話》	名詞
＠ぶろこすの	《ブロコスの神話》	名詞
＠ぶろこすのし	《ブロコスの神話》	名詞
＠ぶろこすのしん	《ブロコスの神話》	名詞
＠ぶろこすのしんわ	《ブロコスの神話》	名詞
＠か	《怪物の代言者、ビビアン》	名詞
＠かい	《怪物の代言者、ビビアン》	名詞
＠かいぶ	《怪物の代言者、ビビアン》	名詞
＠かいぶつ	《怪物の代言者、ビビアン》	名詞
＠かいぶつの	《怪物の代言者、ビビアン》	名詞
＠かいぶつのだ	《怪物の代言者、ビビアン》	名詞
＠かいぶつのだい	《怪物の代言者、ビビアン》	名詞
＠かいぶつのだいげ	《怪物の代言者、ビビアン》	名詞
＠かいぶつのだいげん	《怪物の代言者、ビビアン》	名詞
＠かいぶつのだいげんし	《怪物の代言者、ビビアン》	名詞
＠かいぶつのだいげんしゃ	《怪物の代言者、ビビアン》	名詞
＠かいぶつのだいげんしゃ、	《怪物の代言者、ビビアン》	名詞
＠かいぶつのだいげんしゃ、び	《怪物の代言者、ビビアン》	名詞
＠かいぶつのだいげんしゃ、びび	《怪物の代言者、ビビアン》	名詞
＠かいぶつのだいげんしゃ、びびあ	《怪物の代言者、ビビアン》	名詞
＠かいぶつのだいげんしゃ、びびあん	《怪物の代言者、ビビアン》	名詞
＠び	《怪物の代言者、ビビアン》	名詞
＠びび	《怪物の代言者、ビビアン》	名詞
＠びびあ	《怪物の代言者、ビビアン》	名詞
＠びびあん	《怪物の代言者、ビビアン》	名詞
＠そ	《空猫の君主》	名詞
＠そら	《空猫の君主》	名詞
＠そらね	《空猫の君主》	名詞
＠そらねこ	《空猫の君主》	名詞
＠そらねこの	《空猫の君主》	名詞
＠そらねこのく	《空猫の君主》	名詞
＠そらねこのくん	《空猫の君主》	名詞
＠そらねこのくんし	《空猫の君主》	名詞
＠そらねこのくんしゅ	《空猫の君主》	名詞
＠か	《屍豹》	名詞
＠かば	《屍豹》	名詞
＠かばね	《屍豹》	名詞
＠かばねひ	《屍豹》	名詞
＠かばねひょ	《屍豹》	名詞
＠かばねひょう	《屍豹》	名詞
＠し	《将軍の執行官》	名詞
＠しょ	《将軍の執行官》	名詞
＠しょう	《将軍の執行官》	名詞
＠しょうぐ	《将軍の執行官》	名詞
＠しょうぐん	《将軍の執行官》	名詞
＠しょうぐんの	《将軍の執行官》	名詞
＠しょうぐんのし	《将軍の執行官》	名詞
＠しょうぐんのしっ	《将軍の執行官》	名詞
＠しょうぐんのしっこ	《将軍の執行官》	名詞
＠しょうぐんのしっこう	《将軍の執行官》	名詞
＠しょうぐんのしっこうか	《将軍の執行官》	名詞
＠しょうぐんのしっこうかん	《将軍の執行官》	名詞
＠ふ	《不吉な戦術》	名詞
＠ふき	《不吉な戦術》	名詞
＠ふきつ	《不吉な戦術》	名詞
＠ふきつな	《不吉な戦術》	名詞
＠ふきつなせ	《不吉な戦術》	名詞
＠ふきつなせん	《不吉な戦術》	名詞
＠ふきつなせんじ	《不吉な戦術》	名詞
＠ふきつなせんじゅ	《不吉な戦術》	名詞
＠ふきつなせんじゅつ	《不吉な戦術》	名詞
＠ど	《ドラニスのクードロ将軍》	名詞
＠どら	《ドラニスのクードロ将軍》	名詞
＠どらに	《ドラニスのクードロ将軍》	名詞
＠どらにす	《ドラニスのクードロ将軍》	名詞
＠どらにすの	《ドラニスのクードロ将軍》	名詞
＠どらにすのく	《ドラニスのクードロ将軍》	名詞
＠どらにすのくー	《ドラニスのクードロ将軍》	名詞
＠どらにすのくーど	《ドラニスのクードロ将軍》	名詞
＠どらにすのくーどろ	《ドラニスのクードロ将軍》	名詞
＠どらにすのくーどろし	《ドラニスのクードロ将軍》	名詞
＠どらにすのくーどろしょ	《ドラニスのクードロ将軍》	名詞
＠どらにすのくーどろしょう	《ドラニスのクードロ将軍》	名詞
＠どらにすのくーどろしょうぐ	《ドラニスのクードロ将軍》	名詞
＠どらにすのくーどろしょうぐん	《ドラニスのクードロ将軍》	名詞
＠す	《滑りかすれ》	名詞
＠すべ	《滑りかすれ》	名詞
＠すべり	《滑りかすれ》	名詞
＠すべりか	《滑りかすれ》	名詞
＠すべりかす	《滑りかすれ》	名詞
＠すべりかすれ	《滑りかすれ》	名詞
＠こ	《交感の力》	名詞
＠こう	《交感の力》	名詞
＠こうか	《交感の力》	名詞
＠こうかん	《交感の力》	名詞
＠こうかんの	《交感の力》	名詞
＠こうかんのち	《交感の力》	名詞
＠こうかんのちか	《交感の力》	名詞
＠こうかんのちから	《交感の力》	名詞
＠す	《スプライトのドラゴン》	名詞
＠すぷ	《スプライトのドラゴン》	名詞
＠すぷら	《スプライトのドラゴン》	名詞
＠すぷらい	《スプライトのドラゴン》	名詞
＠すぷらいと	《スプライトのドラゴン》	名詞
＠すぷらいとの	《スプライトのドラゴン》	名詞
＠すぷらいとのど	《スプライトのドラゴン》	名詞
＠すぷらいとのどら	《スプライトのドラゴン》	名詞
＠すぷらいとのどらご	《スプライトのドラゴン》	名詞
＠すぷらいとのどらごん	《スプライトのドラゴン》	名詞
＠で	《伝承のドラッキス》	名詞
＠でん	《伝承のドラッキス》	名詞
＠でんし	《伝承のドラッキス》	名詞
＠でんしょ	《伝承のドラッキス》	名詞
＠でんしょう	《伝承のドラッキス》	名詞
＠でんしょうの	《伝承のドラッキス》	名詞
＠でんしょうのど	《伝承のドラッキス》	名詞
＠でんしょうのどら	《伝承のドラッキス》	名詞
＠でんしょうのどらっ	《伝承のドラッキス》	名詞
＠でんしょうのどらっき	《伝承のドラッキス》	名詞
＠でんしょうのどらっきす	《伝承のドラッキス》	名詞
＠つ	《常智のリエール》	名詞
＠つね	《常智のリエール》	名詞
＠つねさ	《常智のリエール》	名詞
＠つねさと	《常智のリエール》	名詞
＠つねさとし	《常智のリエール》	名詞
＠つねさとしの	《常智のリエール》	名詞
＠つねさとしのり	《常智のリエール》	名詞
＠つねさとしのりえ	《常智のリエール》	名詞
＠つねさとしのりえー	《常智のリエール》	名詞
＠つねさとしのりえーる	《常智のリエール》	名詞
＠め	《迷宮の猛竜》	名詞
＠めい	《迷宮の猛竜》	名詞
＠めいき	《迷宮の猛竜》	名詞
＠めいきゅ	《迷宮の猛竜》	名詞
＠めいきゅう	《迷宮の猛竜》	名詞
＠めいきゅうの	《迷宮の猛竜》	名詞
＠めいきゅうのも	《迷宮の猛竜》	名詞
＠めいきゅうのもう	《迷宮の猛竜》	名詞
＠めいきゅうのもうり	《迷宮の猛竜》	名詞
＠めいきゅうのもうりゅ	《迷宮の猛竜》	名詞
＠めいきゅうのもうりゅう	《迷宮の猛竜》	名詞
＠さ	《再来》	名詞
＠さい	《再来》	名詞
＠さいら	《再来》	名詞
＠さいらい	《再来》	名詞
＠し	《髑髏の予言者》	名詞
＠しゃ	《髑髏の予言者》	名詞
＠しゃれ	《髑髏の予言者》	名詞
＠しゃれこ	《髑髏の予言者》	名詞
＠しゃれこう	《髑髏の予言者》	名詞
＠しゃれこうべ	《髑髏の予言者》	名詞
＠しゃれこうべの	《髑髏の予言者》	名詞
＠しゃれこうべのよ	《髑髏の予言者》	名詞
＠しゃれこうべのよげ	《髑髏の予言者》	名詞
＠しゃれこうべのよげん	《髑髏の予言者》	名詞
＠しゃれこうべのよげんし	《髑髏の予言者》	名詞
＠しゃれこうべのよげんしゃ	《髑髏の予言者》	名詞
＠ほ	《骨塚潜み》	名詞
＠ほね	《骨塚潜み》	名詞
＠ほねづ	《骨塚潜み》	名詞
＠ほねづか	《骨塚潜み》	名詞
＠ほねづかひ	《骨塚潜み》	名詞
＠ほねづかひそ	《骨塚潜み》	名詞
＠ほねづかひそみ	《骨塚潜み》	名詞
＠か	《怪物の災厄、チェビル》	名詞
＠かい	《怪物の災厄、チェビル》	名詞
＠かいぶ	《怪物の災厄、チェビル》	名詞
＠かいぶつ	《怪物の災厄、チェビル》	名詞
＠かいぶつの	《怪物の災厄、チェビル》	名詞
＠かいぶつのさ	《怪物の災厄、チェビル》	名詞
＠かいぶつのさい	《怪物の災厄、チェビル》	名詞
＠かいぶつのさいや	《怪物の災厄、チェビル》	名詞
＠かいぶつのさいやく	《怪物の災厄、チェビル》	名詞
＠かいぶつのさいやく、	《怪物の災厄、チェビル》	名詞
＠かいぶつのさいやく、ち	《怪物の災厄、チェビル》	名詞
＠かいぶつのさいやく、ちぇ	《怪物の災厄、チェビル》	名詞
＠かいぶつのさいやく、ちぇび	《怪物の災厄、チェビル》	名詞
＠かいぶつのさいやく、ちぇびる	《怪物の災厄、チェビル》	名詞
＠ち	《怪物の災厄、チェビル》	名詞
＠ちぇ	《怪物の災厄、チェビル》	名詞
＠ちぇび	《怪物の災厄、チェビル》	名詞
＠ちぇびる	《怪物の災厄、チェビル》	名詞
＠く	《クオーツウッドの壊し屋》	名詞
＠くお	《クオーツウッドの壊し屋》	名詞
＠くおー	《クオーツウッドの壊し屋》	名詞
＠くおーつ	《クオーツウッドの壊し屋》	名詞
＠くおーつう	《クオーツウッドの壊し屋》	名詞
＠くおーつうっ	《クオーツウッドの壊し屋》	名詞
＠くおーつうっど	《クオーツウッドの壊し屋》	名詞
＠くおーつうっどの	《クオーツウッドの壊し屋》	名詞
＠くおーつうっどのこ	《クオーツウッドの壊し屋》	名詞
＠くおーつうっどのこわ	《クオーツウッドの壊し屋》	名詞
＠くおーつうっどのこわし	《クオーツウッドの壊し屋》	名詞
＠くおーつうっどのこわしや	《クオーツウッドの壊し屋》	名詞
＠い	《威厳あるレオサウルス》	名詞
＠いげ	《威厳あるレオサウルス》	名詞
＠いげん	《威厳あるレオサウルス》	名詞
＠いげんあ	《威厳あるレオサウルス》	名詞
＠いげんある	《威厳あるレオサウルス》	名詞
＠いげんあるれ	《威厳あるレオサウルス》	名詞
＠いげんあるれお	《威厳あるレオサウルス》	名詞
＠いげんあるれおさ	《威厳あるレオサウルス》	名詞
＠いげんあるれおさう	《威厳あるレオサウルス》	名詞
＠いげんあるれおさうる	《威厳あるレオサウルス》	名詞
＠いげんあるれおさうるす	《威厳あるレオサウルス》	名詞
＠さ	《サヴァイの雷たてがみ》	名詞
＠さヴ	《サヴァイの雷たてがみ》	名詞
＠さヴぁ	《サヴァイの雷たてがみ》	名詞
＠さヴぁい	《サヴァイの雷たてがみ》	名詞
＠さヴぁいの	《サヴァイの雷たてがみ》	名詞
＠さヴぁいのか	《サヴァイの雷たてがみ》	名詞
＠さヴぁいのかみ	《サヴァイの雷たてがみ》	名詞
＠さヴぁいのかみな	《サヴァイの雷たてがみ》	名詞
＠さヴぁいのかみなり	《サヴァイの雷たてがみ》	名詞
＠さヴぁいのかみなりた	《サヴァイの雷たてがみ》	名詞
＠さヴぁいのかみなりたて	《サヴァイの雷たてがみ》	名詞
＠さヴぁいのかみなりたてが	《サヴァイの雷たてがみ》	名詞
＠さヴぁいのかみなりたてがみ	《サヴァイの雷たてがみ》	名詞
＠て	《天頂の閃光》	名詞
＠てん	《天頂の閃光》	名詞
＠てんち	《天頂の閃光》	名詞
＠てんちょ	《天頂の閃光》	名詞
＠てんちょう	《天頂の閃光》	名詞
＠てんちょうの	《天頂の閃光》	名詞
＠てんちょうのせ	《天頂の閃光》	名詞
＠てんちょうのせん	《天頂の閃光》	名詞
＠てんちょうのせんこ	《天頂の閃光》	名詞
＠てんちょうのせんこう	《天頂の閃光》	名詞
＠ぐ	《軍団のまとめ役、ウィノータ》	名詞
＠ぐん	《軍団のまとめ役、ウィノータ》	名詞
＠ぐんだ	《軍団のまとめ役、ウィノータ》	名詞
＠ぐんだん	《軍団のまとめ役、ウィノータ》	名詞
＠ぐんだんの	《軍団のまとめ役、ウィノータ》	名詞
＠ぐんだんのま	《軍団のまとめ役、ウィノータ》	名詞
＠ぐんだんのまと	《軍団のまとめ役、ウィノータ》	名詞
＠ぐんだんのまとめ	《軍団のまとめ役、ウィノータ》	名詞
＠ぐんだんのまとめや	《軍団のまとめ役、ウィノータ》	名詞
＠ぐんだんのまとめやく	《軍団のまとめ役、ウィノータ》	名詞
＠ぐんだんのまとめやく、	《軍団のまとめ役、ウィノータ》	名詞
＠ぐんだんのまとめやく、う	《軍団のまとめ役、ウィノータ》	名詞
＠ぐんだんのまとめやく、うぃ	《軍団のまとめ役、ウィノータ》	名詞
＠ぐんだんのまとめやく、うぃの	《軍団のまとめ役、ウィノータ》	名詞
＠ぐんだんのまとめやく、うぃのー	《軍団のまとめ役、ウィノータ》	名詞
＠ぐんだんのまとめやく、うぃのーた	《軍団のまとめ役、ウィノータ》	名詞
＠う	《軍団のまとめ役、ウィノータ》	名詞
＠うぃ	《軍団のまとめ役、ウィノータ》	名詞
＠うぃの	《軍団のまとめ役、ウィノータ》	名詞
＠うぃのー	《軍団のまとめ役、ウィノータ》	名詞
＠うぃのーた	《軍団のまとめ役、ウィノータ》	名詞
＠よ	《葉状地のフェリダー》	名詞
＠よう	《葉状地のフェリダー》	名詞
＠ようじ	《葉状地のフェリダー》	名詞
＠ようじょ	《葉状地のフェリダー》	名詞
＠ようじょう	《葉状地のフェリダー》	名詞
＠ようじょうち	《葉状地のフェリダー》	名詞
＠ようじょうちの	《葉状地のフェリダー》	名詞
＠ようじょうちのふ	《葉状地のフェリダー》	名詞
＠ようじょうちのふぇ	《葉状地のフェリダー》	名詞
＠ようじょうちのふぇり	《葉状地のフェリダー》	名詞
＠ようじょうちのふぇりだ	《葉状地のフェリダー》	名詞
＠ようじょうちのふぇりだー	《葉状地のフェリダー》	名詞
＠い	《嘶くナール》	名詞
＠いな	《嘶くナール》	名詞
＠いなな	《嘶くナール》	名詞
＠いななく	《嘶くナール》	名詞
＠いななくな	《嘶くナール》	名詞
＠いななくなー	《嘶くナール》	名詞
＠いななくなーる	《嘶くナール》	名詞
＠げ	《原初の共感》	名詞
＠げん	《原初の共感》	名詞
＠げんし	《原初の共感》	名詞
＠げんしょ	《原初の共感》	名詞
＠げんしょの	《原初の共感》	名詞
＠げんしょのき	《原初の共感》	名詞
＠げんしょのきょ	《原初の共感》	名詞
＠げんしょのきょう	《原初の共感》	名詞
＠げんしょのきょうか	《原初の共感》	名詞
＠げんしょのきょうかん	《原初の共感》	名詞
＠り	《領獣》	名詞
＠りょ	《領獣》	名詞
＠りょう	《領獣》	名詞
＠りょうじ	《領獣》	名詞
＠りょうじゅ	《領獣》	名詞
＠りょうじゅう	《領獣》	名詞
＠け	《眷者の神童、キナン》	名詞
＠けん	《眷者の神童、キナン》	名詞
＠けんじ	《眷者の神童、キナン》	名詞
＠けんじゃ	《眷者の神童、キナン》	名詞
＠けんじゃの	《眷者の神童、キナン》	名詞
＠けんじゃのし	《眷者の神童、キナン》	名詞
＠けんじゃのしん	《眷者の神童、キナン》	名詞
＠けんじゃのしんど	《眷者の神童、キナン》	名詞
＠けんじゃのしんどう	《眷者の神童、キナン》	名詞
＠けんじゃのしんどう、	《眷者の神童、キナン》	名詞
＠けんじゃのしんどう、き	《眷者の神童、キナン》	名詞
＠けんじゃのしんどう、きな	《眷者の神童、キナン》	名詞
＠けんじゃのしんどう、きなん	《眷者の神童、キナン》	名詞
＠き	《眷者の神童、キナン》	名詞
＠きな	《眷者の神童、キナン》	名詞
＠きなん	《眷者の神童、キナン》	名詞
＠き	《奇妙な根本原理》	名詞
＠きみ	《奇妙な根本原理》	名詞
＠きみょ	《奇妙な根本原理》	名詞
＠きみょう	《奇妙な根本原理》	名詞
＠きみょうな	《奇妙な根本原理》	名詞
＠きみょうなこ	《奇妙な根本原理》	名詞
＠きみょうなこん	《奇妙な根本原理》	名詞
＠きみょうなこんぽ	《奇妙な根本原理》	名詞
＠きみょうなこんぽん	《奇妙な根本原理》	名詞
＠きみょうなこんぽんげ	《奇妙な根本原理》	名詞
＠きみょうなこんぽんげん	《奇妙な根本原理》	名詞
＠きみょうなこんぽんげんり	《奇妙な根本原理》	名詞
＠し	《死のオアシス》	名詞
＠しの	《死のオアシス》	名詞
＠しのお	《死のオアシス》	名詞
＠しのおあ	《死のオアシス》	名詞
＠しのおあし	《死のオアシス》	名詞
＠しのおあしす	《死のオアシス》	名詞
＠し	《死の頂点、ネスロイ》	名詞
＠しの	《死の頂点、ネスロイ》	名詞
＠しのち	《死の頂点、ネスロイ》	名詞
＠しのちょ	《死の頂点、ネスロイ》	名詞
＠しのちょう	《死の頂点、ネスロイ》	名詞
＠しのちょうて	《死の頂点、ネスロイ》	名詞
＠しのちょうてん	《死の頂点、ネスロイ》	名詞
＠しのちょうてん、	《死の頂点、ネスロイ》	名詞
＠しのちょうてん、ね	《死の頂点、ネスロイ》	名詞
＠しのちょうてん、ねす	《死の頂点、ネスロイ》	名詞
＠しのちょうてん、ねすろ	《死の頂点、ネスロイ》	名詞
＠しのちょうてん、ねすろい	《死の頂点、ネスロイ》	名詞
＠ね	《死の頂点、ネスロイ》	名詞
＠ねす	《死の頂点、ネスロイ》	名詞
＠ねすろ	《死の頂点、ネスロイ》	名詞
＠ねすろい	《死の頂点、ネスロイ》	名詞
＠し	《思考の旋風》	名詞
＠しこ	《思考の旋風》	名詞
＠しこう	《思考の旋風》	名詞
＠しこうの	《思考の旋風》	名詞
＠しこうのせ	《思考の旋風》	名詞
＠しこうのせん	《思考の旋風》	名詞
＠しこうのせんぷ	《思考の旋風》	名詞
＠しこうのせんぷう	《思考の旋風》	名詞
＠み	《見事な根本原理》	名詞
＠みご	《見事な根本原理》	名詞
＠みごと	《見事な根本原理》	名詞
＠みごとな	《見事な根本原理》	名詞
＠みごとなこ	《見事な根本原理》	名詞
＠みごとなこん	《見事な根本原理》	名詞
＠みごとなこんぽ	《見事な根本原理》	名詞
＠みごとなこんぽん	《見事な根本原理》	名詞
＠みごとなこんぽんげ	《見事な根本原理》	名詞
＠みごとなこんぽんげん	《見事な根本原理》	名詞
＠みごとなこんぽんげんり	《見事な根本原理》	名詞
＠か	《雷の頂点、ヴァドロック》	名詞
＠かみ	《雷の頂点、ヴァドロック》	名詞
＠かみな	《雷の頂点、ヴァドロック》	名詞
＠かみなり	《雷の頂点、ヴァドロック》	名詞
＠かみなりの	《雷の頂点、ヴァドロック》	名詞
＠かみなりのち	《雷の頂点、ヴァドロック》	名詞
＠かみなりのちょ	《雷の頂点、ヴァドロック》	名詞
＠かみなりのちょう	《雷の頂点、ヴァドロック》	名詞
＠かみなりのちょうて	《雷の頂点、ヴァドロック》	名詞
＠かみなりのちょうてん	《雷の頂点、ヴァドロック》	名詞
＠かみなりのちょうてん、	《雷の頂点、ヴァドロック》	名詞
＠かみなりのちょうてん、ヴ	《雷の頂点、ヴァドロック》	名詞
＠かみなりのちょうてん、ヴぁ	《雷の頂点、ヴァドロック》	名詞
＠かみなりのちょうてん、ヴぁど	《雷の頂点、ヴァドロック》	名詞
＠かみなりのちょうてん、ヴぁどろ	《雷の頂点、ヴァドロック》	名詞
＠かみなりのちょうてん、ヴぁどろっ	《雷の頂点、ヴァドロック》	名詞
＠かみなりのちょうてん、ヴぁどろっく	《雷の頂点、ヴァドロック》	名詞
＠ヴ	《雷の頂点、ヴァドロック》	名詞
＠ヴぁ	《雷の頂点、ヴァドロック》	名詞
＠ヴぁど	《雷の頂点、ヴァドロック》	名詞
＠ヴぁどろ	《雷の頂点、ヴァドロック》	名詞
＠ヴぁどろっ	《雷の頂点、ヴァドロック》	名詞
＠ヴぁどろっく	《雷の頂点、ヴァドロック》	名詞
＠ふ	《古き道のナーセット》	名詞
＠ふる	《古き道のナーセット》	名詞
＠ふるき	《古き道のナーセット》	名詞
＠ふるきみ	《古き道のナーセット》	名詞
＠ふるきみち	《古き道のナーセット》	名詞
＠ふるきみちの	《古き道のナーセット》	名詞
＠ふるきみちのな	《古き道のナーセット》	名詞
＠ふるきみちのなー	《古き道のナーセット》	名詞
＠ふるきみちのなーせ	《古き道のナーセット》	名詞
＠ふるきみちのなーせっ	《古き道のナーセット》	名詞
＠ふるきみちのなーせっと	《古き道のナーセット》	名詞
＠き	《巨獣の巣》	名詞
＠きょ	《巨獣の巣》	名詞
＠きょじ	《巨獣の巣》	名詞
＠きょじゅ	《巨獣の巣》	名詞
＠きょじゅう	《巨獣の巣》	名詞
＠きょじゅうの	《巨獣の巣》	名詞
＠きょじゅうのす	《巨獣の巣》	名詞
＠し	《出現の根本原理》	名詞
＠しゅ	《出現の根本原理》	名詞
＠しゅつ	《出現の根本原理》	名詞
＠しゅつげ	《出現の根本原理》	名詞
＠しゅつげん	《出現の根本原理》	名詞
＠しゅつげんの	《出現の根本原理》	名詞
＠しゅつげんのこ	《出現の根本原理》	名詞
＠しゅつげんのこん	《出現の根本原理》	名詞
＠しゅつげんのこんぽ	《出現の根本原理》	名詞
＠しゅつげんのこんぽん	《出現の根本原理》	名詞
＠しゅつげんのこんぽんげ	《出現の根本原理》	名詞
＠しゅつげんのこんぽんげん	《出現の根本原理》	名詞
＠しゅつげんのこんぽんげんり	《出現の根本原理》	名詞
＠え	《永遠の頂点、ブロコス》	名詞
＠えい	《永遠の頂点、ブロコス》	名詞
＠えいえ	《永遠の頂点、ブロコス》	名詞
＠えいえん	《永遠の頂点、ブロコス》	名詞
＠えいえんの	《永遠の頂点、ブロコス》	名詞
＠えいえんのち	《永遠の頂点、ブロコス》	名詞
＠えいえんのちょ	《永遠の頂点、ブロコス》	名詞
＠えいえんのちょう	《永遠の頂点、ブロコス》	名詞
＠えいえんのちょうて	《永遠の頂点、ブロコス》	名詞
＠えいえんのちょうてん	《永遠の頂点、ブロコス》	名詞
＠えいえんのちょうてん、	《永遠の頂点、ブロコス》	名詞
＠えいえんのちょうてん、ぶ	《永遠の頂点、ブロコス》	名詞
＠えいえんのちょうてん、ぶろ	《永遠の頂点、ブロコス》	名詞
＠えいえんのちょうてん、ぶろこ	《永遠の頂点、ブロコス》	名詞
＠えいえんのちょうてん、ぶろこす	《永遠の頂点、ブロコス》	名詞
＠ぶ	《永遠の頂点、ブロコス》	名詞
＠ぶろ	《永遠の頂点、ブロコス》	名詞
＠ぶろこ	《永遠の頂点、ブロコス》	名詞
＠ぶろこす	《永遠の頂点、ブロコス》	名詞
＠は	《破滅の根本原理》	名詞
＠はめ	《破滅の根本原理》	名詞
＠はめつ	《破滅の根本原理》	名詞
＠はめつの	《破滅の根本原理》	名詞
＠はめつのこ	《破滅の根本原理》	名詞
＠はめつのこん	《破滅の根本原理》	名詞
＠はめつのこんぽ	《破滅の根本原理》	名詞
＠はめつのこんぽん	《破滅の根本原理》	名詞
＠はめつのこんぽんげ	《破滅の根本原理》	名詞
＠はめつのこんぽんげん	《破滅の根本原理》	名詞
＠はめつのこんぽんげんり	《破滅の根本原理》	名詞
＠よ	《幼獣の復讐》	名詞
＠よう	《幼獣の復讐》	名詞
＠ようじ	《幼獣の復讐》	名詞
＠ようじゅ	《幼獣の復讐》	名詞
＠ようじゅう	《幼獣の復讐》	名詞
＠ようじゅうの	《幼獣の復讐》	名詞
＠ようじゅうのふ	《幼獣の復讐》	名詞
＠ようじゅうのふく	《幼獣の復讐》	名詞
＠ようじゅうのふくし	《幼獣の復讐》	名詞
＠ようじゅうのふくしゅ	《幼獣の復讐》	名詞
＠ようじゅうのふくしゅう	《幼獣の復讐》	名詞
＠か	《猟の頂点、スナップダックス》	名詞
＠かり	《猟の頂点、スナップダックス》	名詞
＠かりの	《猟の頂点、スナップダックス》	名詞
＠かりのち	《猟の頂点、スナップダックス》	名詞
＠かりのちょ	《猟の頂点、スナップダックス》	名詞
＠かりのちょう	《猟の頂点、スナップダックス》	名詞
＠かりのちょうて	《猟の頂点、スナップダックス》	名詞
＠かりのちょうてん	《猟の頂点、スナップダックス》	名詞
＠かりのちょうてん、	《猟の頂点、スナップダックス》	名詞
＠かりのちょうてん、す	《猟の頂点、スナップダックス》	名詞
＠かりのちょうてん、すな	《猟の頂点、スナップダックス》	名詞
＠かりのちょうてん、すなっ	《猟の頂点、スナップダックス》	名詞
＠かりのちょうてん、すなっぷ	《猟の頂点、スナップダックス》	名詞
＠かりのちょうてん、すなっぷだ	《猟の頂点、スナップダックス》	名詞
＠かりのちょうてん、すなっぷだっ	《猟の頂点、スナップダックス》	名詞
＠かりのちょうてん、すなっぷだっく	《猟の頂点、スナップダックス》	名詞
＠かりのちょうてん、すなっぷだっくす	《猟の頂点、スナップダックス》	名詞
＠す	《猟の頂点、スナップダックス》	名詞
＠すな	《猟の頂点、スナップダックス》	名詞
＠すなっ	《猟の頂点、スナップダックス》	名詞
＠すなっぷ	《猟の頂点、スナップダックス》	名詞
＠すなっぷだ	《猟の頂点、スナップダックス》	名詞
＠すなっぷだっ	《猟の頂点、スナップダックス》	名詞
＠すなっぷだっく	《猟の頂点、スナップダックス》	名詞
＠すなっぷだっくす	《猟の頂点、スナップダックス》	名詞
＠そ	《創造の歌》	名詞
＠そう	《創造の歌》	名詞
＠そうぞ	《創造の歌》	名詞
＠そうぞう	《創造の歌》	名詞
＠そうぞうの	《創造の歌》	名詞
＠そうぞうのう	《創造の歌》	名詞
＠そうぞうのうた	《創造の歌》	名詞
＠は	《発生の根本原理》	名詞
＠はっ	《発生の根本原理》	名詞
＠はっせ	《発生の根本原理》	名詞
＠はっせい	《発生の根本原理》	名詞
＠はっせいの	《発生の根本原理》	名詞
＠はっせいのこ	《発生の根本原理》	名詞
＠はっせいのこん	《発生の根本原理》	名詞
＠はっせいのこんぽ	《発生の根本原理》	名詞
＠はっせいのこんぽん	《発生の根本原理》	名詞
＠はっせいのこんぽんげ	《発生の根本原理》	名詞
＠はっせいのこんぽんげん	《発生の根本原理》	名詞
＠はっせいのこんぽんげんり	《発生の根本原理》	名詞
＠ね	《願いの頂点、イルーナ》	名詞
＠ねが	《願いの頂点、イルーナ》	名詞
＠ねがい	《願いの頂点、イルーナ》	名詞
＠ねがいの	《願いの頂点、イルーナ》	名詞
＠ねがいのち	《願いの頂点、イルーナ》	名詞
＠ねがいのちょ	《願いの頂点、イルーナ》	名詞
＠ねがいのちょう	《願いの頂点、イルーナ》	名詞
＠ねがいのちょうて	《願いの頂点、イルーナ》	名詞
＠ねがいのちょうてん	《願いの頂点、イルーナ》	名詞
＠ねがいのちょうてん、	《願いの頂点、イルーナ》	名詞
＠ねがいのちょうてん、い	《願いの頂点、イルーナ》	名詞
＠ねがいのちょうてん、いる	《願いの頂点、イルーナ》	名詞
＠ねがいのちょうてん、いるー	《願いの頂点、イルーナ》	名詞
＠ねがいのちょうてん、いるーな	《願いの頂点、イルーナ》	名詞
＠い	《願いの頂点、イルーナ》	名詞
＠いる	《願いの頂点、イルーナ》	名詞
＠いるー	《願いの頂点、イルーナ》	名詞
＠いるーな	《願いの頂点、イルーナ》	名詞
＠か	《歓喜する空眷者》	名詞
＠かん	《歓喜する空眷者》	名詞
＠かんき	《歓喜する空眷者》	名詞
＠かんきす	《歓喜する空眷者》	名詞
＠かんきする	《歓喜する空眷者》	名詞
＠かんきするそ	《歓喜する空眷者》	名詞
＠かんきするそら	《歓喜する空眷者》	名詞
＠かんきするそらけ	《歓喜する空眷者》	名詞
＠かんきするそらけん	《歓喜する空眷者》	名詞
＠かんきするそらけんじ	《歓喜する空眷者》	名詞
＠かんきするそらけんじゃ	《歓喜する空眷者》	名詞
＠ず	《狡賢い夜眷者》	名詞
＠ずる	《狡賢い夜眷者》	名詞
＠ずるか	《狡賢い夜眷者》	名詞
＠ずるかし	《狡賢い夜眷者》	名詞
＠ずるかしこ	《狡賢い夜眷者》	名詞
＠ずるかしこい	《狡賢い夜眷者》	名詞
＠ずるかしこいよ	《狡賢い夜眷者》	名詞
＠ずるかしこいよる	《狡賢い夜眷者》	名詞
＠ずるかしこいよるけ	《狡賢い夜眷者》	名詞
＠ずるかしこいよるけん	《狡賢い夜眷者》	名詞
＠ずるかしこいよるけんじ	《狡賢い夜眷者》	名詞
＠ずるかしこいよるけんじゃ	《狡賢い夜眷者》	名詞
＠ど	《堂々たる咆哮眷者》	名詞
＠どう	《堂々たる咆哮眷者》	名詞
＠どうど	《堂々たる咆哮眷者》	名詞
＠どうどう	《堂々たる咆哮眷者》	名詞
＠どうどうた	《堂々たる咆哮眷者》	名詞
＠どうどうたる	《堂々たる咆哮眷者》	名詞
＠どうどうたるほ	《堂々たる咆哮眷者》	名詞
＠どうどうたるほう	《堂々たる咆哮眷者》	名詞
＠どうどうたるほうこ	《堂々たる咆哮眷者》	名詞
＠どうどうたるほうこう	《堂々たる咆哮眷者》	名詞
＠どうどうたるほうこうけ	《堂々たる咆哮眷者》	名詞
＠どうどうたるほうこうけん	《堂々たる咆哮眷者》	名詞
＠どうどうたるほうこうけんじ	《堂々たる咆哮眷者》	名詞
＠どうどうたるほうこうけんじゃ	《堂々たる咆哮眷者》	名詞
＠か	《貫禄ある野生眷者》	名詞
＠かん	《貫禄ある野生眷者》	名詞
＠かんろ	《貫禄ある野生眷者》	名詞
＠かんろく	《貫禄ある野生眷者》	名詞
＠かんろくあ	《貫禄ある野生眷者》	名詞
＠かんろくある	《貫禄ある野生眷者》	名詞
＠かんろくあるや	《貫禄ある野生眷者》	名詞
＠かんろくあるやせ	《貫禄ある野生眷者》	名詞
＠かんろくあるやせい	《貫禄ある野生眷者》	名詞
＠かんろくあるやせいけ	《貫禄ある野生眷者》	名詞
＠かんろくあるやせいけん	《貫禄ある野生眷者》	名詞
＠かんろくあるやせいけんじ	《貫禄ある野生眷者》	名詞
＠かんろくあるやせいけんじゃ	《貫禄ある野生眷者》	名詞
＠し	《慎重な認知眷者》	名詞
＠しん	《慎重な認知眷者》	名詞
＠しんち	《慎重な認知眷者》	名詞
＠しんちょ	《慎重な認知眷者》	名詞
＠しんちょう	《慎重な認知眷者》	名詞
＠しんちょうな	《慎重な認知眷者》	名詞
＠しんちょうなに	《慎重な認知眷者》	名詞
＠しんちょうなにん	《慎重な認知眷者》	名詞
＠しんちょうなにんち	《慎重な認知眷者》	名詞
＠しんちょうなにんちけ	《慎重な認知眷者》	名詞
＠しんちょうなにんちけん	《慎重な認知眷者》	名詞
＠しんちょうなにんちけんじ	《慎重な認知眷者》	名詞
＠しんちょうなにんちけんじゃ	《慎重な認知眷者》	名詞
＠そ	《空を放浪するもの、ヨーリオン》	名詞
＠そら	《空を放浪するもの、ヨーリオン》	名詞
＠そらを	《空を放浪するもの、ヨーリオン》	名詞
＠そらをほ	《空を放浪するもの、ヨーリオン》	名詞
＠そらをほう	《空を放浪するもの、ヨーリオン》	名詞
＠そらをほうろ	《空を放浪するもの、ヨーリオン》	名詞
＠そらをほうろう	《空を放浪するもの、ヨーリオン》	名詞
＠そらをほうろうす	《空を放浪するもの、ヨーリオン》	名詞
＠そらをほうろうする	《空を放浪するもの、ヨーリオン》	名詞
＠そらをほうろうするも	《空を放浪するもの、ヨーリオン》	名詞
＠そらをほうろうするもの	《空を放浪するもの、ヨーリオン》	名詞
＠そらをほうろうするもの、	《空を放浪するもの、ヨーリオン》	名詞
＠そらをほうろうするもの、よ	《空を放浪するもの、ヨーリオン》	名詞
＠そらをほうろうするもの、よー	《空を放浪するもの、ヨーリオン》	名詞
＠そらをほうろうするもの、よーり	《空を放浪するもの、ヨーリオン》	名詞
＠そらをほうろうするもの、よーりお	《空を放浪するもの、ヨーリオン》	名詞
＠そらをほうろうするもの、よーりおん	《空を放浪するもの、ヨーリオン》	名詞
＠よ	《空を放浪するもの、ヨーリオン》	名詞
＠よー	《空を放浪するもの、ヨーリオン》	名詞
＠よーり	《空を放浪するもの、ヨーリオン》	名詞
＠よーりお	《空を放浪するもの、ヨーリオン》	名詞
＠よーりおん	《空を放浪するもの、ヨーリオン》	名詞
＠ゆ	《夢の巣のルールス》	名詞
＠ゆめ	《夢の巣のルールス》	名詞
＠ゆめの	《夢の巣のルールス》	名詞
＠ゆめのす	《夢の巣のルールス》	名詞
＠ゆめのすの	《夢の巣のルールス》	名詞
＠ゆめのすのる	《夢の巣のルールス》	名詞
＠ゆめのすのるー	《夢の巣のルールス》	名詞
＠ゆめのすのるーる	《夢の巣のルールス》	名詞
＠ゆめのすのるーるす	《夢の巣のルールス》	名詞
＠し	《深海の破滅、ジャイルーダ》	名詞
＠しん	《深海の破滅、ジャイルーダ》	名詞
＠しんか	《深海の破滅、ジャイルーダ》	名詞
＠しんかい	《深海の破滅、ジャイルーダ》	名詞
＠しんかいの	《深海の破滅、ジャイルーダ》	名詞
＠しんかいのは	《深海の破滅、ジャイルーダ》	名詞
＠しんかいのはめ	《深海の破滅、ジャイルーダ》	名詞
＠しんかいのはめつ	《深海の破滅、ジャイルーダ》	名詞
＠しんかいのはめつ、	《深海の破滅、ジャイルーダ》	名詞
＠しんかいのはめつ、じ	《深海の破滅、ジャイルーダ》	名詞
＠しんかいのはめつ、じゃ	《深海の破滅、ジャイルーダ》	名詞
＠しんかいのはめつ、じゃい	《深海の破滅、ジャイルーダ》	名詞
＠しんかいのはめつ、じゃいる	《深海の破滅、ジャイルーダ》	名詞
＠しんかいのはめつ、じゃいるー	《深海の破滅、ジャイルーダ》	名詞
＠しんかいのはめつ、じゃいるーだ	《深海の破滅、ジャイルーダ》	名詞
＠じ	《深海の破滅、ジャイルーダ》	名詞
＠じゃ	《深海の破滅、ジャイルーダ》	名詞
＠じゃい	《深海の破滅、ジャイルーダ》	名詞
＠じゃいる	《深海の破滅、ジャイルーダ》	名詞
＠じゃいるー	《深海の破滅、ジャイルーダ》	名詞
＠じゃいるーだ	《深海の破滅、ジャイルーダ》	名詞
＠じ	《呪文追い、ルーツリー》	名詞
＠じゅ	《呪文追い、ルーツリー》	名詞
＠じゅも	《呪文追い、ルーツリー》	名詞
＠じゅもん	《呪文追い、ルーツリー》	名詞
＠じゅもんお	《呪文追い、ルーツリー》	名詞
＠じゅもんおい	《呪文追い、ルーツリー》	名詞
＠じゅもんおい、	《呪文追い、ルーツリー》	名詞
＠じゅもんおい、る	《呪文追い、ルーツリー》	名詞
＠じゅもんおい、るー	《呪文追い、ルーツリー》	名詞
＠じゅもんおい、るーつ	《呪文追い、ルーツリー》	名詞
＠じゅもんおい、るーつり	《呪文追い、ルーツリー》	名詞
＠じゅもんおい、るーつりー	《呪文追い、ルーツリー》	名詞
＠る	《呪文追い、ルーツリー》	名詞
＠るー	《呪文追い、ルーツリー》	名詞
＠るーつ	《呪文追い、ルーツリー》	名詞
＠るーつり	《呪文追い、ルーツリー》	名詞
＠るーつりー	《呪文追い、ルーツリー》	名詞
＠え	《獲物貫き、オボシュ》	名詞
＠えも	《獲物貫き、オボシュ》	名詞
＠えもの	《獲物貫き、オボシュ》	名詞
＠えものつ	《獲物貫き、オボシュ》	名詞
＠えものつら	《獲物貫き、オボシュ》	名詞
＠えものつらぬ	《獲物貫き、オボシュ》	名詞
＠えものつらぬき	《獲物貫き、オボシュ》	名詞
＠えものつらぬき、	《獲物貫き、オボシュ》	名詞
＠えものつらぬき、お	《獲物貫き、オボシュ》	名詞
＠えものつらぬき、おぼ	《獲物貫き、オボシュ》	名詞
＠えものつらぬき、おぼし	《獲物貫き、オボシュ》	名詞
＠えものつらぬき、おぼしゅ	《獲物貫き、オボシュ》	名詞
＠お	《獲物貫き、オボシュ》	名詞
＠おぼ	《獲物貫き、オボシュ》	名詞
＠おぼし	《獲物貫き、オボシュ》	名詞
＠おぼしゅ	《獲物貫き、オボシュ》	名詞
＠あ	《集めるもの、ウモーリ》	名詞
＠あつ	《集めるもの、ウモーリ》	名詞
＠あつめ	《集めるもの、ウモーリ》	名詞
＠あつめる	《集めるもの、ウモーリ》	名詞
＠あつめるも	《集めるもの、ウモーリ》	名詞
＠あつめるもの	《集めるもの、ウモーリ》	名詞
＠あつめるもの、	《集めるもの、ウモーリ》	名詞
＠あつめるもの、う	《集めるもの、ウモーリ》	名詞
＠あつめるもの、うも	《集めるもの、ウモーリ》	名詞
＠あつめるもの、うもー	《集めるもの、ウモーリ》	名詞
＠あつめるもの、うもーり	《集めるもの、ウモーリ》	名詞
＠う	《集めるもの、ウモーリ》	名詞
＠うも	《集めるもの、ウモーリ》	名詞
＠うもー	《集めるもの、ウモーリ》	名詞
＠うもーり	《集めるもの、ウモーリ》	名詞
＠わ	《湧き出る源、ジェガンサ》	名詞
＠わき	《湧き出る源、ジェガンサ》	名詞
＠わきで	《湧き出る源、ジェガンサ》	名詞
＠わきでる	《湧き出る源、ジェガンサ》	名詞
＠わきでるみ	《湧き出る源、ジェガンサ》	名詞
＠わきでるみな	《湧き出る源、ジェガンサ》	名詞
＠わきでるみなも	《湧き出る源、ジェガンサ》	名詞
＠わきでるみなもと	《湧き出る源、ジェガンサ》	名詞
＠わきでるみなもと、	《湧き出る源、ジェガンサ》	名詞
＠わきでるみなもと、じ	《湧き出る源、ジェガンサ》	名詞
＠わきでるみなもと、じぇ	《湧き出る源、ジェガンサ》	名詞
＠わきでるみなもと、じぇが	《湧き出る源、ジェガンサ》	名詞
＠わきでるみなもと、じぇがん	《湧き出る源、ジェガンサ》	名詞
＠わきでるみなもと、じぇがんさ	《湧き出る源、ジェガンサ》	名詞
＠じ	《湧き出る源、ジェガンサ》	名詞
＠じぇ	《湧き出る源、ジェガンサ》	名詞
＠じぇが	《湧き出る源、ジェガンサ》	名詞
＠じぇがん	《湧き出る源、ジェガンサ》	名詞
＠じぇがんさ	《湧き出る源、ジェガンサ》	名詞
＠れ	《黎明起こし、ザーダ》	名詞
＠れい	《黎明起こし、ザーダ》	名詞
＠れいめ	《黎明起こし、ザーダ》	名詞
＠れいめい	《黎明起こし、ザーダ》	名詞
＠れいめいお	《黎明起こし、ザーダ》	名詞
＠れいめいおこ	《黎明起こし、ザーダ》	名詞
＠れいめいおこし	《黎明起こし、ザーダ》	名詞
＠れいめいおこし、	《黎明起こし、ザーダ》	名詞
＠れいめいおこし、ざ	《黎明起こし、ザーダ》	名詞
＠れいめいおこし、ざー	《黎明起こし、ザーダ》	名詞
＠れいめいおこし、ざーだ	《黎明起こし、ザーダ》	名詞
＠ざ	《黎明起こし、ザーダ》	名詞
＠ざー	《黎明起こし、ザーダ》	名詞
＠ざーだ	《黎明起こし、ザーダ》	名詞
＠こ	《孤児護り、カヒーラ》	名詞
＠こじ	《孤児護り、カヒーラ》	名詞
＠こじま	《孤児護り、カヒーラ》	名詞
＠こじまも	《孤児護り、カヒーラ》	名詞
＠こじまもり	《孤児護り、カヒーラ》	名詞
＠こじまもり、	《孤児護り、カヒーラ》	名詞
＠こじまもり、か	《孤児護り、カヒーラ》	名詞
＠こじまもり、かひ	《孤児護り、カヒーラ》	名詞
＠こじまもり、かひー	《孤児護り、カヒーラ》	名詞
＠こじまもり、かひーら	《孤児護り、カヒーラ》	名詞
＠か	《孤児護り、カヒーラ》	名詞
＠かひ	《孤児護り、カヒーラ》	名詞
＠かひー	《孤児護り、カヒーラ》	名詞
＠かひーら	《孤児護り、カヒーラ》	名詞
＠き	《巨智、ケルーガ》	名詞
＠きょ	《巨智、ケルーガ》	名詞
＠きょち	《巨智、ケルーガ》	名詞
＠きょち、	《巨智、ケルーガ》	名詞
＠きょち、け	《巨智、ケルーガ》	名詞
＠きょち、ける	《巨智、ケルーガ》	名詞
＠きょち、けるー	《巨智、ケルーガ》	名詞
＠きょち、けるーが	《巨智、ケルーガ》	名詞
＠け	《巨智、ケルーガ》	名詞
＠ける	《巨智、ケルーガ》	名詞
＠けるー	《巨智、ケルーガ》	名詞
＠けるーが	《巨智、ケルーガ》	名詞
＠あ	《悪魔の職工》	名詞
＠あく	《悪魔の職工》	名詞
＠あくま	《悪魔の職工》	名詞
＠あくまの	《悪魔の職工》	名詞
＠あくまのし	《悪魔の職工》	名詞
＠あくまのしょ	《悪魔の職工》	名詞
＠あくまのしょっ	《悪魔の職工》	名詞
＠あくまのしょっこ	《悪魔の職工》	名詞
＠あくまのしょっこう	《悪魔の職工》	名詞
＠と	《トラバサミ》	名詞
＠とら	《トラバサミ》	名詞
＠とらば	《トラバサミ》	名詞
＠とらばさ	《トラバサミ》	名詞
＠とらばさみ	《トラバサミ》	名詞
＠ね	《眠らせる矢》	名詞
＠ねむ	《眠らせる矢》	名詞
＠ねむら	《眠らせる矢》	名詞
＠ねむらせ	《眠らせる矢》	名詞
＠ねむらせる	《眠らせる矢》	名詞
＠ねむらせるや	《眠らせる矢》	名詞
＠い	《インダサの水晶》	名詞
＠いん	《インダサの水晶》	名詞
＠いんだ	《インダサの水晶》	名詞
＠いんださ	《インダサの水晶》	名詞
＠いんださの	《インダサの水晶》	名詞
＠いんださのす	《インダサの水晶》	名詞
＠いんださのすい	《インダサの水晶》	名詞
＠いんださのすいし	《インダサの水晶》	名詞
＠いんださのすいしょ	《インダサの水晶》	名詞
＠いんださのすいしょう	《インダサの水晶》	名詞
＠け	《ケトリアの水晶》	名詞
＠けと	《ケトリアの水晶》	名詞
＠けとり	《ケトリアの水晶》	名詞
＠けとりあ	《ケトリアの水晶》	名詞
＠けとりあの	《ケトリアの水晶》	名詞
＠けとりあのす	《ケトリアの水晶》	名詞
＠けとりあのすい	《ケトリアの水晶》	名詞
＠けとりあのすいし	《ケトリアの水晶》	名詞
＠けとりあのすいしょ	《ケトリアの水晶》	名詞
＠けとりあのすいしょう	《ケトリアの水晶》	名詞
＠さ	《サヴァイの水晶》	名詞
＠さヴ	《サヴァイの水晶》	名詞
＠さヴぁ	《サヴァイの水晶》	名詞
＠さヴぁい	《サヴァイの水晶》	名詞
＠さヴぁいの	《サヴァイの水晶》	名詞
＠さヴぁいのす	《サヴァイの水晶》	名詞
＠さヴぁいのすい	《サヴァイの水晶》	名詞
＠さヴぁいのすいし	《サヴァイの水晶》	名詞
＠さヴぁいのすいしょ	《サヴァイの水晶》	名詞
＠さヴぁいのすいしょう	《サヴァイの水晶》	名詞
＠ぜ	《ゼイゴスの水晶》	名詞
＠ぜい	《ゼイゴスの水晶》	名詞
＠ぜいご	《ゼイゴスの水晶》	名詞
＠ぜいごす	《ゼイゴスの水晶》	名詞
＠ぜいごすの	《ゼイゴスの水晶》	名詞
＠ぜいごすのす	《ゼイゴスの水晶》	名詞
＠ぜいごすのすい	《ゼイゴスの水晶》	名詞
＠ぜいごすのすいし	《ゼイゴスの水晶》	名詞
＠ぜいごすのすいしょ	《ゼイゴスの水晶》	名詞
＠ぜいごすのすいしょう	《ゼイゴスの水晶》	名詞
＠ら	《ラウグリンの水晶》	名詞
＠らう	《ラウグリンの水晶》	名詞
＠らうぐ	《ラウグリンの水晶》	名詞
＠らうぐり	《ラウグリンの水晶》	名詞
＠らうぐりん	《ラウグリンの水晶》	名詞
＠らうぐりんの	《ラウグリンの水晶》	名詞
＠らうぐりんのす	《ラウグリンの水晶》	名詞
＠らうぐりんのすい	《ラウグリンの水晶》	名詞
＠らうぐりんのすいし	《ラウグリンの水晶》	名詞
＠らうぐりんのすいしょ	《ラウグリンの水晶》	名詞
＠らうぐりんのすいしょう	《ラウグリンの水晶》	名詞
＠お	《オゾリス》	名詞
＠おぞ	《オゾリス》	名詞
＠おぞり	《オゾリス》	名詞
＠おぞりす	《オゾリス》	名詞
＠け	《結晶の巨人》	名詞
＠けっ	《結晶の巨人》	名詞
＠けっし	《結晶の巨人》	名詞
＠けっしょ	《結晶の巨人》	名詞
＠けっしょう	《結晶の巨人》	名詞
＠けっしょうの	《結晶の巨人》	名詞
＠けっしょうのき	《結晶の巨人》	名詞
＠けっしょうのきょ	《結晶の巨人》	名詞
＠けっしょうのきょじ	《結晶の巨人》	名詞
＠けっしょうのきょじん	《結晶の巨人》	名詞
＠い	《茨森の滝》	名詞
＠いば	《茨森の滝》	名詞
＠いばら	《茨森の滝》	名詞
＠いばらも	《茨森の滝》	名詞
＠いばらもり	《茨森の滝》	名詞
＠いばらもりの	《茨森の滝》	名詞
＠いばらもりのた	《茨森の滝》	名詞
＠いばらもりのたき	《茨森の滝》	名詞
＠が	《岩だらけの高地》	名詞
＠がん	《岩だらけの高地》	名詞
＠がんだ	《岩だらけの高地》	名詞
＠がんだら	《岩だらけの高地》	名詞
＠がんだらけ	《岩だらけの高地》	名詞
＠がんだらけの	《岩だらけの高地》	名詞
＠がんだらけのこ	《岩だらけの高地》	名詞
＠がんだらけのこう	《岩だらけの高地》	名詞
＠がんだらけのこうち	《岩だらけの高地》	名詞
＠い	《陰鬱な僻地》	名詞
＠いん	《陰鬱な僻地》	名詞
＠いんう	《陰鬱な僻地》	名詞
＠いんうつ	《陰鬱な僻地》	名詞
＠いんうつな	《陰鬱な僻地》	名詞
＠いんうつなへ	《陰鬱な僻地》	名詞
＠いんうつなへき	《陰鬱な僻地》	名詞
＠いんうつなへきち	《陰鬱な僻地》	名詞
＠ふ	《風に削られた岩山》	名詞
＠ふう	《風に削られた岩山》	名詞
＠ふうに	《風に削られた岩山》	名詞
＠ふうにけ	《風に削られた岩山》	名詞
＠ふうにけず	《風に削られた岩山》	名詞
＠ふうにけずら	《風に削られた岩山》	名詞
＠ふうにけずられ	《風に削られた岩山》	名詞
＠ふうにけずられた	《風に削られた岩山》	名詞
＠ふうにけずられたい	《風に削られた岩山》	名詞
＠ふうにけずられたいわ	《風に削られた岩山》	名詞
＠ふうにけずられたいわや	《風に削られた岩山》	名詞
＠ふうにけずられたいわやま	《風に削られた岩山》	名詞
＠き	《急流の崖》	名詞
＠きゅ	《急流の崖》	名詞
＠きゅう	《急流の崖》	名詞
＠きゅうり	《急流の崖》	名詞
＠きゅうりゅ	《急流の崖》	名詞
＠きゅうりゅう	《急流の崖》	名詞
＠きゅうりゅうの	《急流の崖》	名詞
＠きゅうりゅうのが	《急流の崖》	名詞
＠きゅうりゅうのがけ	《急流の崖》	名詞
＠じ	《ジャングルのうろ穴》	名詞
＠じゃ	《ジャングルのうろ穴》	名詞
＠じゃん	《ジャングルのうろ穴》	名詞
＠じゃんぐ	《ジャングルのうろ穴》	名詞
＠じゃんぐる	《ジャングルのうろ穴》	名詞
＠じゃんぐるの	《ジャングルのうろ穴》	名詞
＠じゃんぐるのう	《ジャングルのうろ穴》	名詞
＠じゃんぐるのうろ	《ジャングルのうろ穴》	名詞
＠じゃんぐるのうろあ	《ジャングルのうろ穴》	名詞
＠じゃんぐるのうろあな	《ジャングルのうろ穴》	名詞
＠し	《進化する未開地》	名詞
＠しん	《進化する未開地》	名詞
＠しんか	《進化する未開地》	名詞
＠しんかす	《進化する未開地》	名詞
＠しんかする	《進化する未開地》	名詞
＠しんかするみ	《進化する未開地》	名詞
＠しんかするみか	《進化する未開地》	名詞
＠しんかするみかい	《進化する未開地》	名詞
＠しんかするみかいち	《進化する未開地》	名詞
＠ち	《血溜まりの洞窟》	名詞
＠ちた	《血溜まりの洞窟》	名詞
＠ちたま	《血溜まりの洞窟》	名詞
＠ちたまり	《血溜まりの洞窟》	名詞
＠ちたまりの	《血溜まりの洞窟》	名詞
＠ちたまりのど	《血溜まりの洞窟》	名詞
＠ちたまりのどう	《血溜まりの洞窟》	名詞
＠ちたまりのどうく	《血溜まりの洞窟》	名詞
＠ちたまりのどうくつ	《血溜まりの洞窟》	名詞
＠は	《花咲く砂地》	名詞
＠はな	《花咲く砂地》	名詞
＠はなさ	《花咲く砂地》	名詞
＠はなさく	《花咲く砂地》	名詞
＠はなさくす	《花咲く砂地》	名詞
＠はなさくすな	《花咲く砂地》	名詞
＠はなさくすなじ	《花咲く砂地》	名詞
＠へ	《平穏な入り江》	名詞
＠へい	《平穏な入り江》	名詞
＠へいお	《平穏な入り江》	名詞
＠へいおん	《平穏な入り江》	名詞
＠へいおんな	《平穏な入り江》	名詞
＠へいおんない	《平穏な入り江》	名詞
＠へいおんないり	《平穏な入り江》	名詞
＠へいおんないりえ	《平穏な入り江》	名詞
＠み	《磨かれたやせ地》	名詞
＠みが	《磨かれたやせ地》	名詞
＠みがか	《磨かれたやせ地》	名詞
＠みがかれ	《磨かれたやせ地》	名詞
＠みがかれた	《磨かれたやせ地》	名詞
＠みがかれたや	《磨かれたやせ地》	名詞
＠みがかれたやせ	《磨かれたやせ地》	名詞
＠みがかれたやせち	《磨かれたやせ地》	名詞
＠い	《インダサのトライオーム》	名詞
＠いん	《インダサのトライオーム》	名詞
＠いんだ	《インダサのトライオーム》	名詞
＠いんださ	《インダサのトライオーム》	名詞
＠いんださの	《インダサのトライオーム》	名詞
＠いんださのと	《インダサのトライオーム》	名詞
＠いんださのとら	《インダサのトライオーム》	名詞
＠いんださのとらい	《インダサのトライオーム》	名詞
＠いんださのとらいお	《インダサのトライオーム》	名詞
＠いんださのとらいおー	《インダサのトライオーム》	名詞
＠いんださのとらいおーむ	《インダサのトライオーム》	名詞
＠け	《ケトリアのトライオーム》	名詞
＠けと	《ケトリアのトライオーム》	名詞
＠けとり	《ケトリアのトライオーム》	名詞
＠けとりあ	《ケトリアのトライオーム》	名詞
＠けとりあの	《ケトリアのトライオーム》	名詞
＠けとりあのと	《ケトリアのトライオーム》	名詞
＠けとりあのとら	《ケトリアのトライオーム》	名詞
＠けとりあのとらい	《ケトリアのトライオーム》	名詞
＠けとりあのとらいお	《ケトリアのトライオーム》	名詞
＠けとりあのとらいおー	《ケトリアのトライオーム》	名詞
＠けとりあのとらいおーむ	《ケトリアのトライオーム》	名詞
＠さ	《サヴァイのトライオーム》	名詞
＠さヴ	《サヴァイのトライオーム》	名詞
＠さヴぁ	《サヴァイのトライオーム》	名詞
＠さヴぁい	《サヴァイのトライオーム》	名詞
＠さヴぁいの	《サヴァイのトライオーム》	名詞
＠さヴぁいのと	《サヴァイのトライオーム》	名詞
＠さヴぁいのとら	《サヴァイのトライオーム》	名詞
＠さヴぁいのとらい	《サヴァイのトライオーム》	名詞
＠さヴぁいのとらいお	《サヴァイのトライオーム》	名詞
＠さヴぁいのとらいおー	《サヴァイのトライオーム》	名詞
＠さヴぁいのとらいおーむ	《サヴァイのトライオーム》	名詞
＠ぜ	《ゼイゴスのトライオーム》	名詞
＠ぜい	《ゼイゴスのトライオーム》	名詞
＠ぜいご	《ゼイゴスのトライオーム》	名詞
＠ぜいごす	《ゼイゴスのトライオーム》	名詞
＠ぜいごすの	《ゼイゴスのトライオーム》	名詞
＠ぜいごすのと	《ゼイゴスのトライオーム》	名詞
＠ぜいごすのとら	《ゼイゴスのトライオーム》	名詞
＠ぜいごすのとらい	《ゼイゴスのトライオーム》	名詞
＠ぜいごすのとらいお	《ゼイゴスのトライオーム》	名詞
＠ぜいごすのとらいおー	《ゼイゴスのトライオーム》	名詞
＠ぜいごすのとらいおーむ	《ゼイゴスのトライオーム》	名詞
＠け	《眷者の居留地》	名詞
＠けん	《眷者の居留地》	名詞
＠けんじ	《眷者の居留地》	名詞
＠けんじゃ	《眷者の居留地》	名詞
＠けんじゃの	《眷者の居留地》	名詞
＠けんじゃのき	《眷者の居留地》	名詞
＠けんじゃのきょ	《眷者の居留地》	名詞
＠けんじゃのきょり	《眷者の居留地》	名詞
＠けんじゃのきょりゅ	《眷者の居留地》	名詞
＠けんじゃのきょりゅう	《眷者の居留地》	名詞
＠けんじゃのきょりゅうち	《眷者の居留地》	名詞
＠ら	《ラウグリンのトライオーム》	名詞
＠らう	《ラウグリンのトライオーム》	名詞
＠らうぐ	《ラウグリンのトライオーム》	名詞
＠らうぐり	《ラウグリンのトライオーム》	名詞
＠らうぐりん	《ラウグリンのトライオーム》	名詞
＠らうぐりんの	《ラウグリンのトライオーム》	名詞
＠らうぐりんのと	《ラウグリンのトライオーム》	名詞
＠らうぐりんのとら	《ラウグリンのトライオーム》	名詞
＠らうぐりんのとらい	《ラウグリンのトライオーム》	名詞
＠らうぐりんのとらいお	《ラウグリンのトライオーム》	名詞
＠らうぐりんのとらいおー	《ラウグリンのトライオーム》	名詞
＠らうぐりんのとらいおーむ	《ラウグリンのトライオーム》	名詞
